id,title,year,rtID,rtAllCriticsRating,rtAllCriticsNumReviews,rtAllCriticsNumFresh,rtAllCriticsNumRotten,rtAllCriticsScore,rtTopCriticsRating,rtTopCriticsNumReviews,rtTopCriticsNumFresh,rtTopCriticsNumRotten,rtTopCriticsScore,rtAudienceRating,rtAudienceNumRatings,rtAudienceScore,rtPictureURL
1,Toy story,1995,toy_story,9,73,73,0,100,8.5,17,17,0,100,3.7,102338,81,http://content7.flixster.com/movie/10/93/63/10936393_det.jpg
2,Jumanji,1995,1068044-jumanji,5.6,28,13,15,46,5.8,5,2,3,40,3.2,44587,61,http://content8.flixster.com/movie/56/79/73/5679734_det.jpg
3,Grumpy Old Men,1993,grumpy_old_men,5.9,36,24,12,66,7,6,5,1,83,3.2,10489,66,http://content6.flixster.com/movie/25/60/256020_det.jpg
4,Waiting to Exhale,1995,waiting_to_exhale,5.6,25,14,11,56,5.5,11,5,6,45,3.3,5666,79,http://content9.flixster.com/movie/10/94/17/10941715_det.jpg
5,Father of the Bride Part II,1995,father_of_the_bride_part_ii,5.3,19,9,10,47,5.4,5,1,4,20,3,13761,64,http://content8.flixster.com/movie/25/54/255426_det.jpg
6,Heat,1995,1068182-heat,7.7,58,50,8,86,7.2,17,14,3,82,3.9,42785,92,http://content9.flixster.com/movie/26/80/268099_det.jpg
7,Sabrina,1954,1018047-sabrina,7.4,31,28,3,90,7.2,5,5,0,100,3.8,12812,87,http://content7.flixster.com/movie/10/93/36/10933669_det.jpg
8,Tom and Huck,1995,tom_and_huck,4.2,8,2,6,25,0,2,1,1,50,2.7,2649,45,http://content9.flixster.com/movie/26/16/261691_det.jpg
9,Sudden Death,1995,1068470-sudden_death,5.2,32,17,15,53,5.6,9,5,4,55,2.6,3626,40,http://content8.flixster.com/movie/27/91/279122_det.jpg
10,GoldenEye,1995,goldeneye,6.8,41,33,8,80,6.2,11,7,4,63,3.4,28260,78,http://content9.flixster.com/movie/26/66/266699_det.jpg
11,The American President,1995,american_president,7,49,44,5,89,7.2,18,16,2,88,3.2,8320,71,http://content7.flixster.com/movie/25/42/254205_det.jpg
12,Dracula: Dead and Loving It,1995,dracula_dead_and_loving_it,3,35,3,32,8,3.7,10,2,8,20,2.8,10078,52,http://content8.flixster.com/movie/10/89/17/10891774_det.jpg
13,Balto,1995,balto,5.8,12,6,6,50,0,4,1,3,25,3.2,9195,66,http://content7.flixster.com/movie/25/16/251605_det.jpg
14,Nixon,1995,nixon,6.7,56,42,14,75,6.1,18,12,6,66,3.5,3256,72,http://content6.flixster.com/movie/28/30/283016_det.jpg
15,Cutthroat Island,1995,cutthroat_island,4.4,31,14,17,45,4.7,6,3,3,50,2.6,3350,42,http://content6.flixster.com/movie/25/69/256908_det.jpg
16,Casino,1995,1067987-casino,7.2,58,47,11,81,6.3,16,11,5,68,3.9,66463,91,http://content8.flixster.com/movie/10/87/61/10876102_det.jpg
17,Sense and Sensibility,1995,1068832-sense_and_sensibility,7.9,49,48,1,97,8.1,14,13,1,92,3.8,32782,88,http://content6.flixster.com/movie/11/12/50/11125040_det.jpg
18,Four Rooms,1995,four_rooms,3.5,42,6,36,14,2.9,11,0,11,0,3.5,14266,72,http://content7.flixster.com/movie/93/49/77/9349773_det.jpg
19,Ace Ventura: When Nature Calls,1995,ace_ventura_when_nature_calls,4.1,25,9,16,36,0,3,1,2,33,3.2,87306,73,http://content7.flixster.com/movie/10/94/18/10941853_det.jpg
20,Money Train,1995,money_train,4,24,4,20,16,4.5,5,1,4,20,2.7,5263,38,http://content9.flixster.com/movie/11/12/51/11125103_det.jpg
21,Get Shorty,1995,get_shorty,7.7,49,42,7,85,8.4,14,14,0,100,3.2,10155,63,http://content7.flixster.com/movie/98/65/89/9865893_det.jpg
22,Copycat,1995,1065837-copycat,6.6,32,24,8,75,7.4,5,4,1,80,3.1,5628,58,http://content9.flixster.com/movie/27/27/272723_det.jpg
23,Ninja Assassin,2009,1198524-ninja_assassin,4.3,106,27,79,25,4.6,20,6,14,30,3.4,107023,58,http://content6.flixster.com/movie/10/89/12/10891232_det.jpg
24,Powder,1995,powder,5.2,19,9,10,47,4.9,5,0,5,0,3.1,6650,67,http://content7.flixster.com/movie/25/59/255901_det.jpg
25,Leaving Las Vegas,1995,leaving_las_vegas,7.7,45,40,5,88,8.1,11,11,0,100,3.6,12742,82,http://content7.flixster.com/movie/10/90/25/10902561_det.jpg
26,Othello,1995,1069707-othello,6.3,38,26,12,68,6.1,11,7,4,63,3.3,2018,66,http://content6.flixster.com/movie/10/92/98/10929892_det.jpg
27,Now and Then,1995,now_and_then,4.7,16,3,13,18,5.2,5,1,4,20,3.5,17168,78,http://content6.flixster.com/movie/55/36/64/5536644_det.jpg
28,Persuasion,1995,1066528-persuasion,7.7,23,19,4,82,8.5,9,9,0,100,3.9,7968,82,http://content6.flixster.com/movie/11/12/73/11127360_det.jpg
29,La cit√© des enfants perdus,1995,city_of_lost_children,7,33,27,6,81,7.2,7,5,2,71,4,22420,89,http://content6.flixster.com/movie/26/78/267824_det.jpg
30,Yao a yao yao dao waipo qiao,1995,shanghai_triad,6.8,21,18,3,85,0,4,3,1,75,3.6,1061,70,http://content8.flixster.com/movie/10/90/31/10903162_det.jpg
31,Dangerous Minds,1995,dangerous_minds,4.7,37,11,26,29,5,12,5,7,41,3.1,12136,66,http://content7.flixster.com/movie/26/98/269813_det.jpg
32,Twelve Monkeys,1995,prem-no-public-issue,0,0,0,0,0,0,0,0,0,0,0,0,0,http://content6.flixster.com/movie/10/93/02/10930244_det.jpg
33,Wings of Courage,1995,,0,4,2,2,50,0,2,1,1,50,0,0,0,http://content7.flixster.com/movie/10/97/83/10978341_det.jpg
34,Babe,1995,1065598-babe,8.2,54,53,1,98,8.2,11,11,0,100,3,22954,54,http://content7.flixster.com/movie/25/32/253205_det.jpg
35,Carrington,1995,carrington,6.2,19,9,10,47,7.4,5,4,1,80,3.5,781,68,http://content7.flixster.com/movie/28/00/280009_det.jpg
36,Dead Man Walking,1995,1068779-dead_man_walking,8.2,53,50,3,94,7.9,20,18,2,90,3.6,15450,81,http://content6.flixster.com/movie/10/88/77/10887764_det.jpg
37,Across the Sea of Time,1995,across_the_sea_of_time,0,4,2,2,50,0,1,0,1,0,2.9,237,27,http://content6.flixster.com/movie/10/90/58/10905808_det.jpg
38,It Takes Two,1995,1067137-it_takes_two,3.9,24,2,22,8,4.6,8,2,6,25,2.9,16311,63,http://content7.flixster.com/movie/25/74/257417_det.jpg
39,Clueless,1995,school_of_senses,0,0,0,0,0,0,0,0,0,0,0,0,0,http://content8.flixster.com/movie/10/85/01/10850110_det.jpg
40,"Cry, the Beloved Country",1995,1068781-cry_the_beloved_country,7.2,13,10,3,76,0,4,3,1,75,3.5,520,66,http://content6.flixster.com/movie/10/89/59/10895996_det.jpg
41,Richard III,1995,1068177-richard_iii,8.1,43,41,2,95,7.6,11,10,1,90,3.7,1552,82,http://content7.flixster.com/movie/26/89/268909_det.jpg
42,Dead Presidents,1995,dead_presidents,5.7,31,14,17,45,6.3,12,7,5,58,3.3,4475,75,http://content7.flixster.com/movie/26/95/269521_det.jpg
43,Restoration,1995,1069339-restoration,6.3,31,21,10,67,6.4,10,6,4,60,3.3,1103,56,http://content6.flixster.com/movie/27/04/270404_det.jpg
44,Mortal Kombat,1995,mortal_kombat,4.4,26,9,17,34,3.9,6,2,4,33,2.8,18291,55,http://content9.flixster.com/movie/25/63/256395_det.jpg
45,Live Free or Die Hard,2007,live_free_or_die_hard,6.8,197,161,36,81,6.7,38,30,8,78,3.9,1145097,86,http://content8.flixster.com/movie/10/93/34/10933482_det.jpg
46,How to Make an American Quilt,1995,how_to_make_an_american_quilt,5.6,22,11,11,50,7.6,6,5,1,83,3.2,2626,58,http://content8.flixster.com/movie/10/86/75/10867514_det.jpg
47,Shichinin no samurai,1954,1018639-seven_samurai,9.2,49,49,0,100,8.6,10,10,0,100,4.5,29509,97,http://content7.flixster.com/movie/39/91/08/3991085_det.jpg
48,Pocahontas,1995,1063452-pocahontas,6,49,27,22,55,6.6,14,10,4,71,3.2,37858,63,http://content6.flixster.com/movie/25/15/251508_det.jpg
49,When Night Is Falling,1995,when_night_is_falling,5.7,16,8,8,50,0,4,1,3,25,3.9,1132,83,http://content6.flixster.com/movie/10/89/77/10897780_det.jpg
50,The Usual Suspects,1995,usual_suspects,7.5,47,41,6,87,6.9,14,12,2,85,4.2,109588,95,http://content7.flixster.com/movie/24/63/48/2463485_det.jpg
52,Mighty Aphrodite,1995,mighty_aphrodite,6.7,33,25,8,75,7.2,6,4,2,66,3.3,4866,69,http://content7.flixster.com/movie/10/84/18/10841893_det.jpg
53,Lamerica,1994,lamerica,8,10,9,1,90,0,1,1,0,100,3.9,239,82,http://content6.flixster.com/movie/29/78/297800_det.jpg
54,The Big Green,1995,big_green,2.8,5,0,5,0,0,1,0,1,0,2.7,2596,47,http://content7.flixster.com/movie/25/93/259305_det.jpg
55,Georgia Rule,2007,georgia_rule,3.8,116,20,96,17,3.4,30,2,28,6,3,64056,55,http://content8.flixster.com/movie/63/82/23/6382238_det.jpg
56,Kids of the Round Table,1997,kids-of-the-round-table,0,0,0,0,0,0,0,0,0,0,0,0,0,http://content7.flixster.com/movie/10/85/20/10852069_det.jpg
57,Home for the Holidays,1995,1066169-home_for_the_holidays,6,44,28,16,63,5.7,11,5,6,45,3.4,3045,69,http://content6.flixster.com/movie/25/43/254392_det.jpg
58,Il postino,1994,il_postino,7.9,25,23,2,92,0,4,4,0,100,4.1,5794,92,http://content8.flixster.com/movie/10/86/74/10867406_det.jpg
59,Le confessionnal,1995,confessional,0,1,1,0,100,0,0,0,0,0,0,0,0,http://images.rottentomatoescdn.com/images/defaults/poster_default.gif
60,The Indian in the Cupboard,1995,indian_in_the_cupboard,6.2,19,13,6,68,0,2,1,1,50,2.7,5127,41,http://content9.flixster.com/movie/25/78/257803_det.jpg
61,Eye for an Eye,1996,1101753-eye,0,0,0,0,0,0,0,0,0,0,0,0,0,http://content8.flixster.com/movie/10/99/01/10990146_det.jpg
62,Mr. Holland's Opus,1995,mr_hollands_opus,6.7,26,19,7,73,7.5,6,5,1,83,3.5,9569,79,http://content8.flixster.com/movie/10/58/42/10584210_det.jpg
63,Don't Be a Menace to South Central While Drinking Your Juice in the Hood,1996,dont_be_a_menace,4.5,24,7,17,29,5.6,7,3,4,42,0,0,0,http://content8.flixster.com/movie/28/69/286926_det.jpg
64,Two If by Sea,1996,two_if_by_sea,3.9,27,3,24,11,0,4,0,4,0,2.6,1608,29,http://content6.flixster.com/movie/27/80/278004_det.jpg
65,Bio-Dome,1996,biodome,1.9,21,1,20,4,2,7,0,7,0,2.6,8972,51,http://content6.flixster.com/movie/25/94/259420_det.jpg
66,Lawnmower Man 2: Beyond Cyberspace,1996,lawnmower_man_2_jobes_war,2.8,9,1,8,11,0,3,1,2,33,2.1,952,18,http://content7.flixster.com/movie/10/86/80/10868017_det.jpg
67,Two Bits,1995,two-bits,5,10,4,6,40,0,4,1,3,25,3.3,685,54,http://content6.flixster.com/movie/26/66/266612_det.jpg
68,Gazon maudit,1995,french_twist,6.1,10,5,5,50,0,4,1,3,25,3.4,597,58,http://content7.flixster.com/movie/27/76/277609_det.jpg
69,Friday,1995,nothing_funny,0,0,0,0,0,0,0,0,0,0,0,0,0,http://content7.flixster.com/movie/10/88/03/10880345_det.jpg
70,From Dusk Till Dawn,1996,from_dusk_till_dawn,6,43,27,16,62,4.9,10,5,5,50,3.4,36073,75,http://content9.flixster.com/movie/62/82/01/6282011_det.jpg
71,Fair Game,1995,1065868-fair_game,2.4,24,3,21,12,3.1,8,1,7,12,2.1,1761,16,http://content8.flixster.com/movie/27/69/276994_det.jpg
72,Kicking & Screaming,2005,kicking_and_screaming,5.1,137,57,80,41,5,31,12,19,38,3,14260,51,http://content9.flixster.com/movie/24/97/249715_det.jpg
73,Les mis√©rables,1998,1083326-les_miserables,6.9,41,31,10,75,6.6,11,6,5,54,3.6,7310,81,http://content9.flixster.com/movie/25/51/255107_det.jpg
74,Bed of Roses,1996,bed_of_roses,5.3,14,3,11,21,5.2,5,1,4,20,3.2,3163,66,http://content9.flixster.com/movie/25/92/259203_det.jpg
75,Big Bully,1996,big_bully,2.8,7,0,7,0,0,2,0,2,0,2.4,1459,23,http://content9.flixster.com/movie/26/51/265195_det.jpg
76,Screamers,1995,1069696-screamers,4.7,30,9,21,30,4.9,9,2,7,22,3,2070,45,http://content7.flixster.com/movie/27/23/272301_det.jpg
77,Nico Icon,1995,nico_icon,7.1,13,11,2,84,8,5,4,1,80,4,87,85,http://content9.flixster.com/movie/10/84/77/10847739_det.jpg
78,The Crossing Guard,1995,crossing_guard,6.5,27,20,7,74,0,4,2,2,50,3.3,2170,56,http://content7.flixster.com/movie/27/69/276905_det.jpg
79,The Juror,1996,juror,4.4,19,3,16,15,4.3,6,1,5,16,2.8,2266,39,http://content6.flixster.com/movie/27/93/279316_det.jpg
80,Badkonake sefid,1995,white_balloon,6.8,20,16,4,80,6.6,8,6,2,75,4,547,86,http://content9.flixster.com/movie/54/93/06/5493067_det.jpg
81,Things to Do in Denver When You're Dead,1995,things_to_do_in_denver_when_youre_dead,4.9,27,9,18,33,5.5,5,1,4,20,3.5,3197,72,http://content8.flixster.com/movie/27/06/270606_det.jpg
82,Antonia,1995,antonias_line,6.5,25,16,9,64,7.8,10,9,1,90,4.2,1707,90,http://content6.flixster.com/movie/28/20/282096_det.jpg
83,Once Upon a Time... When We Were Colored,1995,once-upon-a-timewhen-we-were-colored,7.3,14,10,4,71,7.9,5,5,0,100,3.7,414,76,http://content8.flixster.com/movie/10/92/29/10922994_det.jpg
84,Last Summer in the Hamptons,1995,last_summer_in_the_hamptons,5.6,15,9,6,60,0,2,2,0,100,3.3,89,47,http://content8.flixster.com/movie/92/06/07/9206078_det.jpg
85,Angels and Insects,1995,angels_and_insects,6.5,20,14,6,70,8.1,5,5,0,100,3.3,635,62,http://content6.flixster.com/movie/10/89/39/10893928_det.jpg
86,White Squall,1996,white_squall,5.8,30,19,11,63,6.3,10,7,3,70,3.2,3184,62,http://content9.flixster.com/movie/10/90/52/10905259_det.jpg
87,Dunston Checks In,1996,dunston_checks_in,3.8,15,1,14,6,0,4,1,3,25,2.5,2935,39,http://content8.flixster.com/movie/10/85/22/10852206_det.jpg
88,Black Sheep,2006,black_sheep,6.4,87,61,26,70,6.3,21,15,6,71,3.2,19454,54,http://content6.flixster.com/movie/58/07/67/5807672_det.jpg
89,Nick of Time,1995,nick_of_time,4.6,28,8,20,28,3.8,5,0,5,0,3.1,10563,54,http://content9.flixster.com/movie/10/84/01/10840163_det.jpg
90,The Journey of August King,1995,journey_of_august_king,6.2,7,4,3,57,0,2,1,1,50,3.1,286,54,http://content8.flixster.com/movie/26/54/265406_det.jpg
92,Mary Reilly,1996,mary_reilly,4.4,41,11,30,26,4.6,9,2,7,22,2.8,3733,41,http://content6.flixster.com/movie/27/56/275628_det.jpg
93,Vampire in Brooklyn,1995,vampire_in_brooklyn,3.6,28,3,25,10,3.1,9,0,9,0,2.4,6122,37,http://content7.flixster.com/movie/10/88/64/10886457_det.jpg
94,Beautiful Girls,1996,beautiful_girls,7,46,36,10,78,6.3,14,9,5,64,3.6,4674,79,http://content7.flixster.com/movie/10/84/53/10845361_det.jpg
95,Broken Arrow,1996,1069241-broken_arrow,5.8,29,16,13,55,6.1,6,3,3,50,2.9,12489,51,http://content6.flixster.com/movie/27/12/271208_det.jpg
96,In the Bleak Midwinter,1995,midwinters_tale,7.3,19,17,2,89,0,3,2,1,66,4.1,309,88,http://content6.flixster.com/movie/52/63/38/5263388_det.jpg
97,La haine,1995,hate,8,14,14,0,100,0,4,4,0,100,4.3,11987,95,http://content8.flixster.com/movie/10/84/15/10841502_det.jpg
98,Going Shopping,2005,going_shopping,5,29,12,17,41,5,15,5,10,33,2.8,691,37,http://content8.flixster.com/movie/25/02/250226_det.jpg
99,Heidi Fleiss: Hollywood Madam,1995,heidi_fleiss_hollywood_madam,7.5,7,5,2,71,8.8,5,4,1,80,3,281,46,http://content7.flixster.com/movie/30/49/304921_det.jpg
100,City Hall,1996,city_hall,6.1,22,12,10,54,7,6,3,3,50,3,2730,42,http://content8.flixster.com/movie/27/59/275902_det.jpg
101,Bottle Rocket,1996,bottle_rocket,6.6,42,33,9,78,6.1,9,5,4,55,3.7,16217,80,http://content6.flixster.com/movie/26/73/267324_det.jpg
102,Mr. Wrong,1996,mr_wrong,3.1,28,1,27,3,3.1,8,0,8,0,2.4,1544,29,http://content8.flixster.com/movie/10/92/04/10920478_det.jpg
103,Unforgettable,1996,unforgettable,4.4,26,6,20,23,0,4,0,4,0,3,358,36,http://content8.flixster.com/movie/11/13/35/11133586_det.jpg
104,Happy Gilmore,1996,happy_gilmore,5.5,50,29,21,58,5.1,11,4,7,36,3.7,114875,83,http://content7.flixster.com/movie/25/96/259613_det.jpg
105,The Bridges of Madison County,1995,bridges_of_madison_county,7.2,40,36,4,90,7.9,9,9,0,100,3.6,11573,83,http://content6.flixster.com/movie/10/92/73/10927328_det.jpg
106,Keiner liebt mich,1994,nobody_loves_me,6,6,4,2,66,0,1,1,0,100,4.2,161,89,http://content6.flixster.com/movie/10/89/61/10896152_det.jpg
107,Muppet Treasure Island,1996,muppet_treasure_island,6.1,22,15,7,68,7.4,5,4,1,80,3.2,8588,68,http://content6.flixster.com/movie/10/88/15/10881572_det.jpg
110,Braveheart,1995,1065684-braveheart,7,48,37,11,77,6.7,16,12,4,75,3.8,204275,83,http://content9.flixster.com/movie/16/90/54/1690543_det.jpg
111,Taxi Driver,1976,taxi_driver,8.7,50,49,1,98,7.7,9,8,1,88,4.1,58145,93,http://content9.flixster.com/movie/10/91/39/10913987_det.jpg
112,Hung fan kui,1995,rumble_in_the_bronx,6.4,52,41,11,78,6.5,16,13,3,81,3.1,7517,62,http://content6.flixster.com/movie/10/88/62/10886212_det.jpg
113,Before and After,1996,1070061-before_and_after,4.8,19,6,13,31,5.7,5,2,3,40,3,1276,39,http://content8.flixster.com/movie/26/53/265310_det.jpg
114,Margaret's Museum,1995,margarets_museum,6.9,6,4,2,66,0,1,1,0,100,3.7,500,76,http://content7.flixster.com/movie/10/43/62/10436297_det.jpg
115,Le bonheur est dans le pr√©,1995,happiness_is_in_the_field,0,0,0,0,0,0,0,0,0,0,0,0,0,http://content8.flixster.com/movie/10/91/13/10911350_det.jpg
116,Anne Frank Remembered,1995,anne_frank_remembered,7.8,27,26,1,96,7.6,16,15,1,93,3.7,1076,79,http://content9.flixster.com/movie/10/87/14/10871419_det.jpg
117,The Young Poisoner's Handbook,1995,young_poisoners_handbook,7.1,13,11,2,84,0,3,3,0,100,3.7,541,79,http://content8.flixster.com/movie/52/63/47/5263478_det.jpg
118,If Lucy Fell,1996,if_lucy_fell,4,26,5,21,19,4.3,9,2,7,22,3.1,1202,49,http://content7.flixster.com/movie/10/36/17/10361777_det.jpg
119,Steal Big Steal Little,1995,steal_big_steal_little,4.5,13,2,11,15,0,3,0,3,0,2.9,555,36,http://content9.flixster.com/movie/10/86/77/10867755_det.jpg
120,Race the Sun,1996,race_the_sun,4.8,9,2,7,22,0,3,0,3,0,2.9,822,40,http://content7.flixster.com/movie/10/88/81/10888113_det.jpg
121,The Boys of St. Vincent,1992,the-boys-of-st-vincent,8.2,6,6,0,100,0,1,1,0,100,3.5,401,77,http://content7.flixster.com/movie/11/12/44/11124449_det.jpg
122,Boomerang,1992,1039796-boomerang,4.8,27,10,17,37,5.4,8,4,4,50,2.8,4751,55,http://content6.flixster.com/movie/26/81/268128_det.jpg
123,Chung Hing sam lam,1994,chungking_express,7.7,27,26,1,96,6.8,7,6,1,85,4.2,11068,93,http://content6.flixster.com/movie/10/85/69/10856936_det.jpg
124,L'uomo delle stelle,1995,star_maker,6.5,12,9,3,75,7,5,4,1,80,3.7,543,73,http://content9.flixster.com/movie/27/57/275715_det.jpg
125,Flirting with Disaster,1996,flirting_with_disaster,7.4,42,36,6,85,8.5,6,6,0,100,3.3,2127,65,http://content9.flixster.com/movie/92/18/93/9218931_det.jpg
126,The Neverending Story III,1994,neverending_story_3_the_escape_from_fantasia,0,3,1,2,33,0,0,0,0,0,0,0,0,http://content9.flixster.com/movie/10/88/07/10880743_det.jpg
128,Jupiter's Wife,1995,jupiters_wife,0,4,3,1,75,0,1,0,1,0,0,0,0,http://content7.flixster.com/movie/10/97/52/10975293_det.jpg
129,Pie in the Sky,1996,pie_in_the_sky,0,2,1,1,50,0,0,0,0,0,0,0,0,http://content9.flixster.com/movie/28/42/284295_det.jpg
130,Angela's Ashes,1999,angelas_ashes,5.7,84,44,40,52,5.3,26,10,16,38,3.6,4588,79,http://content6.flixster.com/movie/10/92/31/10923132_det.jpg
131,Frankie Starlight,1995,frankie_starlight,5.8,6,4,2,66,0,1,1,0,100,3.8,133,61,http://content6.flixster.com/movie/93/50/48/9350484_det.jpg
132,The Curse of the Jade Scorpion,2001,curse_of_the_jade_scorpion,5.2,122,55,67,45,5,36,14,22,38,3.1,4108,52,http://content6.flixster.com/movie/26/26/262600_det.jpg
134,Sonic Outlaws,1995,sonic_outlaws,0,3,2,1,66,0,0,0,0,0,0,0,0,http://content9.flixster.com/movie/10/83/90/10839055_det.jpg
135,Down Periscope,1996,down_periscope,3.8,31,4,27,12,4,8,1,7,12,2.8,3851,60,http://content9.flixster.com/movie/25/41/254115_det.jpg
136,From the Journals of Jean Seberg,1995,from_the_journals_of_jean_seberg,7.6,9,9,0,100,0,3,3,0,100,4,30,75,http://content8.flixster.com/movie/10/87/54/10875446_det.jpg
137,Man of the Year,2006,man_of_the_year,4.4,141,30,111,21,5,35,11,24,31,3,29127,51,http://content9.flixster.com/movie/11/12/89/11128939_det.jpg
139,Hard Target,1993,hard_target,5.2,29,14,15,48,5.6,7,4,3,57,0,0,0,http://content6.flixster.com/movie/27/33/273300_det.jpg
140,Up Close & Personal,1996,up_close_and_personal,5.1,31,10,21,32,6.5,6,3,3,50,3.2,2932,63,http://content9.flixster.com/movie/25/89/258991_det.jpg
141,The Birdcage,1996,birdcage,6.7,29,22,7,75,7.5,5,5,0,100,3.3,13502,75,http://content9.flixster.com/movie/26/71/267195_det.jpg
143,Gospa,1995,,\N,\N,\N,\N,\N,\N,\N,\N,\N,\N,\N,\N,\N,\N
144,The Brothers McMullen,1995,brothers_mcmullen,7.1,34,31,3,91,7.8,6,6,0,100,3.2,1225,55,http://content8.flixster.com/movie/10/87/96/10879638_det.jpg
145,Bad Boys,1995,1062483-bad_boys,4.8,41,16,25,39,3.7,9,1,8,11,3.5,67658,79,http://content8.flixster.com/movie/28/27/282798_det.jpg
146,The Amazing Panda Adventure,1995,amazing_panda_adventure,4.3,9,2,7,22,0,3,1,2,33,3,1335,46,http://content9.flixster.com/movie/11/15/28/11152831_det.jpg
147,The Basketball Diaries,1995,basketball_diaries,4.9,35,15,20,42,4.7,11,3,8,27,3.5,12119,77,http://content7.flixster.com/movie/10/93/25/10932577_det.jpg
148,An Awfully Big Adventure,1995,awfully_big_adventure,5.4,11,4,7,36,0,3,0,3,0,3.2,1433,55,http://content8.flixster.com/movie/10/90/97/10909738_det.jpg
149,The Moguls,2005,the-amateurs,3.9,24,4,20,16,0,4,1,3,25,3,8865,46,http://content7.flixster.com/movie/11/13/35/11133545_det.jpg
150,Apollo 13,1995,apollo_13,8,51,49,2,96,7.9,11,10,1,90,3.6,30565,78,http://content7.flixster.com/movie/10/93/70/10937057_det.jpg
151,Rob Roy,1995,1061000-rob_roy,6.3,42,30,12,71,5.8,10,5,5,50,3.3,5253,73,http://content9.flixster.com/movie/26/89/268991_det.jpg
152,Basic Instinct 2,2006,basic_instinct_2,3.1,149,10,139,6,3.2,35,1,34,2,2.5,28208,33,http://content8.flixster.com/movie/10/89/83/10898386_det.jpg
153,Batman Forever,1995,batman_forever,5.2,54,23,31,42,5.9,14,10,4,71,2.9,47498,42,http://content7.flixster.com/movie/55/34/97/5534977_det.jpg
154,Belle de jour,1967,belle_de_jour,8.6,36,34,2,94,7.9,9,8,1,88,4,1378,84,http://content9.flixster.com/movie/10/86/32/10863255_det.jpg
155,Beyond Rangoon,1995,beyond_rangoon,5.1,30,11,19,36,5,10,4,6,40,3.5,3962,64,http://content8.flixster.com/movie/10/86/97/10869758_det.jpg
156,Blue in the Face,1995,blue_in_the_face,5.5,20,9,11,45,0,3,1,2,33,3.5,1323,73,http://content8.flixster.com/movie/27/68/276818_det.jpg
157,Canadian Bacon,1995,canadian_bacon,3.3,14,2,12,14,0,2,0,2,0,2.9,3460,49,http://content7.flixster.com/movie/26/00/260017_det.jpg
158,Casper,1995,casper,4.7,34,14,20,41,4.5,10,3,7,30,3,20672,54,http://content9.flixster.com/movie/31/28/312827_det.jpg
159,Clockers,1995,clockers,6.5,46,31,15,67,6.7,12,9,3,75,3.5,2502,74,http://content8.flixster.com/movie/10/84/06/10840642_det.jpg
160,Congo,1995,congo,3.6,42,9,33,21,3.2,12,1,11,8,2.6,7008,34,http://content7.flixster.com/movie/25/85/258597_det.jpg
161,Crimson Tide,1995,crimson_tide,7.4,44,38,6,86,8,10,9,1,90,3.5,11550,77,http://content7.flixster.com/movie/26/84/268417_det.jpg
162,Crumb,1994,crumb,8.3,39,37,2,94,0,4,4,0,100,4,2689,88,http://content7.flixster.com/movie/27/41/274197_det.jpg
163,Desperado,1995,desperado,6.3,38,23,15,60,5.4,10,3,7,30,3.5,23821,79,http://content6.flixster.com/movie/10/87/27/10872728_det.jpg
164,Devil in a Blue Dress,1995,devil_in_a_blue_dress,7.3,50,44,6,88,7,14,11,3,78,3.3,2742,64,http://content9.flixster.com/movie/27/13/271303_det.jpg
165,Die Hard: With a Vengeance,1995,die_hard_with_a_vengeance,5.7,42,20,22,47,5.8,10,5,5,50,3.6,61394,83,http://content8.flixster.com/movie/10/93/34/10933486_det.jpg
166,The Doom Generation,1995,doom_generation,4.9,29,14,15,48,5.3,12,7,5,58,3.3,2680,64,http://content8.flixster.com/movie/10/92/11/10921130_det.jpg
167,Feast of July,1995,feast_of_july,6.2,9,6,3,66,0,4,2,2,50,2.9,226,40,http://content8.flixster.com/movie/10/87/63/10876398_det.jpg
168,First Knight,1995,first_knight,5.2,42,19,23,45,5.5,14,7,7,50,3,13290,59,http://content9.flixster.com/movie/84/22/90/8422907_det.jpg
169,Free Willy 2: The Adventure Home,1995,free_willy_2_the_adventure_home,4.6,12,3,9,25,0,3,1,2,33,2.8,8336,53,http://content9.flixster.com/movie/26/44/264407_det.jpg
170,Hackers,1995,hackers,4.7,19,7,12,36,0,3,2,1,66,3.2,16863,66,http://content7.flixster.com/movie/25/64/256409_det.jpg
171,Jeffrey,1995,jeffrey,6.1,23,14,9,60,5.7,9,4,5,44,3.4,836,68,http://content7.flixster.com/movie/27/11/271117_det.jpg
172,Johnny Mnemonic,1995,johnny_mnemonic,3.3,28,4,24,14,4.7,5,1,4,20,2.5,7062,33,http://content7.flixster.com/movie/28/53/285317_det.jpg
173,Judge Dredd,1995,judge_dredd,3.6,47,7,40,14,3.7,10,0,10,0,2.5,10571,35,http://content9.flixster.com/movie/27/05/270591_det.jpg
174,Jury Duty,1995,jury_duty,2.1,11,0,11,0,0,2,0,2,0,2.4,1843,33,http://content6.flixster.com/movie/10/50/99/10509940_det.jpg
175,Kids,1995,kids,5,52,26,26,50,6.5,7,4,3,57,3.5,11282,78,http://content6.flixster.com/movie/10/89/38/10893852_det.jpg
176,Living in Oblivion,1995,living_in_oblivion,7.4,24,21,3,87,0,2,2,0,100,3.8,1878,85,http://content6.flixster.com/movie/10/87/12/10871220_det.jpg
177,Lord of Illusions,1995,lord_of_illusions,5.7,19,13,6,68,0,2,1,1,50,3,2344,51,http://content9.flixster.com/movie/28/75/287599_det.jpg
178,Love & Human Remains,1993,love-and-human-remains,6.5,11,7,4,63,0,4,2,2,50,0,0,0,http://content9.flixster.com/movie/84/22/68/8422687_det.jpg
179,Mad Love,1995,bad_love,0,0,0,0,0,0,0,0,0,0,0,0,0,http://content9.flixster.com/movie/10/97/32/10973279_det.jpg
180,Mallrats,1995,mallrats,5.4,40,21,19,52,5,9,2,7,22,3.6,40221,83,http://content6.flixster.com/movie/11/15/34/11153460_det.jpg
181,Mighty Morphin Power Rangers: The Movie,1995,mighty_morphin_power_rangers_the_movie,4.6,19,8,11,42,5.5,8,5,3,62,2.7,5904,52,http://content8.flixster.com/movie/26/01/260110_det.jpg
182,Moonlight and Valentino,1995,moonlight_and_valentino,4.6,13,2,11,15,0,3,0,3,0,3.1,978,51,http://content9.flixster.com/movie/10/91/91/10919195_det.jpg
183,Mute Witness,1994,mute_witness,6.9,19,15,4,78,7.3,6,5,1,83,3.2,644,61,http://content6.flixster.com/movie/27/75/277592_det.jpg
184,Nadja,1994,the-case-of-the-white-chapel-vampire-the-royal-scandal2001,0,0,0,0,0,0,0,0,0,0,0,0,0,http://content8.flixster.com/movie/10/89/08/10890894_det.jpg
185,The Net,1995,net,5.1,33,11,22,33,6.9,5,3,2,60,2.8,10933,50,http://content9.flixster.com/movie/68/77/57/6877579_det.jpg
186,Nine Months,1995,nine_months,4.3,24,6,18,25,5,5,1,4,20,2.7,8930,40,http://content7.flixster.com/movie/10/91/49/10914937_det.jpg
187,Party Girl,1995,1066050-party_girl,6.3,31,24,7,77,6,13,8,5,61,3.5,1243,73,http://content8.flixster.com/movie/10/85/91/10859166_det.jpg
188,The Prophecy,1995,1065632-prophecy,5.2,19,8,11,42,0,1,0,1,0,3.3,5062,71,http://content6.flixster.com/movie/26/79/267992_det.jpg
189,The Reckless Moment,1949,reckless_moment,0,3,3,0,100,0,0,0,0,0,0,0,0,http://content6.flixster.com/movie/55/32/82/5532828_det.jpg
190,Fail-Safe,1964,failsafe,7.6,13,12,1,92,0,0,0,0,0,0,0,0,http://content9.flixster.com/movie/29/23/292315_det.jpg
191,The Scarlet Letter,1995,1066120-scarlet_letter,3,33,5,28,15,3.6,11,1,10,9,2.9,3493,48,http://content7.flixster.com/movie/10/86/16/10861633_det.jpg
193,Showgirls,1995,showgirls,2.9,41,5,36,12,3.4,10,0,10,0,2.3,7443,35,http://content8.flixster.com/movie/28/55/285598_det.jpg
194,Smoke,1995,1062983-smoke,7.8,27,25,2,92,0,4,3,1,75,3.9,3101,88,http://content7.flixster.com/movie/27/30/273025_det.jpg
195,Something to Talk About,1995,something_to_talk_about,5.3,27,10,17,37,6.5,9,5,4,55,3,6137,55,http://content8.flixster.com/movie/93/24/35/9324358_det.jpg
196,Species,1995,species,4.9,31,12,19,38,5.1,5,1,4,20,2.7,6716,37,http://content7.flixster.com/movie/66/42/83/6642833_det.jpg
197,The Stars Fell on Henrietta,1995,stars_fell_on_henrietta,4.9,7,2,5,28,0,1,0,1,0,3,66,18,http://content7.flixster.com/movie/10/85/18/10851893_det.jpg
198,Strange Days,1995,strange_days,6,38,23,15,60,5.9,8,4,4,50,3.3,7016,70,http://content8.flixster.com/movie/27/10/271010_det.jpg
199,Les parapluies de Cherbourg,1964,umbrellas_of_cherbourg,8.6,45,44,1,97,7.9,10,9,1,90,4.1,3199,86,http://content9.flixster.com/movie/30/89/308923_det.jpg
200,The Tie That Binds,1995,tie_that_binds,2.8,9,1,8,11,0,3,0,3,0,3,286,34,http://content9.flixster.com/movie/10/91/94/10919459_det.jpg
201,Three Wishes,1995,three_wishes,4.4,15,2,13,13,0,4,0,4,0,3,1249,52,http://content7.flixster.com/movie/26/05/260509_det.jpg
202,Total Eclipse,1995,total_eclipse,4.9,16,4,12,25,0,4,1,3,25,3.4,2222,63,http://content6.flixster.com/movie/11/14/92/11149252_det.jpg
203,"To Wong Foo Thanks for Everything, Julie Newmar",1995,to_wong_foo_thanks_for_everything_julie_newmar,5,23,8,15,34,5.2,5,0,5,0,3.1,6833,69,http://content9.flixster.com/movie/10/88/06/10880663_det.jpg
204,Under Siege 2: Dark Territory,1995,under_siege_2_dark_territory,4.5,29,10,19,34,0,3,2,1,66,2.6,5213,47,http://content6.flixster.com/movie/27/23/272392_det.jpg
205,Unstrung Heroes,1995,unstrung_heroes,6.3,21,16,5,76,0,4,2,2,50,3.2,530,54,http://content8.flixster.com/movie/26/44/264406_det.jpg
206,Unzipped,1995,unzipped,6.7,13,10,3,76,7.9,5,5,0,100,3.3,64,67,http://content6.flixster.com/movie/10/86/36/10863660_det.jpg
207,A Walk in the Clouds,1995,walk_in_the_clouds,5.5,22,9,13,40,0,3,1,2,33,3.3,12692,74,http://content7.flixster.com/movie/10/89/20/10892013_det.jpg
208,Waterworld,1995,waterworld,5.1,48,20,28,41,6.4,9,7,2,77,2.6,18023,46,http://content9.flixster.com/movie/25/75/257591_det.jpg
209,White Man's Burden,1995,1067214-white_mans_burden,4.5,32,8,24,25,4.4,10,1,9,10,2.8,1275,38,http://content7.flixster.com/movie/27/54/275405_det.jpg
210,Wild Bill,1995,,\N,\N,\N,\N,\N,\N,\N,\N,\N,\N,\N,\N,\N,\N
211,The Browning Version,1951,1043923-browning_version,7.8,17,15,2,88,0,3,1,2,33,4.3,270,94,http://content7.flixster.com/movie/10/83/88/10838841_det.jpg
212,Bushwhacked,1995,bushwhacked,2.1,9,0,9,0,0,2,0,2,0,2.6,1388,38,http://content9.flixster.com/movie/91/58/09/9158095_det.jpg
213,Utomlyonnye solntsem,1994,burnt_by_the_sun,7,13,10,3,76,0,4,3,1,75,4.3,1533,93,http://content8.flixster.com/movie/27/23/272326_det.jpg
214,Before the Rain,1994,before_the_rain,7.5,12,10,2,83,0,2,2,0,100,4.4,1683,93,http://content6.flixster.com/movie/10/89/78/10897876_det.jpg
215,Before Sunrise,1995,before_sunrise,8.2,34,34,0,100,9.3,5,5,0,100,4.1,20616,92,http://content7.flixster.com/movie/10/85/60/10856081_det.jpg
216,Billy Madison,1995,billy_madison,4.8,35,15,20,42,0,4,1,3,25,3.5,91595,79,http://content6.flixster.com/movie/26/12/261212_det.jpg
217,The Babysitters,2007,babysitters,4.4,26,8,18,30,4.6,12,3,9,25,2.9,1237,35,http://content9.flixster.com/movie/10/84/14/10841411_det.jpg
218,Boys on the Side,1995,boys_on_the_side,6,32,23,9,71,6.1,8,5,3,62,3.1,4572,65,http://content6.flixster.com/movie/27/12/271228_det.jpg
219,The Cure,1995,1061860-cure,5.5,10,4,6,40,0,4,1,3,25,3.7,2207,79,http://content9.flixster.com/movie/10/86/12/10861271_det.jpg
220,Castle Freak,1995,castle_freak,5.4,7,4,3,57,0,0,0,0,0,0,0,0,http://content9.flixster.com/movie/10/89/86/10898627_det.jpg
222,Circle of Friends,1995,1059480-circle_of_friends,6.5,35,27,8,77,6.5,11,8,3,72,3.3,3292,65,http://content7.flixster.com/movie/10/91/53/10915357_det.jpg
223,Clerks.,1994,clerks,7.4,48,42,6,87,7.1,9,8,1,88,3.8,57642,89,http://content8.flixster.com/movie/10/93/69/10936950_det.jpg
224,Don Juan DeMarco,1994,don-juan-demarco,5.8,22,16,6,72,0,2,1,1,50,3.3,14169,70,http://content9.flixster.com/movie/25/52/255207_det.jpg
225,Disclosure,1994,disclosure,5.7,40,24,16,60,5.8,9,5,4,55,2.8,3648,41,http://content8.flixster.com/movie/27/42/274202_det.jpg
226,Tucker: The Man and His Dream,1988,tucker_the_man_and_his_dream,7.2,35,30,5,85,6.8,7,5,2,71,3.2,1497,58,http://content7.flixster.com/movie/25/57/255709_det.jpg
227,Drop Zone,1994,drop_zone,4.1,19,6,13,31,0,3,1,2,33,2.7,2485,36,http://content9.flixster.com/movie/27/31/273103_det.jpg
228,Destiny Turns on the Radio,1995,destiny_turns_on_the_radio,2.7,15,2,13,13,0,2,0,2,0,2.6,446,27,http://content8.flixster.com/movie/71/21/48/7121486_det.jpg
229,Death and the Maiden,1994,death_and_the_maiden,7,48,40,8,83,6.2,10,7,3,70,3.6,1972,76,http://content9.flixster.com/movie/10/92/35/10923515_det.jpg
230,Dolores Claiborne,1995,dolores_claiborne,6.8,33,28,5,84,0,4,3,1,75,3.4,4632,75,http://content6.flixster.com/movie/26/92/269216_det.jpg
231,Dumb & Dumber,1994,dumb_and_dumber,5.8,45,28,17,62,4.8,10,4,6,40,3.3,95871,79,http://content6.flixster.com/movie/25/45/254516_det.jpg
232,Yin shi nan nu,1994,eat_drink_man_woman,7.4,31,29,2,93,7.9,8,8,0,100,4,3802,91,http://content8.flixster.com/movie/28/62/286218_det.jpg
233,Exotica,1994,exotica,8.3,27,26,1,96,0,3,3,0,100,3.7,1837,81,http://content8.flixster.com/movie/27/34/273426_det.jpg
234,Exit to Eden,1994,exit_to_eden,2.4,15,1,14,6,0,3,0,3,0,2.3,1694,27,http://content8.flixster.com/movie/26/84/268410_det.jpg
235,Ed Wood,1994,ed_wood,7.9,57,52,5,91,7.2,12,9,3,75,3.7,28216,83,http://content9.flixster.com/movie/10/88/97/10889755_det.jpg
236,French Kiss,1995,french_kiss,5.7,21,10,11,47,0,4,1,3,25,3.2,11010,70,http://content6.flixster.com/movie/10/83/82/10838220_det.jpg
237,Forget Paris,1995,forget_paris,5.4,33,17,16,51,4.7,8,2,6,25,3,2108,51,http://content7.flixster.com/movie/25/90/259029_det.jpg
238,Far from Home: The Adventures of Yellow Dog,1995,far_from_home_the_adventures_of_yellow_dog,5.2,6,3,3,50,0,0,0,0,0,0,0,0,http://content8.flixster.com/movie/26/37/263710_det.jpg
239,A Goofy Movie,1995,goofy_movie,5.7,14,8,6,57,0,2,1,1,50,3.1,17024,57,http://content6.flixster.com/movie/25/16/251608_det.jpg
240,Hideaway,1995,1060518-hideaway,3.5,12,2,10,16,0,4,1,3,25,2.8,1077,41,http://content6.flixster.com/movie/28/06/280696_det.jpg
241,Fluke,1995,fluke,4,9,3,6,33,0,3,0,3,0,3.4,1598,70,http://content9.flixster.com/movie/25/77/257791_det.jpg
242,Farinelli,1994,farinelli,5.7,21,14,7,66,4.7,6,2,4,33,3.8,1092,81,http://content8.flixster.com/movie/27/15/271518_det.jpg
243,Flash Gordon,1980,1007517-flash_gordon,6.3,32,26,6,81,0,3,2,1,66,3.1,6492,64,http://content7.flixster.com/movie/25/73/257321_det.jpg
244,Gumby: The Movie,1995,gumby_the_movie,0,4,0,4,0,0,0,0,0,0,0,0,0,http://content9.flixster.com/movie/10/94/41/10944103_det.jpg
245,The Glass Shield,1994,glass_shield,5.6,21,13,8,61,5.2,7,3,4,42,3,263,41,http://content9.flixster.com/movie/26/60/266023_det.jpg
246,Hoop Dreams,1994,hoop_dreams,8.5,44,43,1,97,8.1,12,12,0,100,4.1,3243,92,http://content6.flixster.com/movie/76/93/769348_det.jpg
247,Heavenly Creatures,1994,heavenly_creatures,8.3,41,39,2,95,7.8,9,9,0,100,3.7,8208,82,http://content9.flixster.com/movie/10/90/75/10907555_det.jpg
248,Houseguest,1995,houseguest,3.4,20,3,17,15,5.2,5,3,2,60,2.8,1745,51,http://content7.flixster.com/movie/26/06/260693_det.jpg
249,Immortal Beloved,1994,immortal_beloved,6,30,17,13,56,0,3,2,1,66,3.8,4786,87,http://content7.flixster.com/movie/26/75/267513_det.jpg
250,Heavy Weights,1995,1059860-heavyweights,4.1,5,1,4,20,0,0,0,0,0,0,0,0,http://content6.flixster.com/movie/10/93/03/10930316_det.jpg
251,The Hunted,2003,1120843-hunted,4.7,143,44,99,30,4.5,34,10,24,29,3,5362,51,http://content9.flixster.com/movie/11/13/64/11136427_det.jpg
252,I.Q.,1994,iq,5.1,21,9,12,42,0,3,1,2,33,2.8,3758,46,http://content8.flixster.com/movie/10/91/74/10917466_det.jpg
253,Interview with the Vampire: The Vampire Chronicles,1994,interview_with_the_vampire,5.8,45,26,19,57,4.6,10,4,6,40,3.7,77706,85,http://content6.flixster.com/movie/28/01/280124_det.jpg
254,Jefferson in Paris,1995,jefferson_in_paris,4.9,14,5,9,35,0,3,1,2,33,2.8,404,27,http://content6.flixster.com/movie/26/30/263024_det.jpg
255,The Jerky Boys,1995,jerky_boys_the_the_movie,1.6,10,1,9,10,0,0,0,0,0,0,0,0,http://content8.flixster.com/movie/62/23/13/6223134_det.jpg
256,Junior,1994,1058426-junior,4.7,30,10,20,33,5.8,8,5,3,62,2.4,9754,28,http://content8.flixster.com/movie/10/84/29/10842998_det.jpg
257,Just Cause,1995,just_cause,4,26,6,20,23,4.2,8,2,6,25,3.1,2888,51,http://content8.flixster.com/movie/10/87/09/10870958_det.jpg
258,A Kid in King Arthur's Court,1995,kid_in_king_arthurs_court,3.2,6,0,6,0,0,0,0,0,0,0,0,0,http://content9.flixster.com/movie/26/31/263115_det.jpg
259,Kiss of Death,1995,1060720-kiss_of_death,6.4,36,24,12,66,7.2,12,9,3,75,2.9,2125,39,http://content6.flixster.com/movie/27/76/277616_det.jpg
260,Star Wars,1977,star_wars,8.2,64,60,4,93,7.4,17,15,2,88,4.1,147448,93,http://content9.flixster.com/movie/10/94/47/10944715_det.jpg
261,Little Women,1994,1190049-little_women,0,0,0,0,0,0,0,0,0,0,0,0,0,http://content7.flixster.com/movie/10/86/52/10865225_det.jpg
262,A Little Princess,1995,1061812-little_princess,8.4,20,19,1,95,0,3,3,0,100,3.4,13643,81,http://content6.flixster.com/movie/29/07/290716_det.jpg
263,Ladybird Ladybird,1994,ladybird_ladybird,7.2,6,4,2,66,0,2,2,0,100,4,368,87,http://content9.flixster.com/movie/92/74/35/9274359_det.jpg
264,L'enfer,1994,1059177-lenfer,7.9,8,8,0,100,0,1,1,0,100,3.5,421,67,http://content8.flixster.com/movie/10/88/73/10887306_det.jpg
265,Como agua para chocolate,1992,like_water_for_chocolate,7.6,28,25,3,89,0,3,3,0,100,3.9,5713,86,http://content9.flixster.com/movie/10/89/25/10892515_det.jpg
266,Legends of the Fall,1994,chris-smither-one-more-night2007,0,0,0,0,0,0,0,0,0,0,0,0,0,http://content6.flixster.com/movie/10/90/03/10900344_det.jpg
267,Major Payne,1995,major_payne,4.6,10,3,7,30,0,2,1,1,50,2.9,8555,69,http://content9.flixster.com/movie/25/69/256903_det.jpg
268,Little Odessa,1994,little_odessa,5.8,17,11,6,64,0,3,1,2,33,3.5,985,69,http://content9.flixster.com/movie/28/36/283627_det.jpg
269,Mi vida loca,1993,mi_vida_loca_my_crazy_life,6.6,15,12,3,80,0,3,2,1,66,3.9,2251,81,http://content8.flixster.com/movie/10/85/41/10854174_det.jpg
270,Love Affair,1994,1056341-love_affair,4.8,26,8,18,30,0,3,1,2,33,3.5,1260,71,http://content8.flixster.com/movie/25/75/257510_det.jpg
271,Losing Isaiah,1995,losing_isaiah,5.1,28,12,16,42,5,9,4,5,44,3.6,2364,76,http://content7.flixster.com/movie/27/48/274897_det.jpg
272,The Madness of King George,1994,madness_of_king_george,7.8,42,39,3,92,8.1,10,10,0,100,3.6,1886,76,http://content6.flixster.com/movie/10/88/81/10888184_det.jpg
273,Frankenstein,1931,1007818-frankenstein,8.5,38,38,0,100,7.8,5,5,0,100,3.6,7211,81,http://content8.flixster.com/movie/28/83/288310_det.jpg
274,Man of the House,2005,man_of_the_house,3.3,60,5,55,8,3.9,16,4,12,25,3.1,10877,59,http://content9.flixster.com/movie/10/91/27/10912719_det.jpg
275,Mixed Nuts,1994,mixed_nuts,2.8,28,2,26,7,2.5,6,0,6,0,2.9,2410,46,http://content9.flixster.com/movie/10/93/94/10939467_det.jpg
276,Milk Money,1994,1055255-milk_money,2.6,25,1,24,4,2.5,8,0,8,0,2.7,2126,40,http://content7.flixster.com/movie/25/98/259809_det.jpg
277,Miracle on 34th Street,1947,1013970-miracle_on_34th_street,8,31,29,2,93,0,2,2,0,100,3.5,5409,81,http://content7.flixster.com/movie/29/05/290513_det.jpg
278,Miami Rhapsody,1995,miami_rhapsody,6.1,18,8,10,44,0,3,2,1,66,2.6,766,28,http://content6.flixster.com/movie/26/49/264916_det.jpg
279,My Family,1995,my_family,7.2,11,9,2,81,0,3,3,0,100,3.9,1137,85,http://content8.flixster.com/movie/26/95/269594_det.jpg
280,Murder in the First,1995,murder_in_the_first,5.5,34,17,17,50,4.8,10,4,6,40,3.5,3888,78,http://content6.flixster.com/movie/27/53/275304_det.jpg
281,Nobody's Fool,1986,1015224-nobodys_fool,0,4,0,4,0,0,1,0,1,0,3,289,43,http://content6.flixster.com/movie/26/56/265692_det.jpg
282,Nell,1994,nell,5,31,16,15,51,0,3,3,0,100,3.1,5373,63,http://content8.flixster.com/movie/25/69/256906_det.jpg
283,New Jersey Drive,1995,new_jersey_drive,6.5,7,4,3,57,0,3,2,1,66,3.8,814,81,http://content6.flixster.com/movie/28/25/282508_det.jpg
284,Ny√ª Y√¥ku no koppu,1993,new_york_cop,0,0,0,0,0,0,0,0,0,0,0,0,0,http://content6.flixster.com/movie/10/97/24/10972404_det.jpg
285,Beyond Bedlam,1994,nightscare,0,1,0,1,0,0,0,0,0,0,0,0,0,http://content8.flixster.com/movie/10/80/07/10800750_det.jpg
286,Nemesis 2: Nebula,1995,nemesis_2,0,0,0,0,0,0,0,0,0,0,0,0,0,http://content8.flixster.com/movie/10/88/48/10884886_det.jpg
287,Nina Takes a Lover,1994,nina_takes_a_lover,5.2,6,3,3,50,0,2,0,2,0,3.4,125,52,http://content8.flixster.com/movie/62/32/18/6232186_det.jpg
288,Natural Born Killers,1994,natural_born_killers,6,29,15,14,51,5.9,7,3,4,42,3.5,39062,80,http://content8.flixster.com/movie/10/88/54/10885402_det.jpg
289,Only You,1994,1055875-only_you,5.5,22,11,11,50,0,3,1,2,33,3.3,4388,69,http://content9.flixster.com/movie/25/51/255111_det.jpg
290,Once Were Warriors,1994,once_were_warriors,7.7,31,29,2,93,7.4,8,7,1,87,0,0,0,http://content7.flixster.com/movie/29/03/290325_det.jpg
291,Poison Ivy II,1996,poison_ivy_2_lily,3.8,6,1,5,16,0,0,0,0,0,0,0,0,http://content6.flixster.com/movie/27/08/270820_det.jpg
292,Outbreak,1995,outbreak,5.6,41,24,17,58,5.1,10,4,6,40,3.1,10732,55,http://content7.flixster.com/movie/55/37/06/5537065_det.jpg
293,L√©on,1994,professional,6.8,39,30,9,76,5.8,8,4,4,50,4.1,59011,94,http://content7.flixster.com/movie/28/62/286221_det.jpg
294,The Perez Family,1995,perez_family,6.3,15,10,5,66,5.9,5,2,3,40,3.2,500,50,http://content9.flixster.com/movie/27/83/278323_det.jpg
295,A Pyromaniac's Love Story,1995,pyromaniacs_love_story,3.4,9,0,9,0,0,2,0,2,0,3.1,773,44,http://content6.flixster.com/movie/26/55/265524_det.jpg
296,Pulp Fiction,1994,pulp_fiction,8.9,50,47,3,94,8.4,14,13,1,92,4.2,249269,95,http://content9.flixster.com/movie/10/88/65/10886599_det.jpg
297,The Pink Panther 2,2009,pink_panther_2,3.5,128,16,112,12,3.9,25,4,21,16,3.1,77879,48,http://content7.flixster.com/movie/10/86/24/10862497_det.jpg
298,Tui shou,1992,pushing_hands,0,2,2,0,100,0,0,0,0,0,0,0,0,http://content8.flixster.com/movie/10/84/00/10840038_det.jpg
299,Priest,1994,1063814-1063814-priest,7.2,19,13,6,68,0,4,3,1,75,3.8,1042,81,http://content9.flixster.com/movie/11/12/75/11127515_det.jpg
300,Quiz Show,1994,quiz_show,8.1,50,48,2,96,8.2,12,12,0,100,3.5,5428,79,http://content6.flixster.com/movie/25/87/258704_det.jpg
301,Picture Bride,1994,picture_bride,6.8,10,8,2,80,0,3,3,0,100,3.7,324,77,http://content8.flixster.com/movie/26/07/260722_det.jpg
302,La reine Margot,1994,queen_margot,5.9,22,17,5,77,0,2,1,1,50,4,2511,86,http://content7.flixster.com/movie/10/88/68/10886821_det.jpg
303,The Quick and the Dead,1995,1059629-quick_and_the_dead,5.9,39,22,17,56,4.2,8,1,7,12,3.1,12178,56,http://content8.flixster.com/movie/27/21/272198_det.jpg
304,Roommates,1995,roommates,5.1,13,4,9,30,0,2,0,2,0,3.2,387,51,http://content7.flixster.com/movie/26/08/260809_det.jpg
305,Pr√™t-√†-Porter,1994,ready_to_wear,4.8,21,6,15,28,4.3,5,0,5,0,2.5,1885,26,http://content6.flixster.com/movie/27/50/275000_det.jpg
306,Trois couleurs: Rouge,1994,1058966-red,8.5,40,40,0,100,8.2,10,10,0,100,4.2,9557,94,http://content7.flixster.com/movie/10/87/54/10875473_det.jpg
307,Trois couleurs: Bleu,1993,1049109-blue,8.4,32,32,0,100,8,5,5,0,100,4.2,11731,93,http://content7.flixster.com/movie/11/12/07/11120777_det.jpg
308,Trzy kolory: Bialy,1994,white,7.5,31,28,3,90,7.6,9,9,0,100,3.9,5105,86,http://content8.flixster.com/movie/10/87/62/10876274_det.jpg
309,Pao Da Shuang Deng,1994,red_firecracker_green_firecracker,0,4,3,1,75,0,1,0,1,0,4.6,71,100,http://content9.flixster.com/movie/10/89/26/10892695_det.jpg
310,Rent-a-Kid,1995,rentakid,0,0,0,0,0,0,0,0,0,0,0,0,0,http://content6.flixster.com/movie/96/79/10/9679108_det.jpg
312,Stuart Saves His Family,1995,stuart_saves_his_family,4.6,25,7,18,28,5.2,10,3,7,30,2.6,531,44,http://content9.flixster.com/movie/10/84/58/10845847_det.jpg
313,The Swan Princess,1994,swan_princess,5.3,9,4,5,44,0,3,2,1,66,3.1,5951,66,http://content9.flixster.com/movie/10/89/44/10894435_det.jpg
314,The Secret of Roan Inish,1994,the-secret-of-roan-inish,7.8,40,39,1,97,7.5,12,11,1,91,3.9,1439,86,http://content8.flixster.com/movie/10/88/77/10887722_det.jpg
315,The Specialist,1994,1056079-specialist,3.1,24,1,23,4,3.8,5,0,5,0,2.5,5147,34,http://content8.flixster.com/movie/27/73/277302_det.jpg
316,Stargate,1994,stargate,5.2,37,17,20,45,0,4,1,3,25,3.3,23611,75,http://content6.flixster.com/movie/26/48/264812_det.jpg
317,Santa Claus,1985,santa_claus_the_movie,4.1,17,3,14,17,0,1,0,1,0,3.1,2513,66,http://content7.flixster.com/movie/25/49/254909_det.jpg
318,The Shawshank Redemption,1994,shawshank_redemption,8,57,50,7,87,7.9,11,10,1,90,4.4,168839,98,http://content9.flixster.com/movie/11/12/45/11124527_det.jpg
319,Shallow Grave,1994,1058923-shallow_grave,6.4,42,30,12,71,5.4,10,5,5,50,3.6,9041,81,http://content7.flixster.com/movie/28/27/282713_det.jpg
320,Suture,1993,suture,6.2,11,7,4,63,0,3,0,3,0,3.6,236,74,http://content7.flixster.com/movie/10/91/57/10915785_det.jpg
321,Fresa y chocolate,1994,strawberry_and_chocolate,6.6,19,15,4,78,0,2,2,0,100,3.9,848,83,http://content6.flixster.com/movie/10/89/25/10892516_det.jpg
322,Swimming with Sharks,1994,swimming_with_sharks,6.3,33,25,8,75,5.4,10,5,5,50,3.6,2888,78,http://content7.flixster.com/movie/27/81/278121_det.jpg
324,The Sum of Us,1994,sum_of_us,6.5,13,9,4,69,0,2,1,1,50,3.6,1056,74,http://content6.flixster.com/movie/27/41/274112_det.jpg
325,Senior Trip,1995,national_lampoons_senior_trip,2.6,7,0,7,0,0,1,0,1,0,3,1370,53,http://content7.flixster.com/movie/10/86/94/10869433_det.jpg
326,Huozhe,1994,huozhe-to-live-lifetimes-living,8.1,14,12,2,85,0,3,3,0,100,4.3,1836,95,http://content8.flixster.com/movie/10/97/19/10971966_det.jpg
327,Tank Girl,1995,tank_girl,4.9,33,14,19,42,5.3,9,4,5,44,2.8,7013,61,http://content8.flixster.com/movie/10/91/40/10914042_det.jpg
328,Tales from the Crypt: Demon Knight,1995,tales_from_the_crypt_presents_demon_knight,4,23,7,16,30,3.4,7,1,6,14,3.2,4989,63,http://content9.flixster.com/movie/10/88/79/10887979_det.jpg
329,Star Trek: Generations,1994,star_trek_generations,5.5,44,20,24,45,6.4,9,6,3,66,3.3,15342,62,http://content6.flixster.com/movie/10/88/86/10888600_det.jpg
330,Tales from the Hood,1995,tales_from_the_hood,4.3,15,5,10,33,0,2,1,1,50,3.1,2119,58,http://content9.flixster.com/movie/27/30/273091_det.jpg
331,Tom & Viv,1994,tom_and_viv,4.8,11,4,7,36,0,2,1,1,50,3.4,351,59,http://content7.flixster.com/movie/26/43/264309_det.jpg
332,Village of the Damned,1995,1061401-village_of_the_damned,4,30,9,21,30,4.2,5,2,3,40,2.7,4194,36,http://content6.flixster.com/movie/11/15/07/11150724_det.jpg
333,Tommy Boy,1995,tommy_boy,5.2,38,17,21,44,3.6,6,1,5,16,3.6,34476,89,http://content6.flixster.com/movie/26/58/265820_det.jpg
334,Vanya on 42nd Street,1994,vanya_on_42nd_street,7.6,32,28,4,87,7.7,9,8,1,88,3.7,466,73,http://content8.flixster.com/movie/10/92/26/10922666_det.jpg
335,Underneath,1995,underneath,5.7,19,10,9,52,5.8,8,3,5,37,3,405,36,http://content8.flixster.com/movie/28/03/280322_det.jpg
336,Incubo sulla citt√† contaminata,1980,nightmare_city,0,4,2,2,50,0,0,0,0,0,0,0,0,http://content6.flixster.com/movie/10/89/70/10897052_det.jpg
337,What's Eating Gilbert Grape,1993,whats_eating_gilbert_grape,7.3,42,37,5,88,5.8,9,6,3,66,3.7,57512,86,http://content8.flixster.com/movie/25/42/254226_det.jpg
338,Virtuosity,1995,virtuosity,4.3,29,10,19,34,4,8,2,6,25,2.8,4167,37,http://content7.flixster.com/movie/27/58/275825_det.jpg
339,While You Were Sleeping,1995,while_you_were_sleeping,6.5,41,35,6,85,6.5,13,11,2,84,3.2,25923,75,http://content7.flixster.com/movie/63/59/09/6359097_det.jpg
340,War,2007,the-secret-war,0,0,0,0,0,0,0,0,0,0,0,0,0,http://content7.flixster.com/movie/10/84/31/10843105_det.jpg
341,Double Happiness,1994,double_happiness,7,10,7,3,70,0,2,2,0,100,3.4,627,61,http://content9.flixster.com/movie/51/27/62/5127627_det.jpg
342,Muriel's Wedding,1994,muriels_wedding,7.1,32,29,3,90,0,4,4,0,100,3.4,8356,78,http://content7.flixster.com/movie/26/76/267629_det.jpg
343,The Baby-Sitters Club,1995,babysitters_club_the_movie,6,15,9,6,60,6.1,7,3,4,42,2.9,1930,46,http://content6.flixster.com/movie/26/16/261608_det.jpg
344,Ace Ventura: Pet Detective,1994,ace_ventura_pet_detective,4.6,37,18,19,48,0,2,0,2,0,3.1,163811,57,http://content7.flixster.com/movie/11/14/42/11144273_det.jpg
345,"The Adventures of Priscilla, Queen of the Desert",1994,adventures_of_priscilla_queen_of_the_desert,7,29,27,2,93,7,6,5,1,83,3.7,8695,84,http://content8.flixster.com/movie/11/15/32/11153218_det.jpg
346,Backbeat,1994,backbeat,6.2,34,25,9,73,6.5,9,6,3,66,3.3,926,67,http://content7.flixster.com/movie/28/07/280793_det.jpg
347,Bitter Moon,1992,bitter-moon,6.2,29,19,10,65,4.7,8,3,5,37,3.8,3436,79,http://content8.flixster.com/movie/27/35/273518_det.jpg
348,Bullets Over Broadway,1994,bullets_over_broadway,7.9,54,52,2,96,8.2,12,12,0,100,3.6,3913,79,http://content8.flixster.com/movie/26/94/269498_det.jpg
349,Clear and Present Danger,1994,clear_and_present_danger,6.8,37,29,8,78,7.1,9,7,2,77,3.3,11095,69,http://content6.flixster.com/movie/26/52/265216_det.jpg
350,The Client,1994,client,6.1,35,28,7,80,6.2,7,5,2,71,3.3,7408,67,http://content8.flixster.com/movie/26/01/260102_det.jpg
351,"Corrina, Corrina",1994,corrina_corrina,5.2,16,6,10,37,0,3,0,3,0,3.1,4265,65,http://content7.flixster.com/movie/25/88/258897_det.jpg
352,Crooklyn,1994,crooklyn,6.6,24,18,6,75,6.8,7,6,1,85,4.1,3115,87,http://content7.flixster.com/movie/25/71/257101_det.jpg
353,The Crow,1994,crow,7,40,33,7,82,6.9,8,6,2,75,3.8,64467,87,http://content6.flixster.com/movie/10/93/21/10932156_det.jpg
354,Cobb,1994,cobb,6.2,32,21,11,65,5.2,8,4,4,50,3.2,875,57,http://content7.flixster.com/movie/27/09/270909_det.jpg
355,The Flintstones,1994,1051663-flintstones,3.7,40,8,32,20,4.5,7,2,5,28,2.5,11823,35,http://content7.flixster.com/movie/10/87/96/10879629_det.jpg
356,Forrest Gump,1994,forrest_gump,6.9,53,37,16,69,7,13,9,4,69,4.1,205253,93,http://content7.flixster.com/movie/60/49/71/6049713_det.jpg
357,Four Weddings and a Funeral,1994,four_weddings_and_a_funeral,7.5,49,47,2,95,7.3,9,8,1,88,3.2,21524,68,http://content7.flixster.com/movie/28/17/281725_det.jpg
358,Higher Learning,1995,higher_learning,5.3,34,17,17,50,4.6,11,4,7,36,3.5,4026,77,http://content7.flixster.com/movie/33/06/29/3306293_det.jpg
359,I Like It Like That,1994,i_like_it_like_that,7.4,9,7,2,77,0,3,3,0,100,4,625,85,http://content8.flixster.com/movie/27/50/275006_det.jpg
360,I Love Trouble,1994,,\N,\N,\N,\N,\N,\N,\N,\N,\N,\N,\N,\N,\N,\N
361,It Could Happen to You,1994,1054344-it_could_happen_to_you,6.2,34,23,11,67,6.2,8,6,2,75,3,6180,53,http://content9.flixster.com/movie/25/86/258695_det.jpg
362,The Jungle Book,1967,1031385-jungle_book,7.3,27,24,3,88,0,2,1,1,50,3.5,35715,70,http://content7.flixster.com/movie/25/07/250701_det.jpg
363,Die Macht der Bilder: Leni Riefenstahl,1993,wonderful_horrible_life_of_leni_riefenstahl,7.6,22,21,1,95,0,4,3,1,75,3.7,257,81,http://content7.flixster.com/movie/29/44/294405_det.jpg
364,The Lion King,1994,lion_king,8,61,56,5,91,7.8,13,13,0,100,3.9,127550,89,http://content7.flixster.com/movie/25/07/250709_det.jpg
365,Little Buddha,1993,little_buddha,5.8,22,14,8,63,6.4,7,4,3,57,3.1,2898,50,http://content8.flixster.com/movie/25/64/256422_det.jpg
366,New Nightmare,1994,wes_cravens_new_nightmare,6.6,31,25,6,80,6.3,9,7,2,77,3.2,11902,65,http://content7.flixster.com/movie/11/13/01/11130129_det.jpg
367,The Mask,1994,1053779-mask,6.4,44,33,11,75,6.1,9,5,4,55,3.2,68419,66,http://content6.flixster.com/movie/62/33/43/6233432_det.jpg
368,Maverick,1994,maverick,6,37,26,11,70,7.4,6,6,0,100,3.2,11507,68,http://content7.flixster.com/movie/25/61/256125_det.jpg
369,Mrs. Parker and the Vicious Circle,1994,mrs_parker_and_the_vicious_circle,6.3,24,17,7,70,0,3,2,1,66,3.5,634,62,http://content8.flixster.com/movie/10/93/78/10937814_det.jpg
370,Naked Gun 33 1/3: The Final Insult,1994,naked_gun_33_13_the_final_insult,5.6,32,17,15,53,7,7,6,1,85,2.9,10482,59,http://content6.flixster.com/movie/10/93/73/10937364_det.jpg
371,The Paper,1994,paper,6.7,31,27,4,87,6.9,7,6,1,85,3.1,1357,54,http://content9.flixster.com/movie/10/95/42/10954299_det.jpg
372,Reality Bites,1994,reality_bites,6,42,27,15,64,6.1,9,5,4,55,3.3,10533,74,http://content6.flixster.com/movie/10/87/05/10870532_det.jpg
373,Red Rock West,1993,red_rock_west,7.5,37,35,2,94,7.2,8,7,1,87,0,0,0,http://content6.flixster.com/movie/27/59/275920_det.jpg
374,Ri¬¢hie Ri¬¢h,1994,richie_rich,4.2,20,5,15,25,4.8,5,2,3,40,2.5,10242,38,http://content6.flixster.com/movie/10/94/80/10948008_det.jpg
375,Safe Passage,1994,safe_passage,5.8,12,6,6,50,0,3,1,2,33,3.4,310,59,http://content8.flixster.com/movie/10/86/70/10867050_det.jpg
376,The River Wild,1994,river_wild,5.8,27,15,12,55,5.8,6,3,3,50,2.9,5610,50,http://content8.flixster.com/movie/10/92/73/10927394_det.jpg
377,Speed,1994,1052692-1052692-speed,7.6,41,37,4,90,7.1,9,7,2,77,3.3,51008,72,http://content6.flixster.com/movie/27/61/276116_det.jpg
378,Speechless,1994,speechless,3.9,25,3,22,12,3.8,6,0,6,0,2.8,683,34,http://content9.flixster.com/movie/11/12/48/11124819_det.jpg
379,Timecop,1994,timecop,5.3,38,18,20,47,5.1,9,4,5,44,2.6,6534,38,http://content6.flixster.com/movie/11/12/53/11125356_det.jpg
380,True Lies,1994,true_lies,6.4,45,31,14,68,5.4,9,5,4,55,3.2,27905,70,http://content8.flixster.com/movie/31/37/313714_det.jpg
381,When a Man Loves a Woman,1994,when_a_man_loves_a_woman,6.5,19,13,6,68,0,3,2,1,66,3.3,6791,76,http://content6.flixster.com/movie/26/88/268892_det.jpg
382,Wolf,1994,1053942-wolf,5.9,48,29,19,60,5.9,8,5,3,62,2.8,6634,43,http://content7.flixster.com/movie/10/26/03/10260341_det.jpg
383,Wyatt Earp,1994,1052698-wyatt_earp,5.3,26,11,15,42,0,3,0,3,0,3.2,8070,63,http://content7.flixster.com/movie/55/06/10/5506105_det.jpg
384,Bad Company,2002,1114548-bad_company,3.9,134,14,120,10,4,31,5,26,16,2.8,6415,42,http://content6.flixster.com/movie/26/66/266604_det.jpg
385,A Man of No Importance,1994,man_of_no_importance,7,12,10,2,83,0,3,2,1,66,3.6,111,62,http://content9.flixster.com/movie/10/88/98/10889863_det.jpg
386,S.F.W.,1994,sfw,3.2,16,2,14,12,0,2,0,2,0,3,1184,49,http://content7.flixster.com/movie/27/88/278813_det.jpg
387,A Low Down Dirty Shame,1994,low_down_dirty_shame,3.6,20,0,20,0,3.5,6,0,6,0,2.9,3460,58,http://content7.flixster.com/movie/27/42/274201_det.jpg
388,This Boy's Life,1993,this_boys_life,6.3,34,26,8,76,5,10,4,6,40,3.5,5072,76,http://content7.flixster.com/movie/10/89/12/10891257_det.jpg
389,Le colonel Chabert,1994,1058427-colonel_chabert,7.1,6,5,1,83,0,1,1,0,100,3.6,142,59,http://content6.flixster.com/movie/10/92/93/10929336_det.jpg
390,"Faster, Pussycat! Kill! Kill!",1965,faster_pussycat_kill_kill,6.9,25,18,7,72,0,3,2,1,66,3.8,3351,77,http://content8.flixster.com/movie/11/69/36/1169362_det.jpg
391,Jason's Lyric,1994,jasons_lyric,6,14,10,4,71,0,3,2,1,66,4,2470,87,http://content9.flixster.com/movie/52/53/79/5253791_det.jpg
392,The Secret Adventures of Tom Thumb,1993,secret_adventures_of_tom_thumb,6.3,5,4,1,80,0,0,0,0,0,0,0,0,http://content8.flixster.com/movie/10/86/72/10867206_det.jpg
393,Street Fighter,1994,1058516-street_fighter,2.9,24,3,21,12,0,4,0,4,0,2.2,10305,25,http://content9.flixster.com/movie/10/87/27/10872731_det.jpg
394,In Cold Blood,1967,1010448-in_cold_blood,8.3,25,22,3,88,7.8,5,4,1,80,3.8,2614,83,http://content6.flixster.com/movie/10/87/75/10877588_det.jpg
395,Desert Winds,1995,desert_winds,4.3,9,2,7,22,4.5,6,2,4,33,4,36,100,http://content7.flixster.com/movie/10/85/18/10851869_det.jpg
396,Fall Time,1995,fall_time,0,3,0,3,0,0,0,0,0,0,0,0,0,http://content9.flixster.com/movie/63/57/62/6357627_det.jpg
397,Cape Fear,1991,1037581-cape_fear,6.9,38,29,9,76,8.3,6,6,0,100,3.4,13943,74,http://content9.flixster.com/movie/10/93/72/10937223_det.jpg
398,Frank and Ollie,1995,frank-and-ollie,7.3,8,7,1,87,0,1,1,0,100,3.9,177,83,http://content9.flixster.com/movie/26/14/261491_det.jpg
401,Mirage,1965,1013976-mirage,0,3,2,1,66,0,0,0,0,0,0,0,0,http://content8.flixster.com/movie/10/85/38/10853846_det.jpg
402,Open Season,2006,open_season,5.4,98,46,52,46,5.7,24,13,11,54,3.4,91895,66,http://content8.flixster.com/movie/10/91/66/10916662_det.jpg
404,Brother Minister: The Assassination of Malcolm X,1994,brother_minister,0,1,1,0,100,0,1,1,0,100,4.2,76,90,http://content6.flixster.com/movie/10/88/20/10882016_det.jpg
405,Highlander III: The Sorcerer,1994,highlander1994,0,0,0,0,0,0,0,0,0,0,0,0,0,http://content6.flixster.com/movie/10/94/47/10944768_det.jpg
406,Federal Hill,1994,federal_hill,6.4,15,12,3,80,6.2,9,6,3,66,3,131,41,http://content7.flixster.com/movie/28/10/281025_det.jpg
407,In the Mouth of Madness,1995,in_the_mouth_of_madness,5,29,14,15,48,4.6,7,2,5,28,3.5,5731,73,http://content9.flixster.com/movie/10/88/81/10888183_det.jpg
408,8 Seconds,1994,8_seconds,5.2,12,4,8,33,0,2,0,2,0,3.6,7861,89,http://content8.flixster.com/movie/25/61/256194_det.jpg
409,Above the Rim,1994,above_the_rim,5.4,18,10,8,55,5,6,3,3,50,3.5,4319,84,http://content9.flixster.com/movie/26/96/269603_det.jpg
410,Addams Family Values,1993,addams_family_values,6.3,35,26,9,74,5.5,7,4,3,57,3.1,21548,57,http://content9.flixster.com/movie/26/62/266215_det.jpg
412,The Age of Innocence,1993,,\N,\N,\N,\N,\N,\N,\N,\N,\N,\N,\N,\N,\N,\N
413,Airheads,1994,airheads,4.2,31,7,24,22,4.6,8,3,5,37,2.9,13551,51,http://content6.flixster.com/movie/26/02/260296_det.jpg
414,The Air Up There,1994,air_up_there,4,26,6,20,23,3,6,0,6,0,2.6,2385,33,http://content8.flixster.com/movie/10/89/39/10893994_det.jpg
415,Another Stakeout,1993,another_stakeout,3.9,21,3,18,14,0,3,1,2,33,2.5,1861,31,http://content6.flixster.com/movie/10/88/81/10888176_det.jpg
416,Bad Girls,1994,1051219-bad_girls,3.5,21,2,19,9,0,4,0,4,0,2.8,5946,49,http://content6.flixster.com/movie/10/87/26/10872684_det.jpg
417,Vicky Cristina Barcelona,2008,vicky_cristina_barcelona,6.9,188,154,34,81,7.2,35,29,6,82,3.6,45494,73,http://content7.flixster.com/movie/11/13/43/11134349_det.jpg
418,Being Human,2008,,\N,\N,\N,\N,\N,\N,\N,\N,\N,\N,\N,\N,\N,\N
419,The Beverly Hillbillies,1993,1046435-beverly_hillbillies,3.6,28,7,21,25,4.2,8,3,5,37,2.5,4897,40,http://content8.flixster.com/movie/37/13/33/3713338_det.jpg
420,Beverly Hills Cop III,1994,beverly_hills_cop_3,3.3,30,3,27,10,2.9,6,0,6,0,2.9,12777,50,http://content8.flixster.com/movie/10/84/44/10844414_det.jpg
421,Black Beauty,1994,1126533-black_friday,0,0,0,0,0,0,0,0,0,0,0,0,0,http://content8.flixster.com/movie/10/93/24/10932426_det.jpg
423,Blown Away,1994,1052838-blown_away,4.8,18,5,13,27,0,3,0,3,0,2.9,3591,46,http://content7.flixster.com/movie/27/66/276629_det.jpg
424,Blue Chips,1994,blue_chips,5.1,26,10,16,38,4.6,8,3,5,37,3,1545,50,http://content8.flixster.com/movie/26/12/261294_det.jpg
425,Blue Sky,1994,blue-sky,6.3,18,13,5,72,0,3,2,1,66,3.2,809,52,http://content8.flixster.com/movie/10/90/79/10907954_det.jpg
426,Invasion of the Body Snatchers,1956,1010678-invasion_of_the_body_snatchers,8.9,36,36,0,100,0,2,2,0,100,3.6,3820,81,http://content8.flixster.com/movie/10/95/44/10954478_det.jpg
427,Boxing Helena,1993,boxing_helena,3.7,30,6,24,20,3.4,7,1,6,14,2.6,1775,39,http://content8.flixster.com/movie/10/88/01/10880190_det.jpg
428,A Bronx Tale,1993,bronx_tale,7.4,26,25,1,96,0,3,3,0,100,3.9,17840,89,http://content7.flixster.com/movie/10/88/62/10886213_det.jpg
429,Cabin Boy,1994,cabin_boy,4.9,23,10,13,43,0,2,0,2,0,2.4,1694,36,http://content8.flixster.com/movie/26/13/261398_det.jpg
430,Calendar Girls,2003,calendar_girls,6.5,118,87,31,73,6.5,33,23,10,69,3.1,8453,59,http://content6.flixster.com/movie/10/90/15/10901532_det.jpg
431,Carlito's Way,1993,carlitos_way,6.8,33,27,6,81,0,4,2,2,50,3.8,32475,88,http://content8.flixster.com/movie/14/81/59/1481590_det.jpg
432,City Slickers II: The Legend of Curly's Gold,1994,city_slickers_ii_the_legend_of_curlys_gold,3.6,21,4,17,19,0,3,0,3,0,2.7,5885,34,http://content9.flixster.com/movie/10/84/98/10849883_det.jpg
433,Clean Slate,1994,1050560-clean_slate,4.1,16,3,13,18,0,2,0,2,0,2.5,630,33,http://content6.flixster.com/movie/26/42/264200_det.jpg
434,Cliffhanger,1993,1044214-cliffhanger,6.3,33,27,6,81,6.2,7,5,2,71,2.8,9768,47,http://content8.flixster.com/movie/10/88/05/10880598_det.jpg
435,Coneheads,1993,coneheads,4.5,27,9,18,33,4.7,8,3,5,37,2.6,9202,37,http://content9.flixster.com/movie/25/66/256607_det.jpg
436,Color of Night,1994,color_of_night,3.9,26,8,18,30,0,3,0,3,0,2.7,3955,40,http://content9.flixster.com/movie/27/04/270403_det.jpg
437,Cops and Robbersons,1994,cops_and_robbersons,3.5,19,3,16,15,2.6,6,0,6,0,2.5,1201,26,http://content7.flixster.com/movie/10/93/94/10939473_det.jpg
438,The Cowboy Way,1994,cowboy_way,4.2,12,2,10,16,0,2,0,2,0,3,2782,61,http://content9.flixster.com/movie/10/88/51/10885187_det.jpg
440,Dave,1993,dave,7.4,37,36,1,97,7.5,9,9,0,100,3.1,4985,63,http://content7.flixster.com/movie/11/12/76/11127633_det.jpg
441,Dazed and Confused,1993,dazed_and_confused,7.9,41,40,1,97,7.6,7,6,1,85,3.8,45956,89,http://content9.flixster.com/movie/10/84/23/10842359_det.jpg
442,Demolition Man,1993,demolition_man,5.6,32,20,12,62,4.2,8,3,5,37,3,16135,60,http://content6.flixster.com/movie/26/97/269712_det.jpg
443,The Endless Summer 2,1994,endless_summer_ii_the_the_journey_continues,5.8,14,8,6,57,5,5,2,3,40,4,802,89,http://content6.flixster.com/movie/25/72/257204_det.jpg
444,Even Cowgirls Get the Blues,1993,even_cowgirls_get_the_blues,3.2,17,4,13,23,0,3,0,3,0,2.6,1583,31,http://content7.flixster.com/movie/10/85/48/10854861_det.jpg
445,Fatal Instinct,1993,1046049-fatal_instinct,4.2,20,4,16,20,3.6,8,1,7,12,2.6,808,36,http://content9.flixster.com/movie/10/88/78/10887875_det.jpg
446,Ba wang bie ji,1993,farewell_to_my_concubine,7.4,33,29,4,87,7.2,10,8,2,80,4.1,4321,91,http://content7.flixster.com/movie/10/89/59/10895913_det.jpg
447,The Favor,1994,favor,4.9,10,3,7,30,0,3,0,3,0,2.8,891,23,http://content9.flixster.com/movie/27/86/278691_det.jpg
448,Huo Yuan Jia,2006,fearless-a-chinese-hero,0,0,0,0,0,0,0,0,0,0,0,0,0,http://content9.flixster.com/movie/10/85/48/10854871_det.jpg
449,Fear of a Black Hat,1994,fear_of_a_black_hat,7,19,16,3,84,7.2,8,8,0,100,3.8,898,81,http://content9.flixster.com/movie/27/00/270091_det.jpg
450,With Honors,1994,with_honors,4,21,4,17,19,0,3,0,3,0,3.3,3484,72,http://content8.flixster.com/movie/25/81/258122_det.jpg
451,Flesh and Bone,1993,flesh_and_bone,6.1,23,16,7,69,0,3,1,2,33,3,851,40,http://content9.flixster.com/movie/28/02/280207_det.jpg
452,Widows' Peak,1994,widows_peak,7.1,15,15,0,100,0,3,3,0,100,3.2,348,46,http://content6.flixster.com/movie/11/13/22/11132224_det.jpg
453,For Love or Money,1993,,\N,\N,\N,\N,\N,\N,\N,\N,\N,\N,\N,\N,\N,\N
454,The Firm,1993,1044522-firm,6.2,50,38,12,76,5,9,4,5,44,3.2,11507,61,http://content8.flixster.com/movie/28/38/283822_det.jpg
455,Free Willy,1993,free_willy,5.5,21,11,10,52,0,3,2,1,66,2.9,19451,48,http://content8.flixster.com/movie/10/88/31/10883198_det.jpg
456,Fresh,1994,fresh,7.5,19,17,2,89,0,3,3,0,100,4,1823,90,http://content7.flixster.com/movie/27/16/271605_det.jpg
457,The Fugitive,1993,1046129-fugitive,7.6,52,49,3,94,8,9,9,0,100,3.6,28862,82,http://content9.flixster.com/movie/11/12/17/11121787_det.jpg
458,Geronimo: An American Legend,1993,geronimo_an_american_legend,6.2,17,9,8,52,0,3,1,2,33,3.2,1686,53,http://content8.flixster.com/movie/25/94/259426_det.jpg
459,A Perfect Getaway,2009,a_perfect_getaway,5.8,124,76,48,61,5.9,29,18,11,62,3.2,102622,50,http://content7.flixster.com/movie/10/91/93/10919317_det.jpg
460,Getting Even with Dad,1994,getting_even_with_dad,3.3,12,1,11,8,0,3,0,3,0,2.4,2200,29,http://content7.flixster.com/movie/10/92/22/10922209_det.jpg
461,Go Fish,1994,1062542-go_fish,6.6,13,10,3,76,7.4,5,4,1,80,3.2,898,54,http://content9.flixster.com/movie/27/62/276227_det.jpg
462,A Good Man in Africa,1994,good_man_in_africa,4.4,8,1,7,12,0,2,0,2,0,2.9,306,34,http://content9.flixster.com/movie/10/87/38/10873887_det.jpg
463,Guilty as Sin,1993,guilty_as_sin,5.2,13,5,8,38,0,3,2,1,66,2.8,474,30,http://content7.flixster.com/movie/27/69/276993_det.jpg
464,Hard Target,1993,hard_target,5.2,29,14,15,48,5.6,7,4,3,57,0,0,0,http://content6.flixster.com/movie/27/33/273300_det.jpg
465,Heaven & Earth,1993,1048333-heaven_and_earth,5.2,17,8,9,47,5.8,5,2,3,40,3.6,1458,71,http://content8.flixster.com/movie/10/86/70/10867030_det.jpg
466,Hot Shots! Part Deux,1993,hot_shots_part_deux,5.6,28,17,11,60,5.8,6,3,3,50,3,9890,61,http://content8.flixster.com/movie/25/63/256302_det.jpg
467,Live Nude Girls,1995,live_nude_girls,4.4,8,3,5,37,0,1,1,0,100,3.2,368,46,http://content8.flixster.com/movie/49/96/89/4996890_det.jpg
468,The Englishman Who Went Up a Hill But Came Down a Mountain,1995,englishman_who_went_up_a_hill_but_came_down_a_mountain,5.8,22,13,9,59,7,5,4,1,80,3,3033,50,http://content9.flixster.com/movie/25/71/257199_det.jpg
469,The House of the Spirits,1993,house_of_the_spirits,5.4,14,6,8,42,0,3,1,2,33,3.7,3169,74,http://content6.flixster.com/movie/10/86/83/10868328_det.jpg
470,House Party 3,1994,house_party_3,2.7,6,0,6,0,0,0,0,0,0,0,0,0,http://content6.flixster.com/movie/27/44/274420_det.jpg
471,The Hudsucker Proxy,1994,hudsucker_proxy,6.2,38,22,16,57,4.1,9,2,7,22,3.6,10291,80,http://content9.flixster.com/movie/10/87/85/10878555_det.jpg
472,I'll Do Anything,1994,ill_do_anything,5.2,17,10,7,58,0,3,3,0,100,3,481,40,http://content7.flixster.com/movie/26/50/265009_det.jpg
473,In the Army Now,1994,in_the_army_now,2.2,21,0,21,0,2.5,5,0,5,0,2.5,3672,47,http://content6.flixster.com/movie/25/72/257292_det.jpg
474,In the Line of Fire,1993,in_the_line_of_fire,7.6,41,39,2,95,8.3,7,6,1,85,3.4,7831,72,http://content8.flixster.com/movie/10/80/52/10805270_det.jpg
475,In the Name of the Father,1993,in_the_name_of_the_father,7.6,39,37,2,94,7.4,9,8,1,88,4,10715,92,http://content8.flixster.com/movie/27/01/270126_det.jpg
476,The Inkwell,1994,inkwell,5,7,2,5,28,0,2,1,1,50,3.8,507,78,http://content9.flixster.com/movie/27/42/274219_det.jpg
477,What's Love Got to Do with It,1993,whats_love_got_to_do_with_it,7.5,33,32,1,96,8.2,7,7,0,100,3.6,9612,83,http://content6.flixster.com/movie/10/90/34/10903400_det.gif
478,Jimmy Hollywood,1994,jimmy_hollywood,4.1,20,3,17,15,0,3,0,3,0,2.5,544,24,http://content6.flixster.com/movie/28/19/281900_det.jpg
479,Judgment Night,1993,judgment_night,4.2,15,4,11,26,3.2,5,1,4,20,3.1,2059,53,http://content9.flixster.com/movie/27/97/279711_det.jpg
480,Jurassic Park,1993,jurassic_park,7.2,38,33,5,86,7.1,10,9,1,90,3.6,91260,81,http://content9.flixster.com/movie/25/84/258423_det.jpg
481,Kalifornia,1993,kalifornia,6.2,24,16,8,66,0,2,1,1,50,3.2,9852,63,http://content9.flixster.com/movie/28/45/284507_det.jpg
482,Killing Zoe,1993,killing_zoe,5.1,25,10,15,40,0,2,0,2,0,3.4,3407,65,http://content6.flixster.com/movie/28/49/284992_det.jpg
483,King of the Hill,1993,1046045-king_of_the_hill,7.9,25,24,1,96,7.8,7,6,1,85,3.6,963,77,http://content8.flixster.com/movie/85/27/98/8527986_det.jpg
484,Lassie,1994,1053155-lassie,6.8,8,6,2,75,0,2,2,0,100,2.9,2576,52,http://content8.flixster.com/movie/26/34/263402_det.jpg
485,Last Action Hero,1993,last_action_hero,4.9,37,14,23,37,4.6,5,1,4,20,2.6,11445,43,http://content6.flixster.com/movie/55/36/01/5536016_det.jpg
486,Life with Mikey,1993,life_with_mikey,3.9,9,2,7,22,0,2,0,2,0,2.8,1377,39,http://content9.flixster.com/movie/26/48/264827_det.jpg
487,Lightning Jack,1994,lightning_jack,3.4,16,1,15,6,3.9,6,1,5,16,2.8,2199,43,http://content9.flixster.com/movie/10/91/89/10918935_det.jpg
488,M. Butterfly,1993,the-thistle-and-the-lotus,0,0,0,0,0,0,0,0,0,0,0,0,0,http://images.rottentomatoescdn.com/images/defaults/poster_default.gif
489,Made in America,1993,1043960-made_in_america,3.9,28,8,20,28,0,3,1,2,33,2.5,4179,38,http://content7.flixster.com/movie/10/87/20/10872029_det.jpg
490,Malice,1993,malice,5.8,18,10,8,55,0,3,0,3,0,3,2429,42,http://content8.flixster.com/movie/28/45/284522_det.jpg
491,The Man Without a Face,1993,man_without_a_face,5.7,20,12,8,60,0,3,2,1,66,3.1,5277,63,http://content8.flixster.com/movie/10/88/44/10884478_det.jpg
492,Manhattan Murder Mystery,1993,manhattan_murder_mystery,6.9,21,19,2,90,0,3,3,0,100,3.7,4405,81,http://content8.flixster.com/movie/11/12/42/11124250_det.jpg
493,Menace II Society,1993,menace_ii_society,7.4,34,29,5,85,8,8,7,1,87,3.8,14420,88,http://content6.flixster.com/movie/10/84/96/10849636_det.jpg
494,Executive Decision,1996,executive_decision,6,37,24,13,64,6.3,10,6,4,60,2.9,5176,51,http://content6.flixster.com/movie/10/89/53/10895300_det.jpg
495,Ai no kor√Æda,1976,in_the_realm_of_the_senses,7.5,28,23,5,82,0,1,1,0,100,3.5,1565,67,http://content8.flixster.com/movie/12/84/25/1284250_det.jpg
496,What Happened Was...,1994,what_happened_was,7,20,18,2,90,0,4,3,1,75,4.1,120,84,http://content6.flixster.com/movie/10/19/72/10197236_det.jpg
497,Much Ado About Nothing,1993,1045992-much_ado_about_nothing,7.1,41,37,4,90,6.8,8,6,2,75,3.6,9764,82,http://content8.flixster.com/movie/26/63/266326_det.jpg
498,Mr. Jones,1993,mr_jones,5.2,13,6,7,46,0,2,1,1,50,3,1067,45,http://content7.flixster.com/movie/10/84/75/10847577_det.jpg
499,Mr. Wonderful,1993,mr_wonderful,5.9,18,10,8,55,6.1,5,3,2,60,3.1,870,46,http://content6.flixster.com/movie/26/28/262824_det.jpg
500,Mrs. Doubtfire,1993,mrs_doubtfire,5.7,42,27,15,64,0,2,1,1,50,3.4,61130,73,http://content6.flixster.com/movie/25/85/258512_det.jpg
501,Naked,1993,1048185-naked,8,21,19,2,90,0,2,2,0,100,4.3,3386,92,http://content9.flixster.com/movie/10/84/20/10842067_det.jpg
502,The Next Karate Kid,1994,next_karate_kid,3.6,17,1,16,5,0,4,0,4,0,0,0,0,http://content8.flixster.com/movie/26/25/262502_det.jpg
503,The New Age,1994,new_age,6,11,7,4,63,0,3,2,1,66,3.1,82,40,http://content8.flixster.com/movie/10/85/39/10853990_det.jpg
504,No Escape,1994,no_escape,5.1,15,8,7,53,0,3,0,3,0,3,2147,43,http://content6.flixster.com/movie/28/52/285208_det.jpg
505,North,1994,north,3,18,2,16,11,0,3,0,3,0,2.6,2932,32,http://content9.flixster.com/movie/41/65/59/4165591_det.jpg
506,Orlando,1992,orlando,6.2,26,21,5,80,0,2,1,1,50,3.9,2705,81,http://content9.flixster.com/movie/11/12/17/11121747_det.jpg
507,A Perfect World,1993,perfect_world,7.2,27,22,5,81,7.4,5,4,1,80,3.5,7814,77,http://content8.flixster.com/movie/10/83/83/10838374_det.jpg
508,Philadelphia,1993,philadelphia,6.5,43,32,11,74,6.7,5,4,1,80,3.7,20896,87,http://content6.flixster.com/movie/10/93/80/10938004_det.jpg
509,The Piano,1993,piano,8,45,40,5,88,9.3,7,7,0,100,3.7,12303,86,http://content7.flixster.com/movie/10/87/64/10876465_det.jpg
510,Poetic Justice,1993,poetic_justice,4.6,14,5,9,35,0,3,1,2,33,3.4,5709,83,http://content7.flixster.com/movie/10/85/49/10854961_det.jpg
511,The Program,1993,program,5,14,5,9,35,0,3,1,2,33,3.6,2842,77,http://content8.flixster.com/movie/46/25/25/4625250_det.jpg
512,The Puppet Masters,1994,puppet_masters,4.9,22,6,16,27,4,5,0,5,0,2.8,1068,38,http://content6.flixster.com/movie/10/93/87/10938732_det.jpg
513,Radioland Murders,1994,radioland_murders,4,15,3,12,20,0,2,0,2,0,3.1,601,52,http://content6.flixster.com/movie/10/89/14/10891492_det.jpg
514,The Ref,1994,ref,6.6,41,32,9,78,5.6,8,4,4,50,3.3,3390,73,http://content6.flixster.com/movie/26/83/268316_det.jpg
515,The Remains of the Day,1993,remains_of_the_day,8.4,38,37,1,97,8.3,8,7,1,87,3.8,6319,86,http://content8.flixster.com/movie/25/57/255706_det.jpg
516,Renaissance Man,1994,renaissance_man,4.4,18,3,15,16,0,3,0,3,0,2.9,2575,54,http://content8.flixster.com/movie/25/80/258018_det.jpg
517,Rising Sun,1993,rising_sun,5.1,35,12,23,34,5.2,11,4,7,36,2.9,4796,47,http://content6.flixster.com/movie/11/12/51/11125172_det.jpg
518,The Road to Wellville,1994,road_to_wellville,4.9,16,7,9,43,0,2,1,1,50,2.8,1442,39,http://content8.flixster.com/movie/27/26/272698_det.jpg
519,RoboCop 3,1993,robocop_3,3.1,28,1,27,3,3,6,0,6,0,2.3,6600,21,http://content6.flixster.com/movie/26/64/266400_det.jpg
520,Robin Hood: Men in Tights,1993,robin_hood_men_in_tights,5.1,22,10,12,45,0,1,0,1,0,3.5,45946,79,http://content9.flixster.com/movie/10/93/73/10937331_det.jpg
521,Romeo Is Bleeding,1993,romeo_is_bleeding,4.5,34,8,26,23,3.6,9,0,9,0,3.3,1704,62,http://content7.flixster.com/movie/27/18/271821_det.jpg
522,Romper Stomper,1992,romper_stomper,6.2,24,19,5,79,0,4,1,3,25,3.5,11581,72,http://content7.flixster.com/movie/10/94/01/10940169_det.jpg
523,Ruby in Paradise,1993,ruby_in_paradise,7.8,15,14,1,93,0,2,2,0,100,3.8,186,77,http://content6.flixster.com/movie/10/83/91/10839188_det.jpg
524,Rudy,1993,rudy,6.8,34,27,7,79,6.7,8,6,2,75,3.7,21916,88,http://content7.flixster.com/movie/10/84/77/10847749_det.jpg
525,The Saint of Fort Washington,1993,saint_of_fort_washington,6.5,9,6,3,66,0,3,2,1,66,3.9,305,84,http://content8.flixster.com/movie/10/86/88/10868814_det.jpg
526,Les nuits fauves,1992,les-nuits-fauves-savage-nights,0,0,0,0,0,0,0,0,0,0,0,0,0,http://content7.flixster.com/movie/10/89/94/10899445_det.jpg
527,Schindler's List,1993,schindlers_list,8.8,59,57,2,96,8.4,10,10,0,100,4.3,83125,96,http://content6.flixster.com/movie/26/71/267112_det.jpg
528,The Last Boy Scout,1991,last_boy_scout,5.1,30,13,17,43,0,4,2,2,50,3.3,11177,66,http://content9.flixster.com/movie/10/92/20/10922043_det.jpg
529,Searching for Bobby Fischer,1993,searching_for_bobby_fischer,8.1,33,33,0,100,8.4,8,8,0,100,3.5,3580,81,http://content6.flixster.com/movie/25/59/255904_det.jpg
530,Second Best,2004,10003765-second_best,5,16,6,10,37,4.5,8,2,6,25,3,174,37,http://content8.flixster.com/movie/30/99/309926_det.jpg
531,The Secret Garden,1993,1045518-secret_garden,8.1,17,16,1,94,0,3,2,1,66,3.3,14794,72,http://content9.flixster.com/movie/11/15/28/11152871_det.jpg
532,Serial Mom,1994,serial_mom,5.8,44,27,17,61,4,8,1,7,12,3,6394,62,http://content6.flixster.com/movie/27/10/271008_det.jpg
533,Kagemusha,1980,kagemusha,7.5,19,16,3,84,0,2,1,1,50,4.2,4005,91,http://content6.flixster.com/movie/10/93/41/10934152_det.jpg
534,Shadowlands,1993,1048267-shadowlands,8,28,27,1,96,8.8,6,6,0,100,3.9,3260,85,http://content7.flixster.com/movie/25/57/255701_det.jpg
535,Short Cuts,1993,short_cuts,7.8,51,48,3,94,8.1,8,7,1,87,3.9,5867,87,http://content9.flixster.com/movie/11/12/17/11121735_det.jpg
536,A Simple Twist of Fate,1994,simple_twist_of_fate,5.5,19,9,10,47,0,2,0,2,0,3.1,1672,52,http://content9.flixster.com/movie/26/22/262291_det.jpg
537,Sairen,2006,sairenforbidden-siren,0,0,0,0,0,0,0,0,0,0,0,0,0,http://content7.flixster.com/movie/10/82/85/10828537_det.jpg
538,Six Degrees of Separation,1993,six_degrees_of_separation,7.1,30,27,3,90,0,3,1,2,33,3.3,3720,67,http://content6.flixster.com/movie/10/84/47/10844780_det.jpg
539,Sleepless in Seattle,1993,sleepless_in_seattle,6.5,43,31,12,72,5.6,10,6,4,60,3.3,36965,75,http://content7.flixster.com/movie/11/12/06/11120641_det.jpg
540,Sliver,1993,sliver,3.6,24,3,21,12,0,2,0,2,0,2.5,2511,34,http://content9.flixster.com/movie/19/52/73/1952731_det.jpg
541,Blade Runner,1982,replikator-cloned-to-kill,0,0,0,0,0,0,0,0,0,0,0,0,0,http://content8.flixster.com/movie/10/85/39/10853986_det.jpg
542,Son in Law,1993,son_in_law_1993,3.8,17,4,13,23,0,3,0,3,0,2.9,5679,62,http://content8.flixster.com/movie/25/67/256726_det.jpg
543,So I Married an Axe Murderer,1993,so_i_married_an_axe_murderer,5.3,30,15,15,50,5,8,3,5,37,3,11154,66,http://content8.flixster.com/movie/10/86/72/10867222_det.jpg
544,Striking Distance,1993,striking_distance,3.6,19,3,16,15,0,2,0,2,0,2.8,4532,39,http://content8.flixster.com/movie/27/27/272702_det.jpg
545,Harem suar√©,1999,1121056-harem,0,1,1,0,100,0,0,0,0,0,0,0,0,http://content9.flixster.com/movie/27/77/277707_det.jpg
546,Super Mario Bros.,1993,,\N,\N,\N,\N,\N,\N,\N,\N,\N,\N,\N,\N,\N,\N
547,Surviving the Game,1994,surviving_the_game,4.3,13,3,10,23,0,1,0,1,0,3,1673,48,http://content7.flixster.com/movie/27/64/276405_det.jpg
548,Terminal Velocity,1994,terminal_velocity,3.6,20,3,17,15,0,3,0,3,0,2.6,1883,25,http://content8.flixster.com/movie/90/84/39/9084394_det.jpg
549,Thirty Two Short Films About Glenn Gould,1993,thirty-two-short-films-about-glenn-gould,8,17,15,2,88,0,3,3,0,100,3.8,1129,79,http://content6.flixster.com/movie/11/13/76/11137636_det.jpg
550,Threesome,1994,threesome,4.4,23,6,17,26,4.1,6,1,5,16,3,1708,52,http://content8.flixster.com/movie/27/55/275526_det.jpg
551,The Nightmare Before Christmas,1993,nightmare_before_christmas,8.2,70,68,2,97,8.2,17,17,0,100,3.8,124838,89,http://content7.flixster.com/movie/10/87/87/10878797_det.jpg
552,The Three Musketeers,1993,1046772-three_musketeers,4.8,24,7,17,29,0,3,0,3,0,3.2,13783,67,http://content7.flixster.com/movie/50/26/53/5026533_det.jpg
553,Tombstone,1993,tombstone,6.4,39,30,9,76,0,3,0,3,0,3.8,31660,93,http://content7.flixster.com/movie/26/73/267317_det.jpg
554,Law & Order: Trial by Jury,2005,,\N,\N,\N,\N,\N,\N,\N,\N,\N,\N,\N,\N,\N,\N
555,True Romance,1993,true_romance,7.5,44,40,4,90,6.2,9,7,2,77,3.9,43205,90,http://content9.flixster.com/movie/38/28/09/3828095_det.jpg
556,Dr. Strangelove or: How I Learned to Stop Worrying and Love the Bomb,1964,dr_strangelove,9,58,58,0,100,8.6,8,8,0,100,4.2,33662,94,http://content8.flixster.com/movie/26/51/265102_det.jpg
558,The Pagemaster,1994,pagemaster,4.6,15,3,12,20,5,6,2,4,33,2.8,7531,49,http://content8.flixster.com/movie/10/88/87/10888782_det.jpg
559,2 Days in Paris,2007,two_days_in_paris,6.8,113,96,17,84,6.9,34,30,4,88,3.6,27100,71,http://content6.flixster.com/movie/93/43/00/9343004_det.jpg
560,"The Beans of Egypt, Maine",1994,forbidden_choices,0,3,1,2,33,0,0,0,0,0,0,0,0,http://content8.flixster.com/movie/10/97/04/10970454_det.jpg
561,Killer Movie,2008,killer_movie,0,1,0,1,0,0,0,0,0,0,0,0,0,http://content7.flixster.com/movie/10/83/93/10839337_det.jpg
562,Welcome to the Dollhouse,1995,welcome_to_the_dollhouse,7.9,46,41,5,89,8.1,7,6,1,85,3.7,6911,84,http://content9.flixster.com/movie/10/88/33/10883391_det.jpg
563,Germinal,1993,germinal,6.9,10,9,1,90,0,2,2,0,100,3.7,511,71,http://content7.flixster.com/movie/39/89/93/3989933_det.jpg
564,Chugyeogja,2008,chaser,6.7,27,22,5,81,6.8,5,4,1,80,4,1927,88,http://content8.flixster.com/movie/10/85/52/10855238_det.jpg
565,Cronos,1993,cronos,7.3,35,31,4,88,7.8,7,6,1,85,3.5,3398,68,http://content9.flixster.com/movie/27/72/277211_det.jpg
566,Naked in New York,1993,naked_in_new_york,6.1,11,6,5,54,0,3,1,2,33,2.9,444,34,http://content8.flixster.com/movie/28/30/283098_det.jpg
567,Kika,1993,kika,5.7,13,8,5,61,5.1,5,2,3,40,0,0,0,http://content7.flixster.com/movie/10/91/08/10910897_det.jpg
568,Bhaji on the Beach,1993,bhaji_on_the_beach,7.4,8,7,1,87,0,2,2,0,100,3.3,372,60,http://content7.flixster.com/movie/10/90/24/10902481_det.jpg
569,Little Big League,1994,little_big_league,5.2,15,5,10,33,0,3,2,1,66,2.9,2288,50,http://content6.flixster.com/movie/25/93/259304_det.jpg
570,K√•disbellan,1993,kadisbellan-slingshot,6.9,9,8,1,88,0,1,1,0,100,3.5,76,59,http://content8.flixster.com/movie/10/84/06/10840610_det.jpg
571,Wide-Eyed and Legless,1993,wedding_gift,6,5,2,3,40,0,2,1,1,50,0,0,0,http://content6.flixster.com/movie/10/91/81/10918184_det.jpg
572,Foreign Student,1994,foreign_student,0,3,1,2,33,0,0,0,0,0,0,0,0,http://content7.flixster.com/movie/10/97/01/10970101_det.jpg
573,Io speriamo che me la cavo,1992,ciao_professore,6.2,7,4,3,57,0,2,1,1,50,3.6,412,71,http://content8.flixster.com/movie/10/88/08/10880806_det.jpg
574,Spanking the Monkey,1994,spanking_the_monkey,7.2,21,19,2,90,0,2,2,0,100,3.1,824,52,http://content8.flixster.com/movie/31/19/311926_det.jpg
575,The Little Rascals,1994,little_rascals,3.8,10,2,8,20,0,0,0,0,0,0,0,0,http://content6.flixster.com/movie/11/13/24/11132400_det.jpg
577,Andre,1994,andre,5.3,16,7,9,43,0,2,0,2,0,2.7,2286,52,http://content9.flixster.com/movie/25/89/258903_det.jpg
579,La scorta,1993,la_scorta,5.9,7,4,3,57,0,3,0,3,0,3.3,52,59,http://content9.flixster.com/movie/10/91/35/10913527_det.jpg
580,Princess Caraboo,1994,princess_caraboo,5.7,14,8,6,57,0,3,0,3,0,3,723,43,http://content8.flixster.com/movie/26/16/261614_det.jpg
581,The Celluloid Closet,1995,celluloid_closet,7.8,24,23,1,95,8.6,5,5,0,100,3.9,1222,87,http://content9.flixster.com/movie/10/87/44/10874435_det.jpg
582,M√©tisse,1993,cafe_au_lait,5.9,6,4,2,66,0,2,1,1,50,0,0,0,http://content8.flixster.com/movie/10/89/42/10894274_det.jpg
583,Caro diario,1993,caro_diario,6.7,9,6,3,66,0,2,0,2,0,4.1,936,86,http://content6.flixster.com/movie/43/98/42/4398424_det.jpg
585,The Brady Bunch Movie,1995,brady_bunch_movie,5.7,38,23,15,60,6.4,11,7,4,63,2.4,3906,38,http://content8.flixster.com/movie/10/70/30/10703022_det.jpg
586,Home Alone,1990,home_alone,5,30,14,16,46,0,2,0,2,0,3.3,66201,74,http://content6.flixster.com/movie/31/21/312104_det.jpg
587,Ghost,1990,1031086-ghost,6.8,42,34,8,80,0,4,4,0,100,3.5,62365,79,http://content7.flixster.com/movie/25/44/254497_det.jpg
588,Aladdin,1992,,\N,\N,\N,\N,\N,\N,\N,\N,\N,\N,\N,\N,\N,\N
589,Terminator 2: Judgment Day,1991,terminator_2_judgment_day,8.4,42,41,1,97,7.4,11,10,1,90,3.7,77100,88,http://content7.flixster.com/movie/10/94/47/10944701_det.jpg
590,Dances with Wolves,1990,dances_with_wolves,7,46,35,11,76,6.9,10,7,3,70,3.6,28000,84,http://content6.flixster.com/movie/10/87/82/10878268_det.jpg
591,Tough and Deadly,1995,,\N,\N,\N,\N,\N,\N,\N,\N,\N,\N,\N,\N,\N,\N
592,Batman,1966,batman_the_movie,6.2,22,18,4,81,0,1,1,0,100,3,13951,51,http://content8.flixster.com/movie/10/85/60/10856086_det.jpg
593,The Silence of the Lambs,1991,silence_of_the_lambs,8.5,52,50,2,96,7.8,11,10,1,90,4,98921,93,http://content7.flixster.com/movie/55/12/86/5512865_det.jpg
594,Snow White and the Seven Dwarfs,1937,the-house-of-magical-sounds,0,0,0,0,0,0,0,0,0,0,0,0,0,http://content6.flixster.com/movie/10/85/16/10851672_det.jpg
595,Beauty and the Beast,1991,1038728-beauty_and_the_beast,8,57,52,5,91,7.8,18,17,1,94,3.7,81050,85,http://content6.flixster.com/movie/10/92/78/10927816_det.jpg
596,Pinocchio,1940,1016342-pinocchio,9,37,37,0,100,8.5,5,5,0,100,3.3,19102,66,http://content8.flixster.com/movie/10/87/27/10872762_det.jpg
597,Pretty Woman,1990,pretty_woman,5.7,55,34,21,61,5.9,9,6,3,66,3.5,200724,68,http://content8.flixster.com/movie/16/90/52/1690526_det.jpg
598,Okno v Parizh,1994,window_to_paris,5.4,7,3,4,42,0,1,0,1,0,3.9,42,88,http://content6.flixster.com/movie/11/13/77/11137744_det.jpg
599,The Wild Bunch,1969,1059489-wild_bunch,8.8,38,37,1,97,8.2,7,6,1,85,4,8004,90,http://content7.flixster.com/movie/26/74/267417_det.jpg
600,Love and a .45,1994,love_and_a_45,6.2,6,5,1,83,0,0,0,0,0,0,0,0,http://content8.flixster.com/movie/10/89/20/10892046_det.jpg
602,A Great Day in Harlem,1994,great_day_in_harlem,7.5,18,16,2,88,7.1,7,6,1,85,3.9,85,82,http://content7.flixster.com/movie/10/93/45/10934505_det.jpg
603,Bye Bye Love,1995,bye_bye_love,4.2,21,4,17,19,0,3,1,2,33,2.9,1015,49,http://content7.flixster.com/movie/26/11/261109_det.jpg
605,One Fine Day,1996,1074374-one_fine_day,5.7,29,13,16,44,5.8,6,1,5,16,3.1,7990,63,http://content9.flixster.com/movie/26/59/265991_det.jpg
606,Candyman: Farewell to the Flesh,1995,candyman_farewell_to_the_flesh,4.9,10,4,6,40,0,1,0,1,0,2.7,4578,44,http://content9.flixster.com/movie/10/89/43/10894315_det.jpg
608,Fargo,1996,fargo,8.4,66,62,4,93,7.6,21,18,3,85,3.9,48610,91,http://content6.flixster.com/movie/31/32/313212_det.jpg
609,Homeward Bound II: Lost in San Francisco,1996,homeward_bound_2_lost_in_san_francisco,5.7,16,9,7,56,6.4,7,5,2,71,2.9,5368,53,http://content6.flixster.com/movie/25/14/251408_det.jpg
610,Heavy Metal,1981,1068461-heavy_metal,5.7,25,15,10,60,5.4,5,3,2,60,3.3,6386,69,http://content8.flixster.com/movie/26/90/269098_det.jpg
611,Hellraiser: Bloodline,1996,hellraiser-bloodline,3.5,10,3,7,30,0,1,0,1,0,2.9,4846,52,http://content9.flixster.com/movie/11/14/29/11142947_det.jpg
612,The Pallbearer,1996,pallbearer,5,18,7,11,38,0,4,2,2,50,2.3,1285,14,http://content8.flixster.com/movie/26/35/263502_det.jpg
613,Jane Eyre,2006,,\N,\N,\N,\N,\N,\N,\N,\N,\N,\N,\N,\N,\N,\N
614,Loaded,2008,loaded-2008,0,0,0,0,0,0,0,0,0,0,0,0,0,http://content9.flixster.com/movie/10/88/27/10882795_det.jpg
615,Pane e cioccolata,1973,bread_and_chocolate,0,4,4,0,100,0,0,0,0,0,0,0,0,http://content7.flixster.com/movie/10/89/25/10892525_det.jpg
616,The AristoCats,1970,aristocats,6.1,26,17,9,65,0,4,3,1,75,3.3,23247,71,http://content7.flixster.com/movie/25/07/250797_det.jpg
617,La flor de mi secreto,1995,flower_of_my_secret,7,23,19,4,82,6.6,11,8,3,72,3.7,1997,75,http://content6.flixster.com/movie/49/69/26/4969268_det.jpg
618,Two Much,1995,two_much,3.6,7,1,6,14,0,3,0,3,0,2.7,947,33,http://content9.flixster.com/movie/26/48/264899_det.jpg
619,Ed,2000,,\N,\N,\N,\N,\N,\N,\N,\N,\N,\N,\N,\N,\N,\N
620,Cerro Torre: Schrei aus Stein,1991,cerro-torre-schrei-aus-stein-scream-of-stone,0,0,0,0,0,0,0,0,0,0,0,0,0,http://content7.flixster.com/movie/91/73/48/9173489_det.jpg
621,Ma saison pr√©f√©r√©e,1993,my_favorite_season_1993,7.3,12,11,1,91,0,3,3,0,100,0,0,0,http://content7.flixster.com/movie/29/64/296417_det.jpg
623,A Modern Affair,1995,modern_affair,0,2,0,2,0,0,1,0,1,0,3.2,63,38,http://content8.flixster.com/movie/10/86/39/10863938_det.jpg
624,Condition Red,1995,,\N,\N,\N,\N,\N,\N,\N,\N,\N,\N,\N,\N,\N,\N
625,Asfour Stah,1990,halfaouine-boy-of-the-terraces,0,0,0,0,0,0,0,0,0,0,0,0,0,http://content9.flixster.com/movie/28/87/288711_det.jpg
626,A Thin Line Between Love and Hate,1996,thin_line_between_love_and_hate,3.5,24,3,21,12,3.2,7,0,7,0,3.5,3360,73,http://content6.flixster.com/movie/97/03/07/9703076_det.jpg
627,The Last Supper,1995,last-supper,0,0,0,0,0,0,0,0,0,0,0,0,0,http://images.rottentomatoescdn.com/images/defaults/poster_default.gif
628,Primal Fear,1996,1070992-primal_fear,6.7,41,30,11,73,7.3,6,4,2,66,3.7,15640,85,http://content8.flixster.com/movie/26/88/268822_det.jpg
629,Rude Boy,1980,rude-boy2003,0,0,0,0,0,0,0,0,0,0,0,0,0,http://content6.flixster.com/movie/10/91/31/10913120_det.jpg
630,Carried Away,1996,1070604-carried_away,6,22,14,8,63,5.4,6,3,3,50,3.3,256,51,http://content9.flixster.com/movie/10/83/80/10838051_det.jpg
631,All Dogs Go to Heaven 2,1996,all_dogs_go_to_heaven_2,0,3,0,3,0,0,1,0,1,0,2.8,10564,48,http://content6.flixster.com/movie/10/87/85/10878596_det.jpg
632,Land and Freedom,1995,land_and_freedom,7.8,10,8,2,80,0,2,2,0,100,4.3,1552,93,http://content7.flixster.com/movie/10/92/30/10923065_det.jpg
633,Denise Calls Up,1995,denise_calls_up,6.4,22,17,5,77,6.9,9,7,2,77,3.4,47,67,http://content8.flixster.com/movie/10/86/34/10863458_det.jpg
634,Theodore Rex,1995,theodore_rex,0,4,0,4,0,0,0,0,0,0,0,0,0,http://content9.flixster.com/movie/10/87/46/10874623_det.jpg
635,A Family Thing,1996,family_thing,6.3,22,16,6,72,6.8,6,5,1,83,3.4,546,61,http://content6.flixster.com/movie/26/40/264000_det.jpg
636,Nina Frisk,2007,nina-frisk,0,0,0,0,0,0,0,0,0,0,0,0,0,http://content7.flixster.com/movie/10/50/90/10509049_det.jpg
637,Sgt. Bilko,1996,sgt_bilko,4.4,36,12,24,33,5.4,10,6,4,60,2.6,3074,46,http://content8.flixster.com/movie/11/13/42/11134258_det.jpg
638,Jack & Sarah,1995,jack_and_sarah,6,11,9,2,81,0,2,1,1,50,3.6,1366,74,http://content6.flixster.com/movie/10/84/03/10840396_det.jpg
639,Girl 6,1996,girl_6,4.6,32,11,21,34,4,11,1,10,9,0,0,0,http://content6.flixster.com/movie/23/16/94/2316944_det.jpg
640,Diabolique,1996,1069985-diabolique,3.8,25,3,22,12,4,6,0,6,0,2.7,1450,35,http://content7.flixster.com/movie/27/67/276705_det.jpg
641,Un indien dans la ville,1994,little_indian_big_city,3.2,8,1,7,12,0,4,0,4,0,2.8,552,34,http://content8.flixster.com/movie/10/83/92/10839294_det.jpg
643,Peanuts - Die Bank zahlt alles,1996,,\N,\N,\N,\N,\N,\N,\N,\N,\N,\N,\N,\N,\N,\N
645,Nelly & Monsieur Arnaud,1995,nelly_and_monsieur_arnaud,7.6,21,20,1,95,7.8,10,9,1,90,3.8,381,78,http://content6.flixster.com/movie/44/35/10/4435104_det.jpg
647,Courage Under Fire,1996,courage_under_fire,7.3,52,44,8,84,7.8,15,14,1,93,3.2,6918,61,http://content8.flixster.com/movie/10/91/78/10917802_det.jpg
648,Mission: Impossible III,2006,mission_impossible_3,6.6,217,152,65,70,6.2,42,26,16,61,3.3,86328,69,http://content6.flixster.com/movie/10/93/36/10933612_det.jpg
649,Cold Fever,1995,cold_fever,7.3,10,9,1,90,0,3,3,0,100,3.9,284,81,http://content7.flixster.com/movie/39/10/58/3910585_det.jpg
650,Moll Flanders,1996,1071414-moll_flanders,5.5,20,9,11,45,6.3,6,3,3,50,3.5,855,72,http://content7.flixster.com/movie/36/25/75/3625753_det.jpg
651,Das Superweib,1996,,\N,\N,\N,\N,\N,\N,\N,\N,\N,\N,\N,\N,\N,\N
652,"301, 302",1995,301-302,5.9,7,5,2,71,0,1,0,1,0,3.7,163,69,http://content7.flixster.com/movie/10/12/38/10123817_det.jpg
653,DragonHeart,1996,dragonheart,5.7,30,15,15,50,6.4,5,3,2,60,3.2,19438,63,http://content6.flixster.com/movie/10/86/38/10863888_det.jpg
655,Mutters Courage,1995,my_mothers_courage,0,0,0,0,0,0,0,0,0,0,0,0,0,http://content9.flixster.com/movie/10/86/25/10862575_det.jpg
656,48 Hrs.,1982,48_hrs,7.4,33,31,2,93,0,4,3,1,75,3.2,10471,61,http://content8.flixster.com/movie/26/94/269494_det.jpg
658,Billy's Holiday,1995,billys_holiday,0,1,0,1,0,0,0,0,0,0,0,0,0,http://content7.flixster.com/movie/10/99/00/10990029_det.jpg
659,Plein soleil,1960,purple-noon,8.2,21,21,0,100,0,4,4,0,100,4,670,89,http://content7.flixster.com/movie/26/19/261905_det.jpg
660,August Rush,2007,august_rush,4.8,120,44,76,36,4.4,27,7,20,25,4,105941,84,http://content6.flixster.com/movie/96/76/16/9676160_det.jpg
661,James and the Giant Peach,1996,james_and_the_giant_peach,7,55,51,4,92,7.5,12,11,1,91,3,18876,55,http://content8.flixster.com/movie/25/48/254806_det.jpg
662,Fear,1996,1071258-fear,4.8,28,11,17,39,0,4,1,3,25,3.2,11285,66,http://content8.flixster.com/movie/27/03/270322_det.jpg
663,Kids in the Hall: Brain Candy,1996,kids_in_the_hall_brain_candy,4.7,33,13,20,39,4.3,9,3,6,33,3.4,2060,72,http://content6.flixster.com/movie/11/14/71/11147180_det.jpg
664,Faithful,1996,faithful,3.8,14,1,13,7,5,5,1,4,20,3.1,397,47,http://content9.flixster.com/movie/10/01/10/10011047_det.jpg
665,Underground,1995,1088763-underground,7.5,18,15,3,83,0,4,4,0,100,4.4,6157,96,http://content7.flixster.com/movie/10/89/31/10893197_det.jpg
666,Lust och f√§gring stor,1995,all_things_fair,0,1,1,0,100,0,0,0,0,0,0,0,0,http://content7.flixster.com/movie/11/13/47/11134717_det.jpg
667,Bloodsport 2,1996,bloodsport_ii_the_next_kumite,0,0,0,0,0,0,0,0,0,0,0,0,0,http://content7.flixster.com/movie/23/38/23/2338233_det.jpg
668,Pather Panchali,1955,pather-panchali-song-of-the-little-road,8.9,33,32,1,96,8.6,6,6,0,100,4.5,1572,95,http://content8.flixster.com/movie/10/08/39/10083902_det.jpg
670,Apur Sansar,1959,apur-sansar-the-world-of-apu1959,9,16,16,0,100,9.2,6,6,0,100,4.4,1009,94,http://content6.flixster.com/movie/10/83/97/10839708_det.jpg
671,Mystery Science Theater 3000: The Movie,1996,mystery_science_theater_3000_the_movie,6.4,37,27,10,72,6.3,13,9,4,69,3.8,4508,86,http://content7.flixster.com/movie/11/13/40/11134021_det.jpg
673,Space Jam,1996,space_jam,5.1,44,16,28,36,5.4,14,6,8,42,2.9,27911,52,http://content9.flixster.com/movie/10/91/96/10919615_det.jpg
674,Barbarella,1968,barbarella,6,35,26,9,74,4.8,5,2,3,40,3,5461,55,http://content9.flixster.com/movie/25/64/256403_det.jpg
678,Some Folks Call It a Sling Blade,1994,some_folks_call_it_a_sling_blade,0,0,0,0,0,0,0,0,0,0,0,0,0,http://content8.flixster.com/movie/10/93/85/10938546_det.jpg
679,The Run of the Country,1995,run_of_the_country,6,7,3,4,42,0,2,1,1,50,3.3,237,60,http://content8.flixster.com/movie/31/34/313418_det.jpg
680,"Alphaville, une √©trange aventure de Lemmy Caution",1965,alphaville,7.9,25,21,4,84,0,2,1,1,50,3.9,4907,82,http://content8.flixster.com/movie/29/56/295614_det.jpg
681,Coup de torchon,1981,1004323-clean_slate,7.2,6,5,1,83,0,1,0,1,0,3.8,497,77,http://content7.flixster.com/movie/10/89/65/10896517_det.jpg
682,Tigrero: A Film That Was Never Made,1994,tigrero_a_film_that_was_never_made,0,2,2,0,100,0,0,0,0,0,0,0,0,http://content8.flixster.com/movie/10/91/28/10912866_det.jpg
683,L'oeil de Vichy,1993,eye_of_vichy,0,2,2,0,100,0,0,0,0,0,0,0,0,http://content8.flixster.com/movie/30/67/306718_det.jpg
685,It's My Party,1996,its_my_party,5.8,14,7,7,50,6.2,6,3,3,50,3.7,843,78,http://content7.flixster.com/movie/27/32/273209_det.jpg
687,Country Life,1994,country_life,6.5,6,4,2,66,0,2,2,0,100,3.1,265,44,http://content6.flixster.com/movie/26/40/264012_det.jpg
688,Operation Dumbo Drop,1995,operation_dumbo_drop,4,24,7,17,29,0,3,2,1,66,2.4,2200,31,http://content9.flixster.com/movie/26/35/263511_det.jpg
690,Das Versprechen,1995,das-versprechen-the-promise,7,6,5,1,83,0,1,1,0,100,3.7,95,74,http://content7.flixster.com/movie/97/48/50/9748505_det.jpg
691,Mrs. Winterbourne,1996,mrs_winterbourne,3.8,29,2,27,6,3.3,10,0,10,0,3.1,2892,60,http://content9.flixster.com/movie/25/92/259299_det.jpg
692,Solo,1996,1073182-solo,3.2,26,1,25,3,3.8,10,1,9,10,2.3,827,25,http://content9.flixster.com/movie/10/87/64/10876463_det.jpg
693,Etz Hadomim Tafus,1995,under_the_domim_tree,0,1,1,0,100,0,0,0,0,0,0,0,0,http://content7.flixster.com/movie/69/02/55/6902553_det.jpg
694,The Substitute,1996,1069981-substitute,4.6,21,8,13,38,4.2,8,2,6,25,2.9,1815,44,http://content7.flixster.com/movie/27/97/279729_det.jpg
695,True Crime,1999,1084928-true_crime,6,38,20,18,52,6.8,6,5,1,83,3.2,2873,51,http://content6.flixster.com/movie/27/47/274704_det.jpg
696,Butterfly Kiss,1995,butterfly_kiss,6.4,13,10,3,76,0,1,1,0,100,3.2,586,55,http://content8.flixster.com/movie/11/13/63/11136386_det.jpg
697,Feeling Minnesota,1996,feeling_minnesota,3.8,19,3,16,15,0,4,1,3,25,2.7,2783,30,http://content9.flixster.com/movie/27/52/275291_det.jpg
698,Delta of Venus,1995,delta_of_venus,4.4,5,0,5,0,0,0,0,0,0,0,0,0,http://content8.flixster.com/movie/10/88/75/10887538_det.jpg
700,"Angus, Thongs and Perfect Snogging",2008,angus_thongs_and_perfect_snogging,6,24,17,7,70,0,2,1,1,50,3.9,6295,76,http://content8.flixster.com/movie/10/85/35/10853566_det.jpg
701,Daens,1992,daens,0,0,0,0,0,0,0,0,0,0,0,0,0,http://content7.flixster.com/movie/34/78/39/3478397_det.jpg
702,Face/Off,1997,faceoff,7.9,60,56,4,93,8.4,15,15,0,100,3.5,62348,81,http://content8.flixster.com/movie/10/85/08/10850854_det.jpg
703,Boy A,2007,boy-a,7.5,57,51,6,89,7.5,23,20,3,86,3.5,5895,84,http://content8.flixster.com/movie/10/85/07/10850786_det.jpg
704,Galaxy Quest,1999,galaxy_quest,7.2,111,99,12,89,6.9,27,22,5,81,3,19804,67,http://content7.flixster.com/movie/10/91/52/10915261_det.jpg
705,Cos√¨ fan tutte,1992,all-ladies-do-it,0,0,0,0,0,0,0,0,0,0,0,0,0,http://content8.flixster.com/movie/10/90/53/10905374_det.jpg
706,Sunset Park,1996,sunset_park,4.6,8,1,7,12,0,3,0,3,0,3.6,636,78,http://content8.flixster.com/movie/27/80/278094_det.jpg
707,Mulholland Falls,1996,mulholland_falls,5.1,29,9,20,31,5.9,5,2,3,40,2.9,1519,40,http://content6.flixster.com/movie/93/68/00/9368008_det.jpg
708,The Truth About Cats & Dogs,1996,truth_about_cats_and_dogs,6.7,36,30,6,83,7.6,6,5,1,83,2.9,6120,55,http://content9.flixster.com/movie/10/88/92/10889235_det.jpg
709,Oliver & Company,1988,oliver_and_company,5.4,33,14,19,42,7.2,5,4,1,80,3.3,9618,65,http://content6.flixster.com/movie/25/15/251504_det.jpg
710,Celtic Pride,1996,celtic_pride,3.1,23,2,21,8,4.5,7,2,5,28,2.6,1756,30,http://content8.flixster.com/movie/95/04/97/9504978_det.jpg
711,Flipper,1996,1070621-flipper,4.8,17,5,12,29,5.4,5,1,4,20,2.6,6086,44,http://content7.flixster.com/movie/25/69/256925_det.jpg
712,La captive,2000,la-captive-the-captive,6.7,10,7,3,70,0,1,1,0,100,3,119,47,http://content8.flixster.com/movie/10/84/16/10841618_det.jpg
713,Of Love and Shadows,1994,of_love_and_shadows,4.2,5,1,4,20,0,0,0,0,0,0,0,0,http://content8.flixster.com/movie/10/89/11/10891186_det.jpg
714,Dead Man,1995,dead_man,6.8,33,23,10,69,5.8,6,2,4,33,4,16798,86,http://content7.flixster.com/movie/26/72/267209_det.jpg
715,Le hussard sur le toit,1995,horseman_on_the_roof,6.6,20,13,7,65,6.4,5,3,2,60,3.7,1134,77,http://content6.flixster.com/movie/10/91/67/10916740_det.jpg
716,The Jezebels,1975,switchblade_sisters,5.4,19,10,9,52,4.4,7,2,5,28,3.5,847,69,http://content7.flixster.com/movie/10/89/70/10897085_det.jpg
717,Boca a boca,1995,mouth_to_mouth,5.8,9,3,6,33,0,2,1,1,50,3.3,162,56,http://content9.flixster.com/movie/10/88/66/10886619_det.jpg
718,Les visiteurs,1993,1073317-visitors,5.4,11,4,7,36,0,3,0,3,0,3.7,3693,74,http://content6.flixster.com/movie/34/10/61/3410616_det.jpg
719,Multiplicity,1996,multiplicity,5.4,43,19,24,44,5.2,14,4,10,28,2.7,4648,43,http://content6.flixster.com/movie/20/48/10/2048108_det.jpg
720,Wallace & Gromit: The Best of Aardman Animation,1996,,\N,\N,\N,\N,\N,\N,\N,\N,\N,\N,\N,\N,\N,\N
722,The Haunted World of Edward D. Wood Jr.,1995,the-haunted-world-of-edward-d-wood-jr,0,1,1,0,100,0,0,0,0,0,0,0,0,http://content7.flixster.com/movie/10/88/97/10889749_det.jpg
724,The Craft,1996,craft,5.4,29,13,16,44,5.5,6,2,4,33,3.1,23740,67,http://content6.flixster.com/movie/10/85/08/10850868_det.jpg
725,The Great White Hype,1996,great_white_hype,5.1,20,9,11,45,6.6,5,3,2,60,2.7,1488,32,http://content6.flixster.com/movie/27/89/278916_det.jpg
726,Save the Last Dance,2001,save_the_last_dance_for_me,0,0,0,0,0,0,0,0,0,0,0,0,0,http://content7.flixster.com/movie/10/87/40/10874033_det.jpg
727,War Stories,2003,1138201-war_stories,0,0,0,0,0,0,0,0,0,0,0,0,0,http://content7.flixster.com/movie/11/13/53/11135357_det.jpg
728,Cold Comfort Farm,1995,1071769-cold_comfort_farm,7.5,31,26,5,83,8.6,5,5,0,100,3.7,1564,79,http://content7.flixster.com/movie/25/59/255913_det.jpg
729,"Institute Benjamenta, or This Dream People Call Human Life",1995,the-institute-benjamenta,7.5,6,6,0,100,0,1,1,0,100,4.2,375,87,http://content7.flixster.com/movie/29/72/297297_det.jpg
730,The Riches,2007,,\N,\N,\N,\N,\N,\N,\N,\N,\N,\N,\N,\N,\N,\N
731,Heaven's Prisoners,1996,heavens_prisoners,4.1,19,3,16,15,4.9,5,1,4,20,2.7,457,25,http://content6.flixster.com/movie/10/85/99/10859980_det.jpg
733,The Rock,1996,1072011-rock,6.5,47,31,16,65,6,15,9,6,60,3.6,45013,85,http://content6.flixster.com/movie/10/87/70/10877064_det.jpg
734,Getting Away with Murder,1996,getting_away_with_murder,3,7,0,7,0,0,3,0,3,0,2.8,747,29,http://content8.flixster.com/movie/10/92/22/10922206_det.jpg
735,Dellamorte Dellamore,1994,cemetery_man,6,26,16,10,61,0,2,0,2,0,3.8,3149,78,http://content9.flixster.com/movie/10/87/59/10875991_det.jpg
736,Twister,1996,1071167-twister,6,49,28,21,57,6.7,10,7,3,70,3.2,45771,62,http://content8.flixster.com/movie/26/63/266302_det.jpg
737,Barb Wire,1996,,\N,\N,\N,\N,\N,\N,\N,\N,\N,\N,\N,\N,\N,\N
738,Le gar√ßu,1995,le-garcu,0,0,0,0,0,0,0,0,0,0,0,0,0,http://images.rottentomatoescdn.com/images/defaults/poster_default.gif
741,K√¥kaku kid√¥tai,1995,ghost_in_the_shell,7.4,31,29,2,93,0,3,3,0,100,3.9,25483,87,http://content7.flixster.com/movie/10/93/13/10931385_det.jpg
742,Thinner,1996,thinner,3.8,17,3,14,17,0,3,0,3,0,2.7,3249,40,http://content6.flixster.com/movie/10/87/05/10870524_det.jpg
743,Spy Hard,1996,spy_hard,3.2,30,2,28,6,2.6,8,0,8,0,2.5,4450,37,http://content7.flixster.com/movie/10/37/12/10371241_det.jpg
744,Brothers in Trouble,1995,brothers_in_trouble,0,3,3,0,100,0,0,0,0,0,0,0,0,http://content6.flixster.com/movie/10/97/76/10977688_det.jpg
745,Wallace and Gromit in A Close Shave,1995,wallace_and_gromit_a_close_shave,8.5,19,19,0,100,0,0,0,0,0,0,0,0,http://content6.flixster.com/movie/41/62/60/4162608_det.jpg
746,Force of Evil,1948,1007691-force_of_evil,8.6,12,12,0,100,0,2,2,0,100,3.7,600,74,http://content6.flixster.com/movie/26/25/262520_det.jpg
747,The Stupids,1996,stupids,3.1,14,3,11,21,0,2,1,1,50,2.3,2070,35,http://content7.flixster.com/movie/10/84/55/10845557_det.jpg
748,The Arrival,1996,1071267-arrival,6.3,27,18,9,66,6.1,5,3,2,60,2.9,2211,41,http://content7.flixster.com/movie/11/14/58/11145801_det.jpg
750,Dr. Strangelove or: How I Learned to Stop Worrying and Love the Bomb,1964,dr_strangelove,9,58,58,0,100,8.6,8,8,0,100,4.2,33662,94,http://content8.flixster.com/movie/26/51/265102_det.jpg
751,Careful,1992,careful,6.4,11,9,2,81,0,4,3,1,75,4,200,79,http://content8.flixster.com/movie/10/70/70/10707046_det.jpg
753,A Month by the Lake,1995,month_by_the_lake,6.2,17,12,5,70,0,4,2,2,50,3.1,914,44,http://content9.flixster.com/movie/25/76/257691_det.jpg
754,Gold Diggers: The Secret of Bear Mountain,1995,gold_diggers_the_secret_of_bear_mountain,6.2,8,4,4,50,0,4,1,3,25,0,0,0,http://content7.flixster.com/movie/28/52/58/2852585_det.jpg
755,Kim,1950,1011597-kim,6.6,5,5,0,100,0,0,0,0,0,0,0,0,http://content7.flixster.com/movie/10/85/81/10858125_det.jpg
756,Carmen Miranda: Bananas Is My Business,1995,carmen_miranda_bananas_is_my_business,6,5,4,1,80,0,0,0,0,0,0,0,0,http://content6.flixster.com/movie/10/90/14/10901436_det.jpg
757,Dung che sai duk,1994,ashes_of_time_redux,6.6,69,54,15,78,6.7,18,14,4,77,3.6,2166,71,http://content8.flixster.com/movie/10/93/19/10931906_det.jpg
759,Maya Lin: A Strong Clear Vision,1994,maya_lin_a_strong_clear_vision,7.5,6,6,0,100,0,2,2,0,100,3.8,180,72,http://content8.flixster.com/movie/10/86/99/10869926_det.jpg
760,Stalingrad,1993,1072969-stalingrad,7.1,7,5,2,71,0,1,1,0,100,4,2247,87,http://content7.flixster.com/movie/29/21/292121_det.jpg
761,Star Wars: Episode I - The Phantom Menace,1999,star-warpd,0,0,0,0,0,0,0,0,0,0,0,0,0,http://content9.flixster.com/movie/10/80/46/10804663_det.jpg
762,Striptease,1996,striptease,3.4,34,4,30,11,4.4,6,0,6,0,2.4,5832,28,http://content7.flixster.com/movie/11/13/78/11137861_det.jpg
763,The Last of the High Kings,1996,summer_fling,0,1,1,0,100,0,0,0,0,0,0,0,0,http://content6.flixster.com/movie/10/89/13/10891324_det.jpg
764,This Is Spinal Tap,1984,this_is_spinal_tap,8.6,53,51,2,96,7.7,7,6,1,85,3.9,23608,91,http://content9.flixster.com/movie/28/14/281499_det.jpg
765,Jack,1996,1072875-jack,4,29,5,24,17,4.8,5,1,4,20,3,11920,57,http://content9.flixster.com/movie/26/14/261407_det.jpg
766,I Shot Andy Warhol,1996,i_shot_andy_warhol,6.7,25,19,6,76,8.3,6,5,1,83,3.4,1521,68,http://content6.flixster.com/movie/27/78/277800_det.jpg
767,The Grass Harp,1995,grass_harp,5.9,14,7,7,50,6.2,5,2,3,40,3.4,297,56,http://content8.flixster.com/movie/11/15/29/11152922_det.jpg
769,Marlene Dietrich: Shadow and Light,1996,,\N,\N,\N,\N,\N,\N,\N,\N,\N,\N,\N,\N,\N,\N
771,La m√¥me,2007,stalags,5.8,12,6,6,50,0,4,1,3,25,3.8,33,80,http://content9.flixster.com/movie/10/84/43/10844375_det.jpg
774,Wend Kuuni,1982,wend_kuuni,0,0,0,0,0,0,0,0,0,0,0,0,0,http://content9.flixster.com/movie/10/96/91/10969179_det.jpg
775,Histoires extraordinaires,1968,spirits_of_the_dead,6.6,18,16,2,88,0,1,1,0,100,3.5,736,65,http://content6.flixster.com/movie/10/86/83/10868324_det.jpg
778,Trainspotting,1996,trainspotting,8.2,55,49,6,89,7.7,14,12,2,85,4,88351,92,http://content7.flixster.com/movie/10/93/17/10931725_det.jpg
779,'Til There Was You,1997,til_there_was_you,3.9,28,2,26,7,3.7,10,0,10,0,2.7,1660,36,http://content6.flixster.com/movie/10/91/72/10917256_det.jpg
780,Independence Day,1996,1071806-independence_day,6.2,54,33,21,61,6.5,17,11,6,64,3.5,94416,75,http://content9.flixster.com/movie/10/94/47/10944707_det.jpg
781,Stealing Beauty,1996,stealing_beauty,5.9,47,25,22,53,5.9,11,6,5,54,3.5,5036,73,http://content9.flixster.com/movie/10/85/38/10853863_det.jpg
782,The Fan,1996,1072972-fan,4.8,25,10,15,40,5.3,5,2,3,40,2.8,5593,37,http://content9.flixster.com/movie/27/82/278295_det.jpg
783,The Hunchback of Notre Dame,1939,1010215-hunchback_of_notre_dame,8.3,9,9,0,100,0,0,0,0,0,0,0,0,http://content9.flixster.com/movie/29/39/293991_det.jpg
784,The Cable Guy,1996,cable_guy,5.4,54,28,26,51,4,14,2,12,14,2.8,27061,50,http://content9.flixster.com/movie/10/87/05/10870531_det.jpg
785,Kingpin,1996,1072385-kingpin,5.8,35,18,17,51,5.7,5,3,2,60,3.1,13950,63,http://content6.flixster.com/movie/26/91/269116_det.jpg
786,Eraser,1996,eraser,4.9,44,15,29,34,5.2,11,4,7,36,2.8,10891,43,http://content7.flixster.com/movie/27/12/271217_det.jpg
787,The Gate of Heavenly Peace,1995,gate_of_heavenly_peace,0,1,1,0,100,0,0,0,0,0,0,0,0,http://images.rottentomatoescdn.com/images/defaults/poster_default.gif
788,The Nutty Professor,1996,1071708-nutty_professor,6,51,34,17,66,6.7,15,13,2,86,2.9,25286,50,http://content8.flixster.com/movie/25/91/259122_det.jpg
789,"Yo, la peor de todas",1990,,\N,\N,\N,\N,\N,\N,\N,\N,\N,\N,\N,\N,\N,\N
791,"The Last Klezmer: Leopold Kozlowski, His Life and Music",1994,last_klezmer,0,2,2,0,100,0,0,0,0,0,0,0,0,http://content6.flixster.com/movie/11/13/72/11137256_det.jpg
792,"Hol volt, hol nem volt",1987,hungarian_fairy_tale,0,1,1,0,100,0,0,0,0,0,0,0,0,http://images.rottentomatoescdn.com/images/defaults/poster_default.gif
793,En compagnie d'Antonin Artaud,1993,artaud,6.9,6,5,1,83,0,2,1,1,50,0,0,0,http://content9.flixster.com/movie/11/02/74/11027443_det.jpg
795,Somebody to Love,1994,,\N,\N,\N,\N,\N,\N,\N,\N,\N,\N,\N,\N,\N,\N
796,A Very Natural Thing,1974,very_natural_thing,0,1,0,1,0,0,0,0,0,0,0,0,0,http://content9.flixster.com/movie/28/04/280491_det.jpg
798,Daylight,1996,daylight,4.7,27,6,21,22,4.9,6,0,6,0,2.8,7912,41,http://content8.flixster.com/movie/26/51/265110_det.jpg
799,The Frighteners,1996,frighteners,6.3,25,18,7,72,5.1,6,2,4,33,3.3,9928,70,http://content8.flixster.com/movie/10/93/70/10937094_det.jpg
800,Lone Star State of Mind,2002,lone_star_state_of_mind,0,4,0,4,0,0,0,0,0,0,0,0,0,http://content7.flixster.com/movie/10/89/20/10892061_det.jpg
801,Harriet the Spy,1996,1072990-harriet_the_spy,5.1,29,13,16,44,4.8,13,4,9,30,2.6,3584,46,http://content6.flixster.com/movie/10/86/90/10869000_det.jpg
802,Phenomenon,1996,phenomenon,5.9,32,16,16,50,5.5,6,1,5,16,3,9166,62,http://content9.flixster.com/movie/25/58/255899_det.jpg
803,Walking and Talking,1996,walking_and_talking,7.1,21,18,3,85,0,4,3,1,75,3.6,674,67,http://content9.flixster.com/movie/27/92/279207_det.jpg
804,She's the One,1996,shes_the_one,5.8,48,29,19,60,5.9,12,7,5,58,2.9,3031,39,http://content9.flixster.com/movie/27/16/271699_det.jpg
805,A Time to Kill,1996,1072381-time_to_kill,6.1,50,34,16,68,6.6,12,8,4,66,3.6,17074,83,http://content8.flixster.com/movie/10/86/86/10868614_det.jpg
806,American Buffalo,1996,american_buffalo,6.6,25,19,6,76,7.4,6,5,1,83,3,598,46,http://content8.flixster.com/movie/10/87/71/10877182_det.jpg
807,Les rendez-vous de Paris,1995,rendezvous_in_paris,6.8,17,13,4,76,6.5,6,4,2,66,3.6,158,63,http://content8.flixster.com/movie/11/13/71/11137142_det.jpg
808,"Mystery, Alaska",1999,mystery_alaska,4.9,78,29,49,37,5.1,26,11,15,42,3.2,4196,66,http://content6.flixster.com/movie/26/75/267504_det.jpg
809,Fled,1996,fled,4.3,29,4,25,13,4.5,11,2,9,18,2.6,1281,26,http://content9.flixster.com/movie/28/22/282227_det.jpg
810,Kazaam,1996,kazaam,2.5,25,1,24,4,3,10,0,10,0,1.8,3161,19,http://content6.flixster.com/movie/26/47/264728_det.jpg
813,Larger Than Life,1996,larger_than_life,4.1,17,2,15,11,4,6,0,6,0,2.6,1363,28,http://content9.flixster.com/movie/18/83/22/1883227_det.jpg
814,A Boy Called Hate,1995,boy_called_hate,0,1,1,0,100,0,0,0,0,0,0,0,0,http://content6.flixster.com/movie/10/97/39/10973916_det.jpg
815,Power 98,1996,,\N,\N,\N,\N,\N,\N,\N,\N,\N,\N,\N,\N,\N,\N
818,A Very Brady Sequel,1996,very_brady_sequel,5.6,32,16,16,50,6.5,9,6,3,66,2.3,4591,26,http://content6.flixster.com/movie/10/89/53/10895312_det.jpg
820,La mort en ce jardin,1956,death_in_the_garden,7.8,11,10,1,90,0,2,2,0,100,3.4,201,47,http://content7.flixster.com/movie/10/84/99/10849941_det.jpg
821,The Crude Oasis,1995,crude_oasis,0,1,0,1,0,0,1,0,1,0,3.1,38,50,http://content9.flixster.com/movie/10/89/37/10893795_det.jpg
823,La collectionneuse,1967,la-collectionneuse,7.1,9,8,1,88,0,2,1,1,50,3.9,566,83,http://content6.flixster.com/movie/29/83/298328_det.jpg
824,Jeder f√ºr sich und Gott gegen alle,1974,mystery-of-kaspar-hauser-jeder-fur-sich-und-gott-gegen-alle,0,0,0,0,0,0,0,0,0,0,0,0,0,http://images.rottentomatoescdn.com/images/defaults/poster_default.gif
827,O Convento,1995,1070236-convent,3.5,7,2,5,28,0,0,0,0,0,0,0,0,http://content6.flixster.com/movie/10/85/90/10859028_det.jpg
828,The Adventures of Pinocchio,1996,1071706-adventures_of_pinocchio,4.8,15,4,11,26,5.4,5,1,4,20,2.6,1746,33,http://content6.flixster.com/movie/10/86/08/10860880_det.jpg
829,Joe's Apartment,1996,joes_apartment,3.8,26,4,22,15,3.6,8,1,7,12,2.5,3311,43,http://content9.flixster.com/movie/11/15/13/11151375_det.jpg
830,The First Wives Club,1996,first_wives_club,5.4,32,13,19,40,5.7,7,2,5,28,3.2,9522,67,http://content9.flixster.com/movie/25/55/255511_det.jpg
831,Stonewall,1995,stonewall,6.5,8,5,3,62,0,3,1,2,33,3.4,282,57,http://content9.flixster.com/movie/10/85/48/10854819_det.jpg
832,Ransom,1996,1074298-ransom,6.4,30,21,9,70,5.7,7,4,3,57,3.1,10364,61,http://content9.flixster.com/movie/10/91/77/10917783_det.jpg
833,High School Musical 3: Senior Year,2008,1194524-high_school_musical_3_senior_year,5.9,127,83,44,65,6,27,18,9,66,3.6,80210,76,http://content9.flixster.com/movie/10/89/47/10894743_det.jpg
834,Phat Beach,1996,phat_beach,0,3,0,3,0,0,1,0,1,0,3,375,46,http://content6.flixster.com/movie/10/85/88/10858856_det.jpg
835,Foxfire,1996,1073285-foxfire,5.3,10,3,7,30,0,4,1,3,25,3.5,3071,67,http://content8.flixster.com/movie/10/87/90/10879038_det.jpg
836,Chain Reaction,1996,1072457-chain_reaction,4.1,31,4,27,12,5.1,9,2,7,22,2.7,6845,33,http://content8.flixster.com/movie/10/94/13/10941374_det.jpg
837,Matilda,1996,1072107-matilda,7.4,20,18,2,90,7.4,5,5,0,100,3.1,24214,65,http://content6.flixster.com/movie/10/88/58/10885848_det.jpg
838,Emma,1996,emma1996,0,0,0,0,0,0,0,0,0,0,0,0,0,http://content7.flixster.com/movie/73/95/22/7395229_det.jpg
839,The Crow: City of Angels,1996,crow_the_city_of_angels,3.4,33,4,29,12,3.3,8,1,7,12,3,12460,51,http://content6.flixster.com/movie/10/93/21/10932152_det.jpg
840,House Arrest,1996,1073023-house_arrest,3.5,12,1,11,8,0,3,0,3,0,2.8,2789,44,http://content9.flixster.com/movie/55/06/07/5506075_det.jpg
841,Les yeux sans visage,1960,eyes-without-a-face1960,8.2,42,41,1,97,7.8,9,8,1,88,4,785,86,http://content9.flixster.com/movie/10/85/78/10857831_det.jpg
842,Bordello of Blood,1996,tales_from_the_crypt_presents_bordello_of_blood,3.2,27,4,23,14,3.6,7,1,6,14,2.6,3764,41,http://content8.flixster.com/movie/10/88/79/10887978_det.jpg
844,Xinghua san yue tian,1994,story_of_xinghua,0,0,0,0,0,0,0,0,0,0,0,0,0,http://content6.flixster.com/movie/10/97/41/10974180_det.jpg
845,Tian guo ni zi,1994,day_the_sun_turned_cold,0,3,2,1,66,0,0,0,0,0,0,0,0,http://content9.flixster.com/movie/10/97/43/10974335_det.jpg
846,Flirt,1995,flirt,6.6,10,7,3,70,0,2,0,2,0,3.7,271,71,http://content7.flixster.com/movie/10/88/38/10883881_det.jpg
847,The Big Squeeze,1996,big_squeeze,5,7,3,4,42,0,1,0,1,0,3.8,49,75,http://content8.flixster.com/movie/10/85/19/10851946_det.jpg
848,The Spitfire Grill,1996,spitfire_grill,5.4,26,9,17,34,5.2,6,0,6,0,3.6,777,77,http://content8.flixster.com/movie/10/88/20/10882010_det.jpg
849,Escape from L.A.,1996,escape_from_la,5.6,45,25,20,55,5.9,14,8,6,57,2.8,10054,41,http://content9.flixster.com/movie/27/26/272607_det.jpg
850,Xich lo,1995,cyclo,6.5,11,8,3,72,0,0,0,0,0,0,0,0,http://content6.flixster.com/movie/29/56/295620_det.jpg
851,Basquiat,1996,night-graffiti,0,0,0,0,0,0,0,0,0,0,0,0,0,http://content6.flixster.com/movie/10/85/19/10851952_det.jpg
852,Tin Cup,1996,tin_cup,6.5,48,33,15,68,7,13,10,3,76,2.9,6148,57,http://content9.flixster.com/movie/26/86/268607_det.jpg
853,Evil Angels,1988,cry_in_the_dark,6.8,20,18,2,90,0,1,1,0,100,3.3,1554,63,http://content6.flixster.com/movie/26/47/264712_det.jpg
858,The Godfather,1972,godfather,9,66,66,0,100,8.4,11,11,0,100,4.4,172072,97,http://content9.flixster.com/movie/11/12/76/11127687_det.jpg
860,Der bewegte Mann,1994,maybe_maybe_not,5.9,9,5,4,55,0,3,2,1,66,3.5,359,64,http://content7.flixster.com/movie/10/85/95/10859537_det.jpg
861,Ging chat goo si 3: Chiu kup ging chat,1992,supercop,7.3,37,35,2,94,6.8,9,8,1,88,3.4,4064,69,http://content9.flixster.com/movie/10/86/39/10863979_det.jpg
862,Manny & Lo,1996,manny_and_lo,5.8,21,13,8,61,6.2,11,8,3,72,3.4,477,55,http://content7.flixster.com/movie/10/86/80/10868093_det.jpg
864,The Time Traveler's Wife,2009,time_travelers_wife,5.1,151,56,95,37,4.8,34,10,24,29,2.9,189828,65,http://content7.flixster.com/movie/10/92/43/10924397_det.jpg
865,Small Faces,1996,small_faces,6.7,9,6,3,66,0,2,2,0,100,4.1,183,85,http://content6.flixster.com/movie/10/93/94/10939484_det.jpg
866,Bound,1996,bound,7.7,34,30,4,88,8.6,5,5,0,100,3.5,5521,80,http://content7.flixster.com/movie/60/48/98/6048989_det.jpg
867,Carpool,1996,carpool,2.4,10,0,10,0,0,3,0,3,0,2.6,1096,39,http://content7.flixster.com/movie/10/52/89/10528985_det.jpg
868,Death in Brunswick,1991,death_in_brunswick,0,4,2,2,50,0,0,0,0,0,0,0,0,http://content6.flixster.com/movie/21/54/85/2154856_det.jpg
869,Kansas City,1996,kansas_city,5.9,33,19,14,57,6.2,9,5,4,55,3,608,37,http://content8.flixster.com/movie/28/25/282598_det.jpg
870,Gone Fishin',1997,gone_fishin,2.2,22,1,21,4,2.4,6,0,6,0,2.6,2183,39,http://content6.flixster.com/movie/10/94/35/10943536_det.jpg
872,Ai qing wan sui,1994,vive-lamour,8.1,5,4,1,80,0,0,0,0,0,0,0,0,http://content7.flixster.com/movie/30/50/305029_det.jpg
875,Nothing to Lose,1997,1077642-nothing_to_lose,5.1,23,6,17,26,5.7,5,1,4,20,3.1,5245,67,http://content7.flixster.com/movie/10/45/21/10452197_det.jpg
876,Chao ji ji hua,1993,,6,14,9,5,64,0,1,1,0,100,3.1,871,46,http://content6.flixster.com/movie/28/07/280704_det.jpg
877,Girls Town,1996,1072971-girls_town,6.8,23,20,3,86,7,10,9,1,90,3.8,173,76,http://content9.flixster.com/movie/66/25/56/6625567_det.jpg
879,The Relic,1997,relic,4.4,28,9,19,32,5.8,5,2,3,40,2.7,3098,36,http://content8.flixster.com/movie/63/26/07/6326074_det.jpg
880,The Island of Dr. Moreau,1996,1072156-island_of_dr_moreau,4.3,31,7,24,22,4,5,0,5,0,2.4,5032,26,http://content7.flixster.com/movie/28/70/287025_det.jpg
881,First Kid,1996,first_kid,4,12,2,10,16,0,2,0,2,0,2.5,2541,37,http://content9.flixster.com/movie/26/04/260491_det.jpg
882,The Trigger Effect,1996,trigger_effect,6.4,23,17,6,73,0,3,1,2,33,3,521,35,http://content7.flixster.com/movie/27/74/277421_det.jpg
884,Sweet Nothing in My Ear,2008,sweet-nothing-in-my-ear,0,0,0,0,0,0,0,0,0,0,0,0,0,http://content7.flixster.com/movie/10/89/53/10895381_det.jpg
885,Bill & Ted's Bogus Journey,1991,bill_and_teds_bogus_journey,6,33,19,14,57,6,6,4,2,66,3,17201,59,http://content9.flixster.com/movie/10/88/19/10881967_det.jpg
886,Bulletproof Monk,2003,bulletproof_monk,4.3,130,28,102,21,4,31,5,26,16,2.9,13789,50,http://content8.flixster.com/movie/10/88/61/10886106_det.jpg
887,Talk of Angels,1998,talk_of_angels,0,3,2,1,66,0,0,0,0,0,0,0,0,http://content9.flixster.com/movie/28/97/76/2897767_det.jpg
888,The Land Before Time III: The Time of the Great Giving,1995,land_before_time_iii_the_time_of_great_giving,0,4,2,2,50,0,0,0,0,0,0,0,0,http://content7.flixster.com/movie/10/92/43/10924385_det.jpg
889,Miami Vice,2006,miami_vice,5.6,189,89,100,47,6.4,41,28,13,68,2.8,55637,48,http://content8.flixster.com/movie/78/65/786578_det.jpg
891,Halloween: The Curse of Michael Myers,1995,halloween_6_the_curse_of_michael_myers,2.5,27,1,26,3,1.7,6,0,6,0,3.1,12571,56,http://content6.flixster.com/movie/97/82/14/9782144_det.jpg
892,Twelfth Night,1996,twelfth-night,6.8,30,21,9,70,6.5,10,7,3,70,3.7,1937,77,http://content9.flixster.com/movie/10/89/35/10893535_det.jpg
893,Mother Night,1996,mother_night,6.3,23,14,9,60,6.4,5,2,3,40,3.6,706,74,http://content9.flixster.com/movie/10/92/33/10923347_det.jpg
896,Les roseaux sauvages,1994,wild_reeds,8.2,10,10,0,100,0,3,3,0,100,4,604,86,http://content8.flixster.com/movie/11/12/23/11122346_det.jpg
897,For Whom the Bell Tolls,1943,for_whom_the_bell_tolls,6.4,12,10,2,83,0,0,0,0,0,0,0,0,http://content7.flixster.com/movie/29/51/295129_det.jpg
898,The Philadelphia Story,1940,philadelphia_story,8.6,43,43,0,100,8,5,5,0,100,4.1,11465,92,http://content7.flixster.com/movie/10/08/01/10080157_det.jpg
899,Singin' in the Rain,1952,singin_in_the_rain,9.2,44,44,0,100,8.8,9,9,0,100,3.9,28033,91,http://content7.flixster.com/movie/10/93/77/10937761_det.jpg
900,An American in Paris,1951,american_in_paris,7.9,47,46,1,97,7.2,5,5,0,100,3.7,6926,77,http://content6.flixster.com/movie/10/85/50/10855056_det.jpg
901,Funny Face,1957,funny_face,7.6,22,19,3,86,0,2,2,0,100,3.7,8892,80,http://content8.flixster.com/movie/10/88/03/10880354_det.jpg
902,Breakfast at Tiffany's,1961,breakfast_at_tiffanys,7.4,43,37,6,86,7.4,5,5,0,100,3.9,56438,91,http://content9.flixster.com/movie/28/57/285711_det.jpg
903,Vertigo,1958,vertigo,8.6,54,53,1,98,8,14,13,1,92,4.1,28291,92,http://content6.flixster.com/movie/57/58/575852_det.jpg
904,Rear Window,1954,1017289-rear_window,8.9,60,60,0,100,8.7,17,17,0,100,4.2,33508,95,http://content6.flixster.com/movie/89/52/98/8952988_det.jpg
905,It Happened One Night,1934,it_happened_one_night,8.7,32,31,1,96,8.2,5,5,0,100,4.1,7375,92,http://content8.flixster.com/movie/29/14/291410_det.jpg
906,Gaslight,1944,1008138-gaslight,7.6,16,14,2,87,0,1,1,0,100,4,2391,89,http://content8.flixster.com/movie/10/85/60/10856082_det.jpg
907,The Gay Divorcee,1934,gay_divorcee,7.8,8,8,0,100,0,0,0,0,0,0,0,0,http://content8.flixster.com/movie/37/40/82/3740826_det.jpg
908,North by Northwest,1959,north-by-northwest,9,58,58,0,100,7.8,6,6,0,100,4.2,23243,93,http://content9.flixster.com/movie/10/93/42/10934207_det.jpg
909,The Apartment,1960,1001115-apartment,8.3,43,39,4,90,7.6,8,7,1,87,4.1,9116,93,http://content8.flixster.com/movie/11/15/13/11151366_det.jpg
910,Some Like It Hot,1959,some_like_it_hot,8.9,40,39,1,97,0,4,4,0,100,4.1,23119,93,http://content9.flixster.com/movie/10/55/31/10553171_det.jpg
911,Charade,1963,1003883-charade,8.1,33,30,3,90,6,5,3,2,60,4.1,9173,92,http://content6.flixster.com/movie/40/80/61/4080612_det.jpg
912,Casablanca,1942,1003707-casablanca,9,58,56,2,96,7.7,7,6,1,85,4,66776,94,http://content9.flixster.com/movie/10/84/88/10848811_det.jpg
913,The Maltese Falcon,1941,1013139-maltese_falcon,9,40,40,0,100,8.2,6,6,0,100,4,14452,90,http://content9.flixster.com/movie/10/87/69/10876999_det.jpg
914,My Fair Lady,1964,my-fair-lady,8,36,34,2,94,8.6,6,6,0,100,3.7,27491,87,http://content8.flixster.com/movie/10/93/43/10934366_det.jpg
915,Sabrina,1954,1018047-sabrina,7.4,31,28,3,90,7.2,5,5,0,100,3.8,12812,87,http://content7.flixster.com/movie/10/93/36/10933669_det.jpg
916,Roman Holiday,1953,roman_holiday,8.2,43,42,1,97,7.5,6,5,1,83,4.1,17541,93,http://content6.flixster.com/movie/29/08/290804_det.jpg
917,A Little Princess,1995,1061812-little_princess,8.4,20,19,1,95,0,3,3,0,100,3.4,13643,81,http://content6.flixster.com/movie/29/07/290716_det.jpg
918,Meet Me in St. Louis,1944,meet_me_in_st_louis,8.4,24,24,0,100,0,4,4,0,100,3.8,7067,84,http://content9.flixster.com/movie/53/80/62/5380627_det.jpg
919,The Wizard of Oz,1939,1092277-wizard_of_oz,9.2,70,70,0,100,8.7,11,11,0,100,3.6,69148,82,http://content6.flixster.com/movie/25/30/253028_det.jpg
920,Gone with the Wind,1939,gone_with_the_wind,8.7,62,60,2,96,8.3,13,13,0,100,3.9,62786,91,http://content9.flixster.com/movie/10/93/18/10931807_det.jpg
921,My Favorite Year,1982,my_favorite_year,7.8,22,22,0,100,0,0,0,0,0,0,0,0,http://content7.flixster.com/movie/10/92/21/10922157_det.jpg
922,Sunset Blvd.,1950,sunset_boulevard,9.2,52,51,1,98,8.2,7,7,0,100,4.3,12588,95,http://content7.flixster.com/movie/10/88/29/10882989_det.jpg
923,Citizen Kane,1941,citizen_kane,9.4,54,54,0,100,8.9,7,7,0,100,4.1,33926,91,http://content7.flixster.com/movie/10/93/41/10934161_det.jpg
924,2001: A Space Odyssey,1968,1000085-2001_a_space_odyssey,8.8,53,51,2,96,7.1,11,9,2,81,3.7,46687,86,http://content6.flixster.com/movie/10/87/27/10872760_det.jpg
925,Golden Earrings,1947,golden_earrings,0,0,0,0,0,0,0,0,0,0,0,0,0,http://content7.flixster.com/movie/10/86/24/10862449_det.jpg
926,All About Eve,1950,1000626-all_about_eve,9,54,54,0,100,8.2,10,10,0,100,4.2,10267,94,http://content8.flixster.com/movie/10/95/54/10955402_det.jpg
927,The Women,2008,10009516-women,3.9,142,18,124,12,3.8,34,4,30,11,3,20081,41,http://content6.flixster.com/movie/10/85/30/10853064_det.jpg
928,Rebecca,1940,1017293-rebecca,8.7,36,36,0,100,8.2,5,5,0,100,0,0,0,http://content9.flixster.com/movie/28/61/286199_det.jpg
929,Foreign Correspondent,1940,foreign_correspondent,7.9,28,26,2,92,0,3,3,0,100,3.7,1921,77,http://content9.flixster.com/movie/99/05/70/9905707_det.jpg
930,Notorious,2009,10009632-notorious,5.5,136,68,68,50,6.2,36,22,14,61,3.6,66668,66,http://content8.flixster.com/movie/10/88/40/10884038_det.jpg
931,Spellbound,1945,1019609-spellbound,7.3,30,26,4,86,0,1,1,0,100,3.8,4332,82,http://content7.flixster.com/movie/10/93/88/10938881_det.jpg
932,An Affair to Remember,1957,affair_to_remember,6.4,25,16,9,64,0,1,0,1,0,4,7962,88,http://content6.flixster.com/movie/30/79/307928_det.jpg
933,To Catch a Thief,1955,to_catch_a_thief,8,32,31,1,96,0,2,2,0,100,0,0,0,http://content7.flixster.com/movie/10/93/55/10935581_det.jpg
934,Father of the Bride,1991,1037864-father_of_the_bride,5.8,29,21,8,72,0,2,2,0,100,3.2,22336,67,http://content9.flixster.com/movie/25/83/258323_det.jpg
935,The Band Wagon,1953,band_wagon,8.5,13,13,0,100,0,1,1,0,100,3.8,1257,79,http://content8.flixster.com/movie/10/93/42/10934214_det.jpg
936,Ninotchka,1939,ninotchka,8.3,23,23,0,100,0,3,3,0,100,4.1,1769,89,http://content9.flixster.com/movie/97/89/92/9789927_det.png
937,Love in the Afternoon,1957,love_in_the_afternoon,7.1,23,20,3,86,0,4,4,0,100,3.8,2060,80,http://content8.flixster.com/movie/29/21/292126_det.jpg
938,Gigi,1958,gigi,7.1,27,20,7,74,0,4,3,1,75,3.7,5450,75,http://content8.flixster.com/movie/10/88/00/10880022_det.jpg
939,The Reluctant Debutante,1958,reluctant_debutante,0,4,2,2,50,0,0,0,0,0,0,0,0,http://content8.flixster.com/movie/51/06/96/5106962_det.jpg
940,The Adventures of Robin Hood,1938,1000355-adventures_of_robin_hood,8.9,43,43,0,100,8.6,7,7,0,100,3.7,6404,84,http://content9.flixster.com/movie/11/14/22/11142287_det.jpg
941,The Mask of Zorro,1998,mask_of_zorro,7.1,66,54,12,81,6.5,13,10,3,76,3.3,31107,70,http://content8.flixster.com/movie/75/96/759614_det.jpg
942,Laura,1944,1012007-laura,8.6,45,45,0,100,8,6,6,0,100,0,0,0,http://content8.flixster.com/movie/29/04/290494_det.jpg
943,The Ghost and Mrs. Muir,1947,ghost_and_mrs_muir,8.2,12,12,0,100,0,0,0,0,0,0,0,0,http://content8.flixster.com/movie/10/85/60/10856078_det.jpg
944,Lost Horizon,1937,lost_horizon,7.6,8,8,0,100,0,0,0,0,0,0,0,0,http://content7.flixster.com/movie/98/97/81/9897817_det.jpg
945,Top Hat,1935,top_hat,8.6,37,37,0,100,8,6,6,0,100,4,2908,89,http://content9.flixster.com/movie/10/13/03/10130383_det.jpg
946,To Be or Not to Be,1942,1021557-to_be_or_not_to_be,8.7,34,33,1,97,7,5,4,1,80,4.2,1733,92,http://content8.flixster.com/movie/91/04/09/9104098_det.jpg
947,My Man Godfrey,1936,1014536-my_man_godfrey,8.4,26,26,0,100,8,6,6,0,100,4.1,1789,90,http://content7.flixster.com/movie/31/11/311193_det.jpg
948,Giant,1956,giant,7.7,35,34,1,97,7.8,6,6,0,100,3.9,5890,86,http://content9.flixster.com/movie/60/48/83/6048835_det.jpg
949,East of Eden,1955,1006416-east_of_eden,8.2,30,26,4,86,0,3,2,1,66,4,5957,90,http://content7.flixster.com/movie/10/93/17/10931781_det.jpg
950,The Thin Man,1934,thin_man,8.5,26,26,0,100,0,1,1,0,100,4.2,3591,93,http://content6.flixster.com/movie/10/43/19/10431924_det.jpg
951,His Girl Friday,1940,his_girl_friday,8.6,36,35,1,97,0,4,4,0,100,0,0,0,http://content9.flixster.com/movie/10/93/46/10934643_det.jpg
952,Around the World in 80 Days,2004,around_the_world_in_80_days,4.8,127,39,88,30,4.7,33,9,24,27,2.7,14038,45,http://content7.flixster.com/movie/11/14/86/11148613_det.jpg
953,It's a Wonderful Life,1946,1010792-its_a_wonderful_life,8.7,54,51,3,94,8.4,6,6,0,100,4,35280,94,http://content9.flixster.com/movie/29/04/290427_det.jpg
954,Mr. Smith Goes to Washington,1939,can-mr-smith-get-to-washington-anymore,7.4,12,10,2,83,7.4,7,6,1,85,3.6,869,66,http://content8.flixster.com/movie/10/86/77/10867718_det.jpg
955,Bringing Up Baby,1938,bringing_up_baby,8.4,36,34,2,94,0,4,3,1,75,4,8722,90,http://content7.flixster.com/movie/10/85/69/10856933_det.jpg
956,Penny Serenade,1941,penny_serenade,7.4,15,14,1,93,0,3,3,0,100,3.7,1083,74,http://content7.flixster.com/movie/28/93/289325_det.jpg
957,The Scarlet Letter,1995,1066120-scarlet_letter,3,33,5,28,15,3.6,11,1,10,9,2.9,3493,48,http://content7.flixster.com/movie/10/86/16/10861633_det.jpg
958,Lady of Burlesque,1943,lady_of_burlesque,5.5,5,3,2,60,0,3,2,1,66,3.2,263,52,http://content8.flixster.com/movie/10/83/91/10839118_det.jpg
959,Of Human Bondage,1934,1015393-of_human_bondage,6.9,9,7,2,77,0,0,0,0,0,0,0,0,http://content6.flixster.com/movie/11/13/92/11139204_det.jpg
960,Angel on My Shoulder,1946,angel_on_my_shoulder,0,3,2,1,66,0,0,0,0,0,0,0,0,http://content9.flixster.com/movie/10/39/82/10398203_det.jpg
961,Little Lord Fauntleroy,1936,1012439-little_lord_fauntleroy,7,5,4,1,80,0,0,0,0,0,0,0,0,http://content9.flixster.com/movie/49/60/85/4960855_det.jpg
963,The Inspector General,1949,inspector_general,6.8,8,7,1,87,0,0,0,0,0,0,0,0,http://content8.flixster.com/movie/28/75/287514_det.jpg
964,Angel and the Badman,1947,1000957-angel_and_the_badman,6.5,6,4,2,66,0,0,0,0,0,0,0,0,http://content6.flixster.com/movie/10/91/88/10918872_det.jpg
965,The 39 Steps,1935,1000121-39_steps,8.8,32,31,1,96,0,4,4,0,100,3.8,5603,84,http://content6.flixster.com/movie/10/87/29/10872908_det.jpg
966,A Walk in the Sun,1945,soldier-world-wide-entertainment,0,0,0,0,0,0,0,0,0,0,0,0,0,http://content8.flixster.com/movie/10/84/92/10849294_det.jpg
967,Outlaw,2007,common_denominators,0,0,0,0,0,0,0,0,0,0,0,0,0,http://content7.flixster.com/movie/10/86/83/10868301_det.jpg
968,Night of the Living Dead,1968,1015052-night_of_the_living_dead,8.5,45,43,2,95,7,5,4,1,80,3.7,26113,85,http://content6.flixster.com/movie/10/91/62/10916208_det.jpg
969,The African Queen,1951,african_queen,8.7,29,29,0,100,0,3,3,0,100,3.8,6609,87,http://content7.flixster.com/movie/20/48/78/2048785_det.jpg
970,Beat the Devil,1953,beat_the_devil,6.6,11,7,4,63,0,2,1,1,50,3.3,793,55,http://content6.flixster.com/movie/31/14/311416_det.jpg
971,Cat on a Hot Tin Roof,1958,1003755-cat_on_a_hot_tin_roof,7.8,30,30,0,100,0,4,4,0,100,3.9,6600,91,http://content9.flixster.com/movie/30/75/307523_det.jpg
972,The Last Time I Saw Paris,1954,last_time_i_saw_paris,6.3,6,5,1,83,0,2,1,1,50,3.1,883,44,http://content9.flixster.com/movie/10/87/75/10877599_det.jpg
973,Meet John Doe,1941,meet_john_doe,7.2,13,11,2,84,0,0,0,0,0,0,0,0,http://content8.flixster.com/movie/30/06/300618_det.jpg
974,La battaglia di Algeri,1966,battle_of_algiers,9,70,69,1,98,8.9,17,17,0,100,4.4,4132,95,http://content9.flixster.com/movie/10/94/26/10942603_det.jpg
976,A Farewell to Arms,1932,farewell_to_arms,7.6,8,7,1,87,0,0,0,0,0,0,0,0,http://content6.flixster.com/movie/10/90/60/10906004_det.jpg
980,Huang jia shi jie,1985,yes_madam,0,2,2,0,100,0,0,0,0,0,0,0,0,http://content7.flixster.com/movie/35/59/28/3559281_det.jpg
981,On Dangerous Ground,1952,1015525-on_dangerous_ground,8.3,11,11,0,100,0,1,1,0,100,3.8,411,75,http://content8.flixster.com/movie/28/52/91/2852910_det.jpg
982,Picnic,1955,picnic,6.5,6,3,3,50,0,1,0,1,0,3.5,632,64,http://content8.flixster.com/movie/25/80/258002_det.jpg
983,Madagascar Skin,1995,madagascar_skin,0,3,2,1,66,0,1,0,1,0,3.5,295,58,http://content6.flixster.com/movie/10/83/80/10838088_det.jpg
984,The Pompatus of Love,1995,pompatus_of_love,3.8,6,1,5,16,0,2,1,1,50,2.9,52,31,http://content7.flixster.com/movie/10/85/36/10853669_det.jpg
985,Small Wonder,1985,,\N,\N,\N,\N,\N,\N,\N,\N,\N,\N,\N,\N,\N,\N
986,Fly Away Home,1996,fly_away_home,7.1,32,27,5,84,8.1,7,7,0,100,3,5636,63,http://content6.flixster.com/movie/26/54/265420_det.jpg
987,Bliss,1997,1078165-bliss,5.8,12,6,6,50,0,4,1,3,25,3.4,337,58,http://content8.flixster.com/movie/27/47/274702_det.jpg
988,Grace of My Heart,1996,grace_of_my_heart,6.7,22,16,6,72,0,4,0,4,0,3.6,611,71,http://content9.flixster.com/movie/27/44/274423_det.jpg
989,Schlafes Bruder,1995,brother_of_sleep,6.6,7,5,2,71,0,2,2,0,100,4.1,119,84,http://content7.flixster.com/movie/10/97/64/10976437_det.jpg
990,Maximum Risk,1996,maximum_risk,4.3,31,9,22,29,4.2,10,3,7,30,2.8,2236,38,http://content9.flixster.com/movie/27/74/277423_det.jpg
991,Michael Collins,1996,michael_collins,6.8,44,34,10,77,6.8,9,7,2,77,3.6,4673,79,http://content8.flixster.com/movie/26/86/268618_det.jpg
992,The Rich Man's Wife,1996,rich_mans_wife,4.1,14,2,12,14,0,4,0,4,0,3,769,49,http://content7.flixster.com/movie/28/19/281925_det.jpg
993,Infinity,1996,1072683-infinity,6.2,13,8,5,61,0,4,2,2,50,3.1,399,38,http://content7.flixster.com/movie/26/46/264697_det.jpg
994,Big Night,1996,big_night,8,52,50,2,96,8.2,11,11,0,100,3.9,1944,84,http://content7.flixster.com/movie/10/87/40/10874069_det.jpg
996,Last Man Standing,1996,1073075-last_man_standing,5.1,30,11,19,36,4,6,1,5,16,3.1,8711,56,http://content7.flixster.com/movie/10/94/88/10948865_det.jpg
997,Caught,1996,1074539-caught,6.3,12,9,3,75,0,3,2,1,66,3.2,209,58,http://content9.flixster.com/movie/28/09/280923_det.jpg
998,Set It Off,1996,set_it_off,6,23,14,9,60,7.5,6,5,1,83,3.6,10301,86,http://content8.flixster.com/movie/26/90/269030_det.jpg
999,2 Days in the Valley,1996,2_days_in_the_valley,6.1,52,32,20,61,6,11,8,3,72,3,3984,48,http://content6.flixster.com/movie/26/94/269408_det.jpg
1000,Curdled,1996,curdled,4.3,12,2,10,16,0,2,0,2,0,3.4,441,62,http://content9.flixster.com/movie/43/21/04/4321043_det.jpg
1001,The Associate,1996,1073315-associate,5.1,17,4,13,23,6.2,7,3,4,42,2.9,1259,52,http://content7.flixster.com/movie/25/98/259813_det.jpg
1002,Ed's Next Move,1996,eds_next_move,6.3,9,7,2,77,0,2,2,0,100,3.2,43,75,http://content8.flixster.com/movie/10/85/80/10858018_det.jpg
1003,Extreme Measures,1996,extreme_measures,6,31,17,14,54,5.7,6,2,4,33,2.9,2772,37,http://content7.flixster.com/movie/28/29/282909_det.jpg
1004,The Glimmer Man,1996,glimmer_man,3.4,24,3,21,12,2.6,9,0,9,0,2.7,2801,48,http://content7.flixster.com/movie/27/22/272217_det.jpg
1005,D3: The Mighty Ducks,1996,d3_the_mighty_ducks,3.7,14,2,12,14,0,4,0,4,0,2.8,9838,50,http://content7.flixster.com/movie/26/31/263193_det.jpg
1006,The Chamber,1996,chamber,4.5,24,3,21,12,4.6,7,0,7,0,3,1633,43,http://content7.flixster.com/movie/10/88/80/10888009_det.jpg
1007,The Apple Dumpling Gang,1975,apple_dumpling_gang,6,8,4,4,50,0,2,0,2,0,3.2,2133,60,http://content8.flixster.com/movie/25/12/251202_det.jpg
1008,"Davy Crockett, King of the Wild Frontier",1955,davy_crockett_king_of_the_wild_frontier,0,4,4,0,100,0,0,0,0,0,0,0,0,http://content7.flixster.com/movie/11/14/51/11145149_det.jpg
1009,Escape to Witch Mountain,1975,escape_to_witch_mountain,6,20,15,5,75,0,3,2,1,66,3.1,3761,60,http://content8.flixster.com/movie/10/89/29/10892994_det.jpg
1010,The Love Bug,1968,1012813-love_bug,5.7,15,11,4,73,0,4,1,3,25,3.1,3795,63,http://content8.flixster.com/movie/25/11/251198_det.jpg
1011,Herbie Rides Again,1974,herbie_rides_again,0,4,3,1,75,0,0,0,0,0,0,0,0,http://content8.flixster.com/movie/25/21/252102_det.jpg
1012,Old Yeller,1957,old_yeller,7.7,17,16,1,94,0,2,2,0,100,3.3,6399,73,http://content8.flixster.com/movie/10/94/43/10944394_det.jpg
1013,The Parent Trap,1998,1083414-parent_trap,7,34,27,7,79,6.5,7,4,3,57,3.1,41455,67,http://content9.flixster.com/movie/10/88/10/10881003_det.jpg
1014,Pollyanna,1960,1016512-pollyanna,7.4,11,9,2,81,0,2,2,0,100,3.3,3331,71,http://content7.flixster.com/movie/25/10/251005_det.jpg
1015,Homeward Bound: The Incredible Journey,1993,homeward_bound_the_incredible_journey,6.5,22,19,3,86,6.9,8,7,1,87,3.2,15019,66,http://content8.flixster.com/movie/10/91/53/10915370_det.jpg
1016,The Shaggy Dog,2006,shaggy_dog,4.4,103,28,75,27,4.8,29,10,19,34,2.9,41890,50,http://content9.flixster.com/movie/10/89/84/10898411_det.jpg
1017,Swiss Family Robinson,1960,1020736-swiss_family_robinson,6.7,17,14,3,82,0,2,1,1,50,3.3,3986,71,http://content8.flixster.com/movie/10/86/95/10869530_det.jpg
1018,That Darn Cat,1997,1075251-that_darn_cat,3.8,14,1,13,7,0,4,0,4,0,2.5,2029,30,http://content6.flixster.com/movie/10/86/44/10864404_det.jpg
1019,20000 Leagues Under the Sea,1954,1000079-20000_leagues_under_the_sea,7.7,24,22,2,91,0,4,4,0,100,3.2,7628,57,http://content6.flixster.com/movie/11/14/17/11141728_det.jpg
1020,Cool Runnings,1993,1046227-cool_runnings,6,30,22,8,73,6,6,4,2,66,3.4,35317,77,http://content8.flixster.com/movie/25/47/254718_det.jpg
1021,Angels in the Outfield,1951,1048301-angels_in_the_outfield,0,1,1,0,100,0,0,0,0,0,0,0,0,http://content8.flixster.com/movie/10/89/81/10898186_det.jpg
1022,Cinderella,1950,1004186-cinderella,7.3,26,24,2,92,8,5,5,0,100,3.5,63946,76,http://content9.flixster.com/movie/25/06/250619_det.jpg
1023,Winnie the Pooh and the Blustery Day,1968,,\N,\N,\N,\N,\N,\N,\N,\N,\N,\N,\N,\N,\N,\N
1024,The Three Caballeros,1944,the-three-caballeros,6.8,15,13,2,86,0,4,3,1,75,3.3,2192,62,http://content9.flixster.com/movie/10/88/70/10887063_det.jpg
1025,The Sword in the Stone,1963,sword_in_the_stone,6,22,16,6,72,0,3,2,1,66,3.3,11900,68,http://content6.flixster.com/movie/25/07/250724_det.jpg
1026,So Dear to My Heart,1948,so_dear_to_my_heart,0,0,0,0,0,0,0,0,0,0,0,0,0,http://content8.flixster.com/movie/56/75/49/5675490_det.jpg
1027,Robin Hood: Prince of Thieves,1991,robin_hood_prince_of_thieves,5.2,27,15,12,55,0,2,1,1,50,3.4,30722,72,http://content6.flixster.com/movie/10/93/73/10937328_det.jpg
1028,Mary Poppins,1964,mary_poppins,8.2,37,37,0,100,0,3,3,0,100,3.5,44140,79,http://content6.flixster.com/movie/62/99/53/6299532_det.jpg
1029,Dumbo,1941,dumbo,8.4,31,30,1,96,0,4,4,0,100,3.3,32327,65,http://content8.flixster.com/movie/10/83/83/10838302_det.jpg
1030,Pete's Dragon,1977,petes_dragon,4.6,20,10,10,50,0,2,2,0,100,3.1,7622,59,http://content6.flixster.com/movie/25/09/250924_det.jpg
1031,Bedknobs and Broomsticks,1971,bedknobs_and_broomsticks,6,28,17,11,60,4.8,5,1,4,20,3.3,15857,67,http://content6.flixster.com/movie/11/15/24/11152484_det.jpg
1032,Alice in Wonderland,1951,1029112-alice_in_wonderland,6.5,22,18,4,81,0,3,2,1,66,3.3,37778,70,http://content8.flixster.com/movie/10/83/99/10839910_det.jpg
1033,The Fox and the Hound,1981,fox_and_the_hound,6.6,22,15,7,68,0,3,3,0,100,3.4,24666,77,http://content8.flixster.com/movie/10/84/96/10849638_det.jpg
1034,Freeway,1996,1072957-freeway,6.4,35,26,9,74,7.6,8,6,2,75,3.4,4677,73,http://content7.flixster.com/movie/27/08/270821_det.jpg
1035,The Sound of Music,1965,sound_of_music,7.7,47,38,9,80,5,5,2,3,40,3.6,72590,86,http://content6.flixster.com/movie/35/91/82/3591824_det.jpg
1036,Die Hard,1988,die_hard,8.1,50,47,3,94,6.2,9,6,3,66,3.9,99625,91,http://content8.flixster.com/movie/10/93/34/10933490_det.gif
1037,The Lawnmower Man,1992,lawnmower_man,4.9,19,9,10,47,0,0,0,0,0,0,0,0,http://content8.flixster.com/movie/10/85/16/10851698_det.jpg
1038,Unhook the Stars,1996,unhook_the_stars,6.6,16,13,3,81,6.4,6,5,1,83,3.2,257,49,http://content9.flixster.com/movie/27/66/276699_det.jpg
1039,Synthetic Pleasures,1995,synthetic_pleasures,5.4,6,1,5,16,0,2,0,2,0,0,0,0,http://content7.flixster.com/movie/10/97/63/10976305_det.jpg
1040,Secret Agent,1936,1018483-secret_agent,7.6,10,10,0,100,0,0,0,0,0,0,0,0,http://content8.flixster.com/movie/10/35/29/10352954_det.jpg
1041,Secrets & Lies,1996,secrets_and_lies,8.6,34,32,2,94,9.2,7,7,0,100,4.1,3358,90,http://content6.flixster.com/movie/10/86/84/10868484_det.jpg
1042,That Thing You Do!,1996,that_thing_you_do,7.1,50,46,4,92,7.2,17,16,1,94,3.2,14364,69,http://content9.flixster.com/movie/10/89/08/10890851_det.jpg
1043,To Gillian on Her 37th Birthday,1996,to_gillian_on_her_37th_birthday,4.7,27,4,23,14,5.2,7,0,7,0,2.9,1032,43,http://content9.flixster.com/movie/26/66/266615_det.jpg
1044,Surviving Picasso,1996,surviving_picasso,5,17,5,12,29,6.2,6,2,4,33,3.4,1054,58,http://content8.flixster.com/movie/74/43/17/7443178_det.jpg
1045,Love Is All There Is,1996,love_is_all_there_is,0,2,0,2,0,0,0,0,0,0,0,0,0,http://content6.flixster.com/movie/27/61/276104_det.jpg
1046,Beautiful Thing,1996,beautiful_thing,6.8,20,18,2,90,6.8,8,7,1,87,4.3,3357,91,http://content8.flixster.com/movie/26/94/269414_det.jpg
1047,The Long Kiss Goodnight,1996,long_kiss_goodnight,6.1,29,20,9,68,4.1,6,0,6,0,3.3,10833,69,http://content8.flixster.com/movie/59/86/77/5986778_det.jpg
1049,The Ghost and the Darkness,1996,ghost_and_the_darkness,5.5,45,23,22,51,4.3,10,2,8,20,3.3,7987,71,http://content9.flixster.com/movie/10/86/46/10864623_det.jpg
1050,Looking for Richard,1996,looking_for_richard,7.1,45,37,8,82,6.5,12,8,4,66,3.6,1885,73,http://content6.flixster.com/movie/10/91/36/10913644_det.jpg
1051,Trees Lounge,1996,trees_lounge,6.9,25,20,5,80,0,4,3,1,75,3.6,1441,78,http://content9.flixster.com/movie/28/39/283995_det.jpg
1053,Normal Life,1996,normal_life,6,10,7,3,70,0,2,2,0,100,3,289,45,http://content7.flixster.com/movie/10/88/24/10882453_det.jpg
1054,Get on the Bus,1996,get_on_the_bus,7.5,38,33,5,86,7.7,10,9,1,90,3.5,1014,70,http://content6.flixster.com/movie/10/86/99/10869944_det.jpg
1055,Shadow Conspiracy,1997,shadow_conspiracy,3,27,0,27,0,3.3,9,0,9,0,2.6,692,24,http://content9.flixster.com/movie/31/37/313791_det.jpg
1056,Jude,1996,jude,7.3,28,24,4,85,7.7,8,7,1,87,3.6,1931,71,http://content9.flixster.com/movie/27/59/275991_det.jpg
1057,Everyone Says I Love You,1996,everyone_says_i_love_you,7.3,41,32,9,78,7,9,5,4,55,3.4,6964,63,http://content6.flixster.com/movie/10/89/31/10893116_det.jpg
1058,Az√∫car amarga,1996,bitter_sugar,0,3,2,1,66,0,0,0,0,0,0,0,0,http://content9.flixster.com/movie/10/91/32/10913275_det.jpg
1059,Romeo + Juliet,1996,1102360-romeo_and_juliet,0,0,0,0,0,0,0,0,0,0,0,0,0,http://content6.flixster.com/movie/10/85/38/10853892_det.jpg
1060,Swingers,1996,swingers,7.7,51,44,7,86,7.6,10,8,2,80,3.8,14060,89,http://content9.flixster.com/movie/11/12/17/11121759_det.jpg
1061,Sleepers,1996,1073595-sleepers,6.7,48,35,13,72,7.3,9,8,1,88,3.6,20694,81,http://content9.flixster.com/movie/27/01/270111_det.jpg
1062,The Sunchaser,1996,1212848-sunchaser,3.9,5,1,4,20,0,1,0,1,0,3.3,191,52,http://content8.flixster.com/movie/83/85/33/8385330_det.jpg
1063,Indiana Jones and the Last Crusade,1989,indiana_jones_and_the_last_crusade,7.9,54,48,6,88,6.5,7,5,2,71,3.9,103952,91,http://content7.flixster.com/movie/10/91/96/10919621_det.jpg
1064,Aladdin and the King of Thieves,1995,aladdin-and-the-king-of-thieves,4.4,9,2,7,22,0,0,0,0,0,0,0,0,http://content6.flixster.com/movie/10/93/64/10936432_det.jpg
1066,Shall We Dance,2004,shall_we_dance,5.4,152,69,83,45,5.2,37,16,21,43,3,26935,63,http://content9.flixster.com/movie/10/84/66/10846607_det.jpg
1067,A Damsel in Distress,1937,damsel_in_distress,0,4,3,1,75,0,1,1,0,100,3.5,179,59,http://content9.flixster.com/movie/10/87/43/10874351_det.jpg
1068,Crossfire,1947,crossfire_1989,7.7,12,10,2,83,0,3,3,0,100,3.5,577,72,http://content7.flixster.com/movie/11/12/18/11121857_det.jpg
1069,"Murder, My Sweet",1944,murder_my_sweet,7.7,14,13,1,92,0,0,0,0,0,0,0,0,http://content6.flixster.com/movie/10/89/53/10895388_det.jpg
1070,Macao,1952,macao,5.7,9,5,4,55,0,2,0,2,0,3.4,169,55,http://content6.flixster.com/movie/10/92/51/10925124_det.jpg
1071,For the Moment,1993,for-the-moment,0,0,0,0,0,0,0,0,0,0,0,0,0,http://content6.flixster.com/movie/10/88/39/10883976_det.jpg
1073,Willy Wonka & the Chocolate Factory,1971,willy_wonka_and_the_chocolate_factory,7.5,29,26,3,89,0,0,0,0,0,0,0,0,http://content9.flixster.com/movie/25/32/253203_det.jpg
1076,The Innocents,1961,1099622-innocents,7.9,24,23,1,95,0,4,3,1,75,4,2095,85,http://content7.flixster.com/movie/28/56/285693_det.jpg
1077,Sleeper,1973,sleeper,8,28,28,0,100,0,4,4,0,100,3.7,6718,80,http://content8.flixster.com/movie/25/67/256722_det.jpg
1078,Bananas,1971,bananas,7,18,16,2,88,0,1,1,0,100,3.6,4533,73,http://content8.flixster.com/movie/10/90/14/10901434_det.jpg
1079,A Fish Called Wanda,1988,fish_called_wanda,8,46,44,2,95,7.8,8,7,1,87,3.4,15157,77,http://content9.flixster.com/movie/26/75/267511_det.jpg
1080,Life of Brian,1979,monty_pythons_life_of_brian,8.2,53,51,2,96,7.9,13,12,1,92,3.9,40453,91,http://content7.flixster.com/movie/10/94/54/10945437_det.jpg
1081,Victor Victoria,1982,victor-victoria,8,17,16,1,94,0,1,1,0,100,3.7,3624,82,http://content6.flixster.com/movie/25/53/255300_det.jpg
1082,The Manchurian Candidate,1962,1013227-manchurian_candidate,8.6,48,47,1,97,7.5,6,5,1,83,3.9,6006,89,http://content7.flixster.com/movie/26/56/265601_det.jpg
1083,The Great Race,1965,1008852-great_race,6.1,20,15,5,75,0,2,2,0,100,3.8,2175,81,http://content6.flixster.com/movie/10/88/81/10888116_det.jpg
1084,Bonnie and Clyde,1967,bonnie_and_clyde,8.1,46,41,5,89,6,7,4,3,57,3.7,12684,84,http://content6.flixster.com/movie/11/14/98/11149888_det.jpg
1085,The Old Man and the Sea,1958,1070233-old_man_and_the_sea,6.4,8,7,1,87,0,0,0,0,0,0,0,0,http://content8.flixster.com/movie/10/88/22/10882258_det.jpg
1086,Dial M for Murder,1954,dial_m_for_murder,7.2,26,21,5,80,6.8,6,5,1,83,3.9,9307,88,http://content7.flixster.com/movie/10/86/71/10867193_det.jpg
1087,M. Butterfly,1993,the-thistle-and-the-lotus,0,0,0,0,0,0,0,0,0,0,0,0,0,http://images.rottentomatoescdn.com/images/defaults/poster_default.gif
1088,Dirty Dancing,1987,dirty_dancing,5.8,43,29,14,67,5.8,6,4,2,66,3.7,185439,88,http://content6.flixster.com/movie/10/91/46/10914656_det.jpg
1089,Reservoir Dogs,1992,reservoir_dogs,8.9,45,43,2,95,8.5,12,11,1,91,4.1,125757,93,http://content6.flixster.com/movie/10/83/91/10839128_det.jpg
1090,Platoon,1986,platoon,7.8,42,36,6,85,6.8,10,7,3,70,3.9,49655,91,http://content7.flixster.com/movie/10/86/50/10865025_det.jpg
1091,Weekend at Bernie's,1989,weekend_at_bernies,4.9,21,10,11,47,0,1,0,1,0,3,6596,57,http://content9.flixster.com/movie/10/88/30/10883063_det.jpg
1092,Basic Instinct,1992,basic_instinct,6,42,25,17,59,5.7,10,6,4,60,3.1,14326,64,http://content7.flixster.com/movie/28/33/283309_det.jpg
1093,The Doors,1991,doors,5.8,44,25,19,56,4.1,9,2,7,22,3.6,14440,80,http://content7.flixster.com/movie/28/48/284817_det.jpg
1094,The Crying Game,1992,crying_game,8.5,38,38,0,100,9.4,6,6,0,100,3.5,5761,76,http://content7.flixster.com/movie/27/86/278613_det.jpg
1095,Glengarry Glen Ross,1992,glengarry_glen_ross,8.5,41,40,1,97,0,4,4,0,100,3.9,9083,87,http://content6.flixster.com/movie/10/93/46/10934652_det.jpg
1096,Sophie's Choice,1982,sophies_choice,7.1,26,21,5,80,6.6,5,3,2,60,3.9,5468,87,http://content6.flixster.com/movie/10/88/09/10880940_det.jpg
1097,E.T.: The Extra-Terrestrial,1982,et_the_extraterrestrial,8.9,89,87,2,97,8.6,18,17,1,94,3.5,154405,65,http://content8.flixster.com/movie/16/90/48/1690482_det.jpg
1098,The Search for One-eye Jimmy,1994,the-search-for-oneeye-jimmy,0,0,0,0,0,0,0,0,0,0,0,0,0,http://content9.flixster.com/movie/35/55/91/3555915_det.jpg
1099,A Christmas Carol,1984,christmas_carol_1984miracle_on_34th_street_1994_2pack,0,0,0,0,0,0,0,0,0,0,0,0,0,http://content9.flixster.com/movie/10/99/61/10996135_det.jpg
1100,Days of Thunder,1990,days_of_thunder,4.6,43,17,26,39,5.6,8,5,3,62,3,14585,59,http://content9.flixster.com/movie/25/70/257091_det.jpg
1101,Top Gun,1986,danger_zone_2,0,0,0,0,0,0,0,0,0,0,0,0,0,http://images.rottentomatoescdn.com/images/defaults/poster_default.gif
1102,American Strays,1996,american_strays,0,0,0,0,0,0,0,0,0,0,0,0,0,http://content6.flixster.com/movie/11/15/11/11151128_det.jpg
1103,Rebel Without a Cause,1955,rebel_without_a_cause,8.2,41,39,2,95,7.7,5,5,0,100,3.9,14558,87,http://content7.flixster.com/movie/10/87/09/10870961_det.jpg
1104,A Streetcar Named Desire,1951,1020333-streetcar_named_desire,8.5,46,45,1,97,8.5,5,5,0,100,3.9,13151,88,http://content6.flixster.com/movie/25/45/254524_det.jpg
1105,Children of the Corn: The Gathering,1996,children_of_the_corn_iv_the_gathering,0,1,0,1,0,0,0,0,0,0,0,0,0,http://content8.flixster.com/movie/10/91/84/10918478_det.jpg
1107,Loser,2000,1098734-loser,4.2,94,23,71,24,4.5,26,9,17,34,2.6,5745,37,http://content7.flixster.com/movie/26/34/263425_det.jpg
1111,Microcosmos: Le peuple de l'herbe,1996,microcosmos,8,29,28,1,96,9.3,5,5,0,100,4,1418,89,http://content9.flixster.com/movie/10/86/09/10860943_det.jpg
1112,Palookaville,1995,palookaville,6.2,11,7,4,63,0,3,3,0,100,3.3,334,58,http://content7.flixster.com/movie/28/19/281993_det.jpg
1113,The Associate,1996,1073315-associate,5.1,17,4,13,23,6.2,7,3,4,42,2.9,1259,52,http://content7.flixster.com/movie/25/98/259813_det.jpg
1114,The Funeral,1996,1074517-funeral,7,24,20,4,83,7.6,5,5,0,100,3.4,1110,65,http://content7.flixster.com/movie/28/48/284821_det.jpg
1115,Sleepover,2004,sleepover,3.7,95,14,81,14,3.9,29,5,24,17,3.3,29842,62,http://content6.flixster.com/movie/10/94/27/10942700_det.jpg
1116,La fille seule,1995,a-single-girl,6.8,7,5,2,71,0,0,0,0,0,0,0,0,http://content6.flixster.com/movie/10/89/99/10899968_det.jpg
1117,Le huiti√®me jour,1996,eighth_day,6.8,6,4,2,66,0,3,1,2,33,4,1377,86,http://content6.flixster.com/movie/19/57/20/1957200_det.jpg
1119,Punch-Drunk Love,2002,punchdrunk_love,7.4,179,141,38,78,7.4,36,29,7,80,3.2,24379,72,http://content7.flixster.com/movie/27/01/270105_det.jpg
1120,The People vs. Larry Flynt,1996,people_vs_larry_flynt,7.7,53,46,7,86,7.7,15,13,2,86,3.3,7206,73,http://content9.flixster.com/movie/27/96/279603_det.jpg
1121,Glory Daze,1995,glory_daze,0,4,0,4,0,0,0,0,0,0,0,0,0,http://content8.flixster.com/movie/28/01/280106_det.jpg
1123,A Perfect Candidate,1996,perfect_candidate,6.9,16,14,2,87,7.5,8,7,1,87,3.2,252,66,http://content7.flixster.com/movie/30/24/302417_det.jpg
1124,On Golden Pond,1981,on_golden_pond,7.5,21,19,2,90,0,4,3,1,75,3.7,4024,84,http://content7.flixster.com/movie/26/46/264625_det.jpg
1125,The Return of the Pink Panther,1975,return_of_the_pink_panther,6.6,16,14,2,87,0,0,0,0,0,0,0,0,http://content7.flixster.com/movie/10/87/22/10872257_det.jpg
1126,Drop Dead Fred,1991,drop_dead_fred,2.7,12,1,11,8,0,1,0,1,0,3.1,20039,72,http://content7.flixster.com/movie/25/58/255809_det.jpg
1127,The Abyss,1989,abyss,7.2,43,38,5,88,6.5,6,4,2,66,3.5,17381,78,http://content7.flixster.com/movie/26/41/264193_det.jpg
1128,The Fog,2005,fog,2.7,66,3,63,4,2.8,11,0,11,0,2.5,14642,35,http://content7.flixster.com/movie/25/03/250317_det.jpg
1129,Escape from New York,1981,1006717-escape_from_new_york,6.8,45,37,8,82,0,4,2,2,50,3.4,15629,72,http://content8.flixster.com/movie/27/30/273002_det.jpg
1130,The Howling,1981,howling,6.1,25,15,10,60,0,1,0,1,0,3.2,4849,61,http://content6.flixster.com/movie/28/39/283992_det.jpg
1131,Jean de Florette,1986,jean_de_florette,8,19,19,0,100,0,3,3,0,100,4.2,3691,94,http://content8.flixster.com/movie/25/83/258318_det.jpg
1132,Manon des sources,1986,manon_of_the_spring,8.9,13,13,0,100,0,2,2,0,100,4.2,2871,91,http://content6.flixster.com/movie/10/94/69/10946936_det.jpg
1133,Kinsey,2004,kinsey,7.6,187,168,19,89,7.9,39,36,3,92,3.4,6162,72,http://content6.flixster.com/movie/10/94/53/10945324_det.jpg
1135,Private Benjamin,1980,private_benjamin,6.7,22,19,3,86,0,1,1,0,100,3,3377,57,http://content6.flixster.com/movie/27/50/275008_det.jpg
1136,Monty Python and the Holy Grail,1975,monty_python_and_the_holy_grail,7.8,51,48,3,94,7.1,13,12,1,92,4.1,94032,94,http://content7.flixster.com/movie/26/07/260725_det.jpg
1137,Hustler White,1996,hustler_white,0,2,1,1,50,0,0,0,0,0,0,0,0,http://content7.flixster.com/movie/28/80/288093_det.jpg
1138,Dadetown,1995,dadetown,0,4,3,1,75,0,3,2,1,66,0,0,0,http://images.rottentomatoescdn.com/images/defaults/poster_default.gif
1139,Everything Relative,1996,everything_relative,4.9,8,2,6,25,0,4,1,3,25,3.2,49,50,http://content8.flixster.com/movie/10/88/06/10880662_det.jpg
1140,Entertaining Angels: The Dorothy Day Story,1996,entertaining_angels_the_dorothy_day_story,4.8,6,3,3,50,0,1,0,1,0,3.7,176,67,http://content8.flixster.com/movie/35/32/07/3532074_det.jpg
1142,Get Over It,2001,get_over_it,5.1,62,28,34,45,5.4,18,9,9,50,2.9,9761,51,http://content9.flixster.com/movie/10/87/96/10879663_det.jpg
1143,Trois vies & une seule mort,1996,three_lives_and_only_one_death,6.3,9,5,4,55,0,2,1,1,50,4,162,80,http://content7.flixster.com/movie/83/72/46/8372465_det.jpg
1144,The Line King: The Al Hirschfeld Story,1996,line_king_the_the_al_hirschfeld_story,0,2,2,0,100,0,0,0,0,0,0,0,0,http://content8.flixster.com/movie/10/85/81/10858174_det.jpg
1146,Curtis's Charm,1995,,\N,\N,\N,\N,\N,\N,\N,\N,\N,\N,\N,\N,\N,\N
1147,When We Were Kings,1996,when_we_were_kings,8.4,42,41,1,97,8.1,12,12,0,100,4.1,2489,91,http://content7.flixster.com/movie/10/92/29/10922993_det.jpg
1148,Wallace & Gromit in The Wrong Trousers,1993,wallace_and_gromit_the_wrong_trousers,9.1,24,24,0,100,0,0,0,0,0,0,0,0,http://content9.flixster.com/movie/74/28/86/7428867_det.jpg
1149,JLG/JLG - autoportrait de d√©cembre,1994,,\N,\N,\N,\N,\N,\N,\N,\N,\N,\N,\N,\N,\N,\N
1150,Le retour de Martin Guerre,1982,the-return-of-martin-guerre,8,9,9,0,100,0,0,0,0,0,0,0,0,http://content9.flixster.com/movie/29/94/299491_det.jpg
1151,Faust: Love of the Damned,2000,faust_love_of_the_damned,0,3,1,2,33,0,0,0,0,0,0,0,0,http://content7.flixster.com/movie/10/90/86/10908669_det.jpg
1152,He Walked by Night,1948,he_walked_by_night,7.6,6,5,1,83,0,0,0,0,0,0,0,0,http://content8.flixster.com/movie/10/33/53/10335338_det.jpg
1153,Raw Deal,1986,1017226-raw_deal,3.8,12,3,9,25,0,1,0,1,0,2.7,3041,32,http://content7.flixster.com/movie/10/87/80/10878017_det.jpg
1154,T-Men,1947,tmen,7.8,6,6,0,100,0,0,0,0,0,0,0,0,http://content7.flixster.com/movie/34/90/10/3490101_det.jpg
1156,I bambini ci guardano,1944,children_are_watching_us,0,2,2,0,100,0,0,0,0,0,0,0,0,http://content7.flixster.com/movie/10/93/91/10939149_det.jpg
1157,La symphonie pastorale,1946,la_symphonie_pastorale,0,0,0,0,0,0,0,0,0,0,0,0,0,http://content7.flixster.com/movie/10/86/41/10864137_det.jpg
1161,Die Blechtrommel,1979,tin_drum,7.3,12,9,3,75,0,1,0,1,0,4,2140,86,http://content7.flixster.com/movie/10/86/23/10862349_det.jpg
1162,The Ruling Class,1972,ruling_class,7.2,11,9,2,81,0,1,0,1,0,3.9,956,85,http://content8.flixster.com/movie/28/04/280402_det.jpg
1163,Mina Tannenbaum,1994,mina_tannenbaum,0,2,2,0,100,0,0,0,0,0,0,0,0,http://content8.flixster.com/movie/10/54/46/10544670_det.jpg
1164,2 ou 3 choses que je sais d'elle,1967,two_or_three_things_i_know_about_her,8,29,27,2,93,7.6,8,7,1,87,3.8,1050,73,http://content9.flixster.com/movie/55/83/45/5583455_det.jpg
1167,Dear God,1996,dear_god,3.6,33,4,29,12,3.2,10,0,10,0,2.6,883,26,http://content6.flixster.com/movie/10/91/90/10919008_det.jpg
1168,Bad Moon,1996,bad_moon,3.3,5,1,4,20,0,1,0,1,0,2.8,1122,41,http://content9.flixster.com/movie/27/37/273711_det.jpg
1169,"Hollywoodism: Jews, Movies and the American Dream",1998,,\N,\N,\N,\N,\N,\N,\N,\N,\N,\N,\N,\N,\N,\N
1170,Best of the Best 3: No Turning Back,1995,best_of_the_best_3_no_turning_back,0,0,0,0,0,0,0,0,0,0,0,0,0,http://content6.flixster.com/movie/11/14/40/11144072_det.jpg
1171,Bob Roberts,1992,bob_roberts,7.5,34,34,0,100,7.4,7,7,0,100,3.5,1689,70,http://content6.flixster.com/movie/10/91/75/10917528_det.jpg
1172,Nuovo Cinema Paradiso,1988,cinema_paradiso,7.9,56,50,6,89,7.8,15,13,2,86,4.4,21396,96,http://content9.flixster.com/movie/11/12/58/11125855_det.jpg
1173,The Cook the Thief His Wife & Her Lover,1989,cook_the_thief_his_wife_and_her_lover,7.3,37,33,4,89,8,7,6,1,85,3.9,5208,88,http://content6.flixster.com/movie/27/68/276824_det.jpg
1174,Grosse fatigue,1994,dead_tired,6.8,6,3,3,50,0,2,1,1,50,3.3,124,60,http://content8.flixster.com/movie/10/85/01/10850122_det.jpg
1175,Delicatessen,1991,delicatessen,7.6,39,34,5,87,5.4,6,3,3,50,4.1,14805,91,http://content6.flixster.com/movie/21/65/51/2165516_det.jpg
1176,La double vie de V√©ronique,1991,double_life_of_veronique,7.6,25,21,4,84,7.6,5,5,0,100,4.3,5676,92,http://content8.flixster.com/movie/10/94/04/10940458_det.jpg
1177,Enchanted April,1992,enchanted_april,7.2,19,17,2,89,0,2,2,0,100,3.9,2525,80,http://content8.flixster.com/movie/10/87/94/10879422_det.jpg
1178,Paths of Glory,1957,paths_of_glory,8.6,39,36,3,92,7.1,7,5,2,71,0,0,0,http://content8.flixster.com/movie/28/63/286322_det.jpg
1179,The Grifters,1990,grifters,7.9,38,34,4,89,7.1,8,6,2,75,3.4,2730,69,http://content6.flixster.com/movie/28/29/282900_det.jpg
1180,Hear My Song,1991,hear_my_song,7.1,12,11,1,91,0,2,2,0,100,3.7,154,74,http://content7.flixster.com/movie/44/09/73/4409737_det.jpg
1183,The English Patient,1996,english_patient,7.7,58,48,10,82,7.8,17,15,2,88,3.6,22977,82,http://content7.flixster.com/movie/10/88/86/10888661_det.jpg
1184,Mediterraneo,1991,mediterraneo,6.3,13,10,3,76,0,1,0,1,0,4.1,1443,91,http://content8.flixster.com/movie/10/05/64/10056494_det.jpg
1185,My Left Foot: The Story of Christy Brown,1989,my_left_foot,8.2,30,30,0,100,8.1,5,5,0,100,3.9,5875,90,http://content6.flixster.com/movie/14/81/63/1481632_det.jpg
1186,"Sex, Lies, and Videotape",1989,sex_lies_and_videotape,7.9,34,33,1,97,8,5,5,0,100,3.3,5946,73,http://content7.flixster.com/movie/27/06/270617_det.jpg
1187,Passion Fish,1992,passion_fish,7.8,22,22,0,100,0,3,3,0,100,3.6,614,79,http://content6.flixster.com/movie/27/83/278392_det.jpg
1188,Strictly Ballroom,1992,dancing-ballroom,0,0,0,0,0,0,0,0,0,0,0,0,0,http://content6.flixster.com/movie/10/84/26/10842624_det.jpg
1189,The Thin Blue Line,1988,thin_blue_line,8.7,11,11,0,100,0,1,1,0,100,4,1805,89,http://content7.flixster.com/movie/29/37/293729_det.jpg
1190,√Åtame!,1990,tie_me_up_tie_me_down,6.5,23,17,6,73,0,4,1,3,25,3.7,4683,79,http://content8.flixster.com/movie/11/13/35/11133522_det.gif
1191,Madonna: Truth or Dare,1991,madonna_truth_or_dare,6.1,16,12,4,75,0,2,2,0,100,3.2,2102,62,http://content6.flixster.com/movie/26/97/269792_det.jpg
1192,Paris Is Burning,1990,paris_is_burning,7.4,9,9,0,100,0,2,2,0,100,4,878,82,http://content7.flixster.com/movie/26/93/269309_det.jpg
1193,One Flew Over the Cuckoo's Nest,1975,one_flew_over_the_cuckoos_nest,8.8,50,48,2,96,6.3,6,4,2,66,4.2,61369,95,http://content6.flixster.com/movie/26/74/267412_det.jpg
1194,Up in Smoke,1978,up-in-smoke,5.1,16,7,9,43,0,2,0,2,0,3.6,11888,81,http://content9.flixster.com/movie/62/26/95/6226959_det.jpg
1196,Star Wars: Episode V - The Empire Strikes Back,1980,empire_strikes_back,8.6,71,69,2,97,7.5,17,15,2,88,4.1,146071,94,http://content6.flixster.com/movie/10/94/47/10944712_det.jpg
1197,The Princess Bride,1987,princess_bride,8.2,44,42,2,95,7.4,7,6,1,85,4,116640,92,http://content7.flixster.com/movie/10/92/26/10922677_det.png
1198,Raiders of the Lost Ark,1981,veggietales-silly-little-thing-called-love,0,0,0,0,0,0,0,0,0,0,0,0,0,http://images.rottentomatoescdn.com/images/defaults/poster_default.gif
1199,Brazil,1985,1003033-brazil,8.6,40,39,1,97,7.2,8,7,1,87,4.1,35162,89,http://content8.flixster.com/movie/26/99/269902_det.jpg
1200,Aliens,1986,1000617-aliens,8.8,47,47,0,100,8,7,7,0,100,3.8,72406,90,http://content6.flixster.com/movie/10/85/78/10857876_det.jpg
1201,"Il buono, il brutto, il cattivo.",1966,good_the_bad_and_the_ugly,8.7,62,61,1,98,8,11,10,1,90,4,40790,93,http://content9.flixster.com/movie/10/91/38/10913807_det.jpg
1202,Withnail & I,1987,withnail_and_i,8.3,28,26,2,92,0,1,1,0,100,4.4,11574,95,http://content6.flixster.com/movie/28/74/287404_det.jpg
1203,12 Angry Men,1957,1000013-12_angry_men,8.8,36,36,0,100,0,4,4,0,100,4.1,22784,95,http://content8.flixster.com/movie/10/88/47/10884742_det.jpg
1204,Lawrence of Arabia,1962,lawrence_of_arabia,8.8,56,55,1,98,8.3,15,14,1,93,4.1,22451,91,http://content6.flixster.com/movie/25/53/255304_det.jpg
1206,A Clockwork Orange,1971,great-writers-anthony-burgess,0,0,0,0,0,0,0,0,0,0,0,0,0,http://content8.flixster.com/movie/10/85/63/10856338_det.jpg
1207,To Kill a Mockingbird,1962,to_kill_a_mockingbird,8.8,39,38,1,97,0,3,3,0,100,3.8,19861,91,http://content6.flixster.com/movie/10/41/76/10417668_det.jpg
1208,Apocalypse Now,1979,apocalypse_now,8.8,61,60,1,98,8.4,11,10,1,90,4.1,67647,93,http://content6.flixster.com/movie/11/12/07/11120788_det.jpg
1209,C'era una volta il West,1968,once_upon_a_time_in_the_west,9,48,47,1,97,7.2,5,4,1,80,4.3,18310,94,http://content9.flixster.com/movie/10/88/22/10882283_det.jpg
1210,Star Wars: Episode VI - Return of the Jedi,1983,return_of_the_jedi,6.7,63,49,14,77,6.4,17,13,4,76,4,137818,93,http://content7.flixster.com/movie/10/94/47/10944709_det.jpg
1211,Der Himmel √ºber Berlin,1987,wings_of_desire,8.5,39,38,1,97,7.5,6,5,1,83,4.4,9110,94,http://content9.flixster.com/movie/25/46/254691_det.jpg
1212,The Third Man,1949,the-third-man,9.1,57,57,0,100,8.2,14,14,0,100,4.3,13251,94,http://content8.flixster.com/movie/11/14/87/11148754_det.jpg
1213,Goodfellas,1990,1032176-goodfellas,8.8,58,56,2,96,7.8,10,9,1,90,4.3,124589,96,http://content8.flixster.com/movie/10/93/19/10931922_det.jpg
1214,Alien,1979,american-alien,0,0,0,0,0,0,0,0,0,0,0,0,0,http://content7.flixster.com/movie/10/87/47/10874757_det.jpg
1215,Army of Darkness,1992,army_of_darkness,6.9,37,27,10,72,0,4,2,2,50,3.8,33240,85,http://content6.flixster.com/movie/10/86/53/10865344_det.jpg
1216,Le grand bleu,1988,1002303-big_blue,5.8,12,8,4,66,0,2,0,2,0,4.1,10653,92,http://content9.flixster.com/movie/10/94/57/10945723_det.jpg
1217,Ran,1985,ran,8.7,56,54,2,96,8.5,11,11,0,100,4.3,9990,94,http://content8.flixster.com/movie/10/89/37/10893702_det.jpg
1218,Dip huet seung hung,1989,1032434-killer,8.6,31,31,0,100,0,4,4,0,100,4,6079,91,http://content6.flixster.com/movie/29/00/290000_det.jpg
1219,Psycho,1960,psycho,8.9,67,66,1,98,7.5,8,7,1,87,3.9,32475,90,http://content7.flixster.com/movie/68/89/78/6889781_det.jpg
1220,The Blues Brothers,1980,blues_brothers,6.9,45,38,7,84,4.8,5,2,3,40,3.7,29786,89,http://content6.flixster.com/movie/10/84/85/10848572_det.jpg
1221,The Godfather: Part II,1974,godfather_part_ii,9.2,55,54,1,98,7.3,6,5,1,83,4.3,106035,96,http://content9.flixster.com/movie/26/72/267219_det.jpg
1222,Full Metal Jacket,1987,full_metal_jacket,8.2,55,53,2,96,7.7,8,7,1,87,4,77926,93,http://content8.flixster.com/movie/53/08/530874_det.jpg
1223,A Grand Day Out with Wallace and Gromit,1989,wallace_and_gromit_a_grand_day_out,8.3,19,19,0,100,0,0,0,0,0,0,0,0,http://content8.flixster.com/movie/74/28/88/7428882_det.jpg
1224,Henry V,1989,1029042-henry_v,8.2,32,32,0,100,7.8,7,7,0,100,4,3619,87,http://content9.flixster.com/movie/25/39/253911_det.jpg
1225,Amadeus,1984,amadeus,8.6,69,66,3,95,8.1,12,11,1,91,3.9,24420,94,http://content6.flixster.com/movie/25/50/255000_det.jpg
1226,The Quiet Man,1952,quiet_man,8,34,31,3,91,0,4,4,0,100,4.1,6203,91,http://content8.flixster.com/movie/29/63/296314_det.jpg
1227,Once Upon a Time in America,1984,once_upon_a_time_in_america,8.4,29,27,2,93,0,4,3,1,75,4.2,25390,92,http://content7.flixster.com/movie/10/91/75/10917577_det.jpg
1228,Raging Bull,1980,raging_bull,9,54,53,1,98,8.1,9,8,1,88,4.1,33528,92,http://content9.flixster.com/movie/10/93/45/10934583_det.jpg
1230,Annie Hall,1977,annie_hall,8.8,46,45,1,97,8.2,5,5,0,100,3.9,27350,92,http://content8.flixster.com/movie/10/85/12/10851294_det.jpg
1231,The Right Stuff,1983,right_stuff,8.6,30,29,1,96,0,1,1,0,100,3.9,5615,87,http://content7.flixster.com/movie/58/56/27/5856273_det.jpg
1232,Stalker,1979,1043378-stalker,8.2,16,16,0,100,0,2,2,0,100,4.5,6877,95,http://content7.flixster.com/movie/29/43/294309_det.jpg
1233,Das Boot,1981,das_boot,9,36,36,0,100,8.5,5,5,0,100,4.1,11718,94,http://content6.flixster.com/movie/10/92/18/10921888_det.jpg
1234,The Sting,1973,1020130-sting,8.1,45,41,4,91,6.9,5,4,1,80,4.1,16187,93,http://content7.flixster.com/movie/11/11/96/11119697_det.jpg
1235,Harold and Maude,1971,harold_and_maude,7.6,38,32,6,84,0,4,0,4,0,4.2,15115,93,http://content9.flixster.com/movie/25/38/253827_det.jpg
1236,Trust the Man,2005,trust_the_man,4.6,100,27,73,27,4.5,25,3,22,12,2.9,11451,38,http://content8.flixster.com/movie/21/37/19/2137190_det.jpg
1237,Det sjunde inseglet,1957,seventh_seal,9,46,43,3,93,0,4,3,1,75,4.3,12987,94,http://content6.flixster.com/movie/10/91/35/10913568_det.jpg
1238,Local Hero,1983,local_hero,8.8,30,30,0,100,0,4,4,0,100,4.1,2127,87,http://content8.flixster.com/movie/25/52/255294_det.jpg
1240,Terminator Salvation,2009,terminator_4,5,251,80,171,31,4.9,35,10,25,28,3.4,267474,64,http://content8.flixster.com/movie/10/92/76/10927658_det.jpg
1241,Braindead,1992,dead_alive,7.4,20,17,3,85,0,1,1,0,100,3.8,16839,84,http://content6.flixster.com/movie/28/59/285900_det.jpg
1242,Glory,1989,1008415-glory,7.9,40,37,3,92,7.4,9,8,1,88,4,13978,92,http://content7.flixster.com/movie/10/86/41/10864113_det.jpg
1243,Rosencrantz & Guildenstern Are Dead,1990,rosencrantz_and_guildenstern_are_dead,6.3,27,18,9,66,0,4,0,4,0,4,4144,89,http://content9.flixster.com/movie/25/43/254319_det.jpg
1244,Manhattan,1979,manhattan,8.6,43,42,1,97,8.5,6,6,0,100,4.1,14496,92,http://content7.flixster.com/movie/26/79/267901_det.jpg
1245,Miller's Crossing,1990,millers_crossing,8,51,46,5,90,6.9,9,7,2,77,4,14665,90,http://content6.flixster.com/movie/26/73/267312_det.jpg
1246,Dead Poets Society,1989,dead_poets_society,7.2,49,42,7,85,6.5,7,5,2,71,3.8,56733,90,http://content9.flixster.com/movie/10/58/40/10584083_det.jpg
1247,The Graduate,1967,graduate,8,44,39,5,88,6.7,6,5,1,83,3.7,22493,90,http://content8.flixster.com/movie/27/15/271514_det.jpg
1248,Touch of Evil,1958,touched-by-evil,0,0,0,0,0,0,0,0,0,0,0,0,0,http://content8.flixster.com/movie/10/85/14/10851430_det.jpg
1249,La Femme Nikita,1997,,\N,\N,\N,\N,\N,\N,\N,\N,\N,\N,\N,\N,\N,\N
1250,The Bridge on the River Kwai,1957,bridge_on_the_river_kwai,8.8,43,41,2,95,7.9,6,5,1,83,3.9,10774,90,http://content7.flixster.com/movie/10/92/73/10927333_det.jpg
1251,8¬Ω,1963,8-12,8.4,34,33,1,97,7.5,9,8,1,88,4.3,12375,92,http://content9.flixster.com/movie/49/37/75/4937759_det.jpg
1252,Chinatown,1974,chinatown,9.3,47,47,0,100,8.8,6,6,0,100,4.2,22995,92,http://content7.flixster.com/movie/10/87/19/10871921_det.jpg
1253,The Day the Earth Stood Still,1951,1005371-day_the_earth_stood_still,8,50,47,3,94,7,5,4,1,80,3.8,8999,86,http://content7.flixster.com/movie/10/87/31/10873109_det.jpg
1254,The Treasure of the Sierra Madre,1948,treasure_of_the_sierra_madre,9,38,38,0,100,8.5,5,5,0,100,4.1,6732,90,http://content8.flixster.com/movie/89/34/49/8934498_det.jpg
1255,Bad Taste,1987,bad_taste,6.4,20,14,6,70,0,0,0,0,0,0,0,0,http://content8.flixster.com/movie/11/14/76/11147638_det.jpg
1256,Duck Soup,1933,duck_soup,8.9,35,33,2,94,0,4,3,1,75,4.1,7416,91,http://content7.flixster.com/movie/29/49/294993_det.jpg
1257,Better Off Dead...,1985,1002213-better_off_dead,7,21,17,4,80,0,1,1,0,100,3.7,11561,86,http://content7.flixster.com/movie/10/84/19/10841913_det.jpg
1258,The Shining,1980,shining,7.8,45,39,6,86,5.4,6,3,3,50,4,91362,91,http://content8.flixster.com/movie/10/92/96/10929678_det.jpg
1259,Stand by Me,1986,1019794-stand_by_me,7.8,34,32,2,94,0,2,2,0,100,0,0,0,http://content9.flixster.com/movie/28/31/283115_det.jpg
1260,M,1931,1012928-m,9,40,40,0,100,8.4,8,8,0,100,4.3,9191,94,http://content8.flixster.com/movie/10/85/69/10856942_det.jpg
1261,Evil Dead II,1987,evil-dead-2,7.8,42,41,1,97,6.6,6,5,1,83,3.8,30657,86,http://content9.flixster.com/movie/51/02/510275_det.jpg
1262,The Great Escape,1963,secrets-of-the-great-wall2004,0,0,0,0,0,0,0,0,0,0,0,0,0,http://content8.flixster.com/movie/10/85/23/10852306_det.jpg
1263,The Deer Hunter,1978,deer_hunter,8.3,44,40,4,90,7.1,5,4,1,80,4.1,27513,91,http://content6.flixster.com/movie/26/75/267592_det.jpg
1264,Diva,1981,1005973-diva,8.1,41,39,2,95,8,14,13,1,92,4,1807,86,http://content8.flixster.com/movie/10/84/36/10843630_det.jpg
1265,Groundhog Day,1993,groundhog_day,7.9,52,50,2,96,7.5,10,10,0,100,3.3,34921,79,http://content7.flixster.com/movie/26/23/262309_det.jpg
1266,Unforgiven,1992,1041911-unforgiven,8.5,56,54,2,96,7.5,11,9,2,81,4,27203,91,http://content9.flixster.com/movie/10/93/21/10932195_det.jpg
1267,The Manchurian Candidate,1962,1013227-manchurian_candidate,8.6,48,47,1,97,7.5,6,5,1,83,3.9,6006,89,http://content7.flixster.com/movie/26/56/265601_det.jpg
1268,Pump Up the Volume,1990,pump_up_the_volume,6.7,31,25,6,80,0,3,2,1,66,3.4,5356,79,http://content8.flixster.com/movie/27/20/272094_det.jpg
1269,Arsenic and Old Lace,1944,arsenic_and_old_lace,7.6,21,19,2,90,0,3,2,1,66,4,9161,91,http://content8.flixster.com/movie/95/83/75/9583750_det.jpg
1270,Back to the Future,1985,back_to_the_future,8.4,54,52,2,96,7.3,6,5,1,83,3.8,126816,88,http://content6.flixster.com/movie/31/17/311700_det.jpg
1271,Fried Green Tomatoes,1991,fried_green_tomatoes,6.5,22,18,4,81,0,3,3,0,100,3.7,24457,88,http://content7.flixster.com/movie/10/88/22/10882269_det.jpg
1272,Patton,1970,patton,8.2,36,35,1,97,8.3,6,5,1,83,4,8522,93,http://content7.flixster.com/movie/18/68/40/1868409_det.jpg
1273,Down by Law,1986,down_by_law,7.4,24,21,3,87,6.1,6,4,2,66,4.3,6805,94,http://content8.flixster.com/movie/10/93/40/10934066_det.jpg
1274,Akira,1988,akira,7.3,34,30,4,88,6.9,6,5,1,83,4,33398,89,http://content6.flixster.com/movie/28/40/284000_det.jpg
1275,Highlander,1986,highlander,5.9,29,19,10,65,0,2,1,1,50,3.5,18748,78,http://content7.flixster.com/movie/10/94/47/10944769_det.jpg
1276,Cool Hand Luke,1967,cool_hand_luke,8.8,44,44,0,100,8.5,6,6,0,100,4.1,17521,93,http://content9.flixster.com/movie/29/06/290627_det.jpg
1277,Cyrano de Bergerac,1950,1005099-cyrano_de_bergerac,6.9,12,10,2,83,0,3,1,2,33,3.8,668,81,http://content7.flixster.com/movie/10/93/42/10934285_det.jpg
1278,Young Frankenstein,1974,young_frankenstein,8.5,46,43,3,93,0,4,4,0,100,3.8,37773,91,http://content6.flixster.com/movie/10/06/45/10064516_det.jpg
1279,Night on Earth,1991,night_on_earth,6.3,16,13,3,81,0,2,2,0,100,4,5592,91,http://content8.flixster.com/movie/54/92/80/5492802_det.jpg
1280,Da hong deng long gao gao gua,1991,raise_the_red_lantern,8.4,24,23,1,95,7.6,9,8,1,88,4.1,5193,92,http://content8.flixster.com/movie/10/89/42/10894258_det.jpg
1281,The Great Dictator,1940,great_dictator,8.9,34,32,2,94,8.8,7,6,1,85,4.2,16082,93,http://content8.flixster.com/movie/10/93/78/10937802_det.jpg
1282,Fantasia,1940,fantasia,8.5,42,41,1,97,8.3,6,6,0,100,3.5,12184,77,http://content7.flixster.com/movie/10/88/07/10880753_det.jpg
1283,High Noon,1952,1046060-high_noon,8.8,41,39,2,95,8.5,5,5,0,100,3.9,6074,87,http://content7.flixster.com/movie/30/88/308893_det.jpg
1284,The Big Sleep,1946,1002352-big_sleep,8.6,43,41,2,95,7.5,8,7,1,87,4.1,7772,91,http://content9.flixster.com/movie/10/89/25/10892543_det.jpg
1285,Heathers,1989,heathers,7.8,41,39,2,95,7,9,7,2,77,3.7,17025,82,http://content7.flixster.com/movie/28/00/280093_det.jpg
1286,Somewhere in Time,1980,somewhere_in_time,5.8,16,10,6,62,0,4,1,3,25,3.9,7602,88,http://content7.flixster.com/movie/10/87/45/10874553_det.jpg
1287,Ben-Hur,1959,benhur,7.8,33,30,3,90,0,4,3,1,75,3.7,25817,80,http://content9.flixster.com/movie/10/93/53/10935339_det.jpg
1288,This Is Spinal Tap,1984,this_is_spinal_tap,8.6,53,51,2,96,7.7,7,6,1,85,3.9,23608,91,http://content9.flixster.com/movie/28/14/281499_det.jpg
1289,Koyaanisqatsi,1982,koyaanisqatsi_life_out_of_balance,8,18,16,2,88,0,1,1,0,100,4.3,4109,91,http://content6.flixster.com/movie/28/60/286016_det.jpg
1290,Some Kind of Wonderful,1987,some_kind_of_wonderful,6.4,33,26,7,78,5.8,6,4,2,66,3.5,7505,78,http://content8.flixster.com/movie/10/84/77/10847746_det.jpg
1291,Indiana Jones and the Last Crusade,1989,indiana_jones_and_the_last_crusade,7.9,54,48,6,88,6.5,7,5,2,71,3.9,103952,91,http://content7.flixster.com/movie/10/91/96/10919621_det.jpg
1292,Being There,1979,being_there,8.4,38,36,2,94,0,4,4,0,100,4.1,6371,91,http://content6.flixster.com/movie/25/44/254496_det.jpg
1293,Gandhi,1982,gandhi,7.7,40,34,6,85,6.9,5,4,1,80,3.9,10562,91,http://content9.flixster.com/movie/10/85/69/10856927_det.jpg
1295,The Unbearable Lightness of Being,1988,unbearable_lightness_of_being,8.3,17,16,1,94,0,2,1,1,50,3.9,5178,84,http://content8.flixster.com/movie/27/30/273098_det.jpg
1296,A Room with a View,1985,1017864-room_with_a_view,8.6,21,21,0,100,0,2,2,0,100,3.9,6394,85,http://content6.flixster.com/movie/28/87/288792_det.jpg
1297,Real Genius,1985,real_genius,6.5,23,17,6,73,0,4,2,2,50,3.5,6720,78,http://content6.flixster.com/movie/25/42/254292_det.jpg
1298,Pink Floyd The Wall,1982,pink_floyd_the_wall,6.5,17,11,6,64,0,0,0,0,0,0,0,0,http://content8.flixster.com/movie/10/87/16/10871678_det.jpg
1299,The Killing Fields,1984,killing_fields,8.1,33,30,3,90,5.8,6,3,3,50,4,6389,89,http://content7.flixster.com/movie/26/93/269393_det.jpg
1300,Mitt liv som hund,1985,my-life-as-a-dog,7.9,28,28,0,100,0,3,3,0,100,4.1,2751,88,http://content6.flixster.com/movie/26/43/264304_det.jpg
1301,Forbidden Planet,1956,forbidden_planet,8.1,36,35,1,97,0,2,2,0,100,3.8,4780,82,http://content7.flixster.com/movie/25/08/250801_det.jpg
1302,Field of Dreams,1989,field_of_dreams,7.7,45,41,4,91,5.9,8,5,3,62,3.4,16498,85,http://content7.flixster.com/movie/10/84/97/10849709_det.jpg
1303,The Man Who Would Be King,1975,man_who_would_be_king,8.6,20,19,1,95,0,4,3,1,75,4,3790,88,http://content8.flixster.com/movie/25/47/254722_det.jpg
1304,Butch Cassidy and the Sundance Kid,1969,1003318-butch_cassidy_and_the_sundance_kid,8.1,42,38,4,90,6.5,5,3,2,60,3.9,17396,90,http://content6.flixster.com/movie/10/93/10/10931056_det.jpg
1305,"Paris, Texas",1984,paris_texas,8.2,25,25,0,100,0,1,1,0,100,4.2,6389,93,http://content6.flixster.com/movie/10/93/85/10938524_det.jpg
1306,Bis ans Ende der Welt,1991,until_the_end_of_the_world,6.5,12,10,2,83,0,1,0,1,0,4.1,1508,87,http://content8.flixster.com/movie/44/43/77/4443770_det.jpg
1307,When Harry Met Sally...,1989,when_harry_met_sally,7.8,47,43,4,91,6.2,8,6,2,75,3.5,47834,83,http://content6.flixster.com/movie/31/25/312596_det.jpg
1310,Hype!,1996,hype,7.5,6,6,0,100,0,2,2,0,100,3.9,430,85,http://content6.flixster.com/movie/28/70/287012_det.jpg
1311,Santa with Muscles,1996,santa_with_muscles,0,3,0,3,0,0,0,0,0,0,0,0,0,http://content8.flixster.com/movie/10/86/76/10867690_det.jpg
1312,Female Perversions,1996,female_perversions,6.3,21,14,7,66,6.8,9,7,2,77,3.1,264,48,http://content9.flixster.com/movie/10/97/76/10977687_det.jpg
1313,Mad Dog Time,1996,mad_dog_time,2.9,6,1,5,16,0,2,0,2,0,2.9,429,48,http://content9.flixster.com/movie/11/12/32/11123267_det.jpg
1314,Breathing Room,2008,breathing-room,0,0,0,0,0,0,0,0,0,0,0,0,0,http://content7.flixster.com/movie/10/90/03/10900357_det.jpg
1317,I'm Not Rappaport,1996,im_not_rappaport,5.6,15,5,10,33,0,4,1,3,25,3.4,285,61,http://content6.flixster.com/movie/26/50/265020_det.jpg
1318,Blue Juice,1995,blue_juice,0,2,0,2,0,0,1,0,1,0,3,1487,46,http://content7.flixster.com/movie/27/77/277701_det.jpg
1320,Alien¬≥,1992,alien_3,5,39,15,24,38,5.8,7,4,3,57,3.1,30526,55,http://content9.flixster.com/movie/27/38/273891_det.jpg
1321,An American Werewolf in London,1981,american_werewolf_in_london,7.5,43,38,5,88,0,4,2,2,50,3.4,18421,76,http://content7.flixster.com/movie/28/37/283709_det.jpg
1322,Amityville 1992: It's About Time,1992,amityville-its-about-time,2.3,7,1,6,14,0,0,0,0,0,0,0,0,http://content6.flixster.com/movie/27/25/272500_det.jpg
1323,Amityville 3-D,1983,amityville_3d,2.9,15,0,15,0,0,2,0,2,0,2.7,2070,32,http://content7.flixster.com/movie/26/28/262801_det.jpg
1324,Amityville: Dollhouse,1996,amityville_dollhouse,0,2,0,2,0,0,0,0,0,0,0,0,0,http://content9.flixster.com/movie/27/32/273299_det.jpg
1325,Amityville: A New Generation,1993,amityville_a_new_generation,0,1,0,1,0,0,0,0,0,0,0,0,0,http://content6.flixster.com/movie/10/88/97/10889788_det.jpg
1326,Amityville II: The Possession,1982,amityville_2_the_possession,2.7,14,1,13,7,0,1,0,1,0,2.9,3306,47,http://content6.flixster.com/movie/63/30/69/6330692_det.jpg
1327,The Amityville Horror,2005,amityville_horror,4.2,155,37,118,23,3.9,33,7,26,21,3.2,31070,64,http://content8.flixster.com/movie/24/97/249734_det.jpg
1328,The Amityville Curse,1990,amityville_curse,3.6,5,1,4,20,0,0,0,0,0,0,0,0,http://content7.flixster.com/movie/55/05/10/5505101_det.jpg
1329,Blood for Dracula,1974,blood-for-dracula,6.4,15,10,5,66,0,2,1,1,50,3.4,1432,58,http://content6.flixster.com/movie/10/91/36/10913628_det.jpg
1330,April Fool's Day,2008,1194078-april_fools_day,0,3,0,3,0,0,0,0,0,0,0,0,0,http://content8.flixster.com/movie/10/92/20/10922090_det.jpg
1331,Audrey Rose,1977,audrey_rose,5.4,9,5,4,55,0,0,0,0,0,0,0,0,http://content7.flixster.com/movie/26/14/261405_det.jpg
1332,Believers,2007,1183429-believers,0,3,0,3,0,0,0,0,0,0,0,0,0,http://content9.flixster.com/movie/10/14/14/10141427_det.jpg
1333,The Birds,1963,1002448-birds,8,40,38,2,95,0,4,2,2,50,3.5,17449,80,http://content8.flixster.com/movie/10/83/82/10838298_det.jpg
1334,The Blob,1988,1002585-blob,5.6,16,9,7,56,0,0,0,0,0,0,0,0,http://content6.flixster.com/movie/27/38/273804_det.jpg
1335,Blood Beach,1980,blood_beach,2.6,6,0,6,0,0,0,0,0,0,0,0,0,http://content9.flixster.com/movie/10/86/83/10868347_det.jpg
1336,Body Parts,1991,1040324-body_parts,4.4,15,6,9,40,0,1,0,1,0,2.6,958,31,http://content9.flixster.com/movie/10/04/67/10046739_det.jpg
1337,Invasion of the Body Snatchers,1956,1010678-invasion_of_the_body_snatchers,8.9,36,36,0,100,0,2,2,0,100,3.6,3820,81,http://content8.flixster.com/movie/10/95/44/10954478_det.jpg
1339,Dracula,1931,1006234-dracula,7.7,42,39,3,92,7.7,6,6,0,100,3.6,8598,76,http://content9.flixster.com/movie/29/22/292203_det.jpg
1340,Bride of Frankenstein,1935,bride_of_frankenstein,8.9,39,39,0,100,8.6,6,6,0,100,3.7,4867,82,http://content8.flixster.com/movie/30/28/302822_det.jpg
1341,Burnt Offerings,1976,burnt_offerings,5.2,8,3,5,37,0,1,0,1,0,3.1,927,45,http://content7.flixster.com/movie/25/77/257797_det.jpg
1342,Candyman,1992,candyman,6.3,37,27,10,72,5.4,5,3,2,60,3,12889,58,http://content6.flixster.com/movie/27/80/278008_det.jpg
1343,Cape Fear,1991,1037581-cape_fear,6.9,38,29,9,76,8.3,6,6,0,100,3.4,13943,74,http://content9.flixster.com/movie/10/93/72/10937223_det.jpg
1344,Cape Fear,1991,1037581-cape_fear,6.9,38,29,9,76,8.3,6,6,0,100,3.4,13943,74,http://content9.flixster.com/movie/10/93/72/10937223_det.jpg
1345,Carrie,1976,1003625-carrie,8,42,38,4,90,6.4,7,4,3,57,3.3,23161,70,http://content9.flixster.com/movie/28/14/281415_det.jpg
1346,Cat People,1982,1003758-cat_people,6.1,36,23,13,63,0,3,2,1,66,3,2400,46,http://content8.flixster.com/movie/28/49/284902_det.jpg
1347,A Nightmare on Elm Street,1984,nightmare_on_elm_street,7.7,40,38,2,95,0,4,4,0,100,3.5,57452,78,http://content7.flixster.com/movie/11/12/18/11121889_det.jpg
1348,"Nosferatu, eine Symphonie des Grauens",1922,nosferatu,8.9,47,46,1,97,8.2,5,5,0,100,3.9,11264,86,http://content9.flixster.com/movie/28/92/289207_det.jpg
1349,Nosferatu a Venezia,1988,nosferatu-a-venezia-nosferatu-in-venice-vampire-in-venice,0,0,0,0,0,0,0,0,0,0,0,0,0,http://content7.flixster.com/movie/10/85/60/10856093_det.jpg
1350,The Omen,1976,1015517-omen,7,32,27,5,84,0,2,1,1,50,3.5,17016,78,http://content6.flixster.com/movie/10/93/48/10934824_det.jpg
1351,Blood and Wine,1996,blood_and_wine,6.1,31,19,12,61,6.5,9,6,3,66,3,951,36,http://content7.flixster.com/movie/10/88/75/10887533_det.jpg
1352,Albino Alligator,1996,albino_alligator,5.5,17,8,9,47,5.4,6,2,4,33,3,1198,42,http://content8.flixster.com/movie/10/83/84/10838426_det.jpg
1353,The Mirror Has Two Faces,1996,mirror_has_two_faces,5.3,28,15,13,53,0,4,1,3,25,3.5,2549,72,http://content6.flixster.com/movie/10/92/03/10920300_det.jpg
1354,Breaking the Waves,1996,breaking_the_waves,8,42,36,6,85,7.8,7,6,1,85,4.1,7949,91,http://content9.flixster.com/movie/10/91/67/10916763_det.jpg
1355,Nochnoy dozor,2004,1148279-night_watch,5.9,125,73,52,58,5.9,30,17,13,56,3.3,19774,70,http://content8.flixster.com/movie/22/60/07/2260074_det.jpg
1356,Star Trek: First Contact,1996,star_trek_first_contact,7.4,52,48,4,92,7.4,13,12,1,92,3.5,20013,84,http://content9.flixster.com/movie/10/88/85/10888599_det.jpg
1357,Shine,1996,shine,8,31,28,3,90,8.8,7,7,0,100,3.8,6087,89,http://content6.flixster.com/movie/10/95/41/10954120_det.jpg
1358,Sling Blade,1996,sling_blade,8.3,49,47,2,95,7.9,16,14,2,87,3.9,10557,91,http://content7.flixster.com/movie/10/93/85/10938549_det.jpg
1359,Jingle All the Way,1996,jingle_all_the_way,4,38,6,32,15,5.3,6,1,5,16,2.6,10937,42,http://content9.flixster.com/movie/25/51/255123_det.jpg
1361,Paradise Lost: The Child Murders at Robin Hood Hills,1996,paradise_lost_the_child_murders_at_robin_hood_hills,8.2,24,23,1,95,0,3,3,0,100,4.1,1701,90,http://content7.flixster.com/movie/11/14/56/11145609_det.jpg
1363,The Preacher's Wife,1996,preachers_wife,5.8,38,23,15,60,7.2,11,8,3,72,2.9,3793,54,http://content7.flixster.com/movie/10/84/31/10843145_det.jpg
1364,Kj√¶rlighetens kj√∏tere,1995,zero-kelvin,0,0,0,0,0,0,0,0,0,0,0,0,0,http://content7.flixster.com/movie/30/86/308629_det.jpg
1365,Ridicule,1996,ridicule,7.3,17,13,4,76,8.2,5,5,0,100,3.8,979,83,http://content8.flixster.com/movie/10/87/61/10876134_det.jpg
1366,The Crucible,1996,1074978-crucible,7.2,26,20,6,76,8.3,6,4,2,66,3.2,4752,64,http://content9.flixster.com/movie/10/85/09/10850975_det.jpg
1367,One Hundred and One Dalmatians,1961,1036674-101_dalmatians,8,37,36,1,97,7.6,5,5,0,100,3.3,29711,63,http://content7.flixster.com/movie/10/92/06/10920681_det.jpg
1369,J'ai pas sommeil,1994,i-cant-sleep,7.5,7,5,2,71,0,2,1,1,50,3.4,283,70,http://content8.flixster.com/movie/10/88/71/10887118_det.jpg
1370,Die Hard,1988,die_hard,8.1,50,47,3,94,6.2,9,6,3,66,3.9,99625,91,http://content8.flixster.com/movie/10/93/34/10933490_det.gif
1371,Star Trek: The Motion Picture,1979,star_trek_the_motion_picture,5.8,31,15,16,48,4.8,5,2,3,40,3.1,14598,48,http://content9.flixster.com/movie/25/77/257795_det.jpg
1372,Star Trek VI: The Undiscovered Country,1991,star_trek_vi_the_undiscovered_country,6.8,46,38,8,82,7.1,6,5,1,83,3.5,13463,77,http://content7.flixster.com/movie/10/88/86/10888601_det.jpg
1373,Star Trek V: The Final Frontier,1989,star_trek_v_the_final_frontier,4,41,9,32,21,3.4,7,0,7,0,2.8,11133,37,http://content9.flixster.com/movie/10/89/11/10891103_det.jpg
1374,Star Trek: The Wrath of Khan,1982,star_trek_ii_the_wrath_of_khan,7.8,40,36,4,90,7.1,6,5,1,83,3.7,18490,86,http://content8.flixster.com/movie/10/88/85/10888590_det.jpg
1375,Star Trek III: The Search for Spock,1984,star_trek_iii_the_search_for_spock,6.4,38,29,9,76,6.4,6,5,1,83,3.3,13649,60,http://content6.flixster.com/movie/10/88/86/10888604_det.jpg
1376,Star Trek IV: The Voyage Home,1986,star_trek_iv_the_voyage_home,6.8,37,31,6,83,6.2,7,5,2,71,3.5,14361,77,http://content9.flixster.com/movie/10/88/86/10888603_det.jpg
1377,Batman Returns,1992,batman_returns,6.5,46,36,10,78,5.8,9,6,3,66,3.3,65412,68,http://content7.flixster.com/movie/56/82/90/5682901_det.jpg
1378,Young Guns,1988,young_guns,4.6,25,10,15,40,0,3,1,2,33,3.5,11858,77,http://content6.flixster.com/movie/11/14/43/11144324_det.jpg
1379,Young Guns II,1990,young_guns_2,4.9,16,6,10,37,0,2,0,2,0,3.2,7476,67,http://content7.flixster.com/movie/11/14/43/11144321_det.jpg
1380,Grease,1978,grease,6.7,54,45,9,83,5.9,11,9,2,81,3.7,176349,85,http://content8.flixster.com/movie/55/35/45/5535450_det.jpg
1381,Grease,1978,grease,6.7,54,45,9,83,5.9,11,9,2,81,3.7,176349,85,http://content8.flixster.com/movie/55/35/45/5535450_det.jpg
1382,Marked for Death,1990,marked_for_death,3.2,9,2,7,22,0,0,0,0,0,0,0,0,http://content8.flixster.com/movie/27/16/271606_det.jpg
1383,Adrenalin: Fear the Rush,1996,adrenalin_fear_the_rush,1.4,5,0,5,0,0,1,0,1,0,2.7,684,30,http://content9.flixster.com/movie/15/97/11/1597119_det.jpg
1384,The Substance of Fire,1996,substance_of_fire,6.1,10,6,4,60,0,3,1,2,33,3,189,26,http://content7.flixster.com/movie/28/32/283217_det.jpg
1385,Under Siege,1992,under_siege,6.2,23,17,6,73,0,3,2,1,66,3,9661,60,http://content9.flixster.com/movie/27/21/272191_det.jpg
1386,Terror in a Texas Town,1958,terror_in_a_texas_town,0,3,3,0,100,0,0,0,0,0,0,0,0,http://content9.flixster.com/movie/10/84/99/10849939_det.jpg
1387,Jaws,1975,jaws,8.8,37,37,0,100,8.5,5,5,0,100,3.5,63534,81,http://content7.flixster.com/movie/10/93/72/10937249_det.jpg
1388,Jaws,1975,jaws,8.8,37,37,0,100,8.5,5,5,0,100,3.5,63534,81,http://content7.flixster.com/movie/10/93/72/10937249_det.jpg
1389,Jaws 3-D,1983,jaws_3,2.9,24,3,21,12,0,2,0,2,0,2.5,15576,33,http://content6.flixster.com/movie/10/93/72/10937248_det.jpg
1390,My Fellow Americans,1996,my_fellow_americans,5.2,38,19,19,50,4.6,14,4,10,28,3.2,1831,61,http://content6.flixster.com/movie/25/90/259092_det.jpg
1391,Mars Attacks!,1996,mars_attacks,5.8,56,28,28,50,5.4,15,6,9,40,2.8,24991,49,http://content8.flixster.com/movie/10/88/97/10889794_det.jpg
1392,Citizen Ruth,1996,citizen_ruth,6.8,24,19,5,79,6,5,3,2,60,3.5,998,72,http://content9.flixster.com/movie/10/89/27/10892735_det.jpg
1393,Jerry Maguire,1996,jerry_maguire,7.4,57,48,9,84,7.5,19,17,2,89,3.3,32601,72,http://content9.flixster.com/movie/26/81/268123_det.jpg
1394,Raising Arizona,1987,raising_arizona,7.6,49,44,5,89,5.5,6,3,3,50,3.6,19379,82,http://content9.flixster.com/movie/99/56/74/9956747_det.jpg
1395,Tin Men,1987,tin_men,6.4,19,15,4,78,0,1,1,0,100,3.1,778,54,http://content7.flixster.com/movie/26/96/269609_det.jpg
1396,Sneakers,1992,sneakers,6.8,45,36,9,80,6.4,7,5,2,71,3.4,6830,77,http://content7.flixster.com/movie/10/51/26/10512625_det.jpg
1397,Bastard Out of Carolina,1996,bastard_out_of_carolina,7.1,9,9,0,100,0,0,0,0,0,0,0,0,http://content8.flixster.com/movie/27/35/273522_det.jpg
1398,In Love and War,1996,1074467-in_love_and_war,4.1,26,3,23,11,3.4,6,0,6,0,3,2942,52,http://content8.flixster.com/movie/26/21/262106_det.jpg
1399,Marvin's Room,1996,marvins_room,6.7,47,38,9,80,6,13,9,4,69,3.2,4558,58,http://content9.flixster.com/movie/10/88/77/10887763_det.jpg
1401,Ghosts of Mississippi,1996,ghosts_of_mississippi,5.8,26,13,13,50,6.4,7,3,4,42,3.4,1916,64,http://content6.flixster.com/movie/10/88/54/10885484_det.jpg
1404,Night Falls on Manhattan,1996,night_falls_on_manhattan,6.7,26,17,9,65,8,5,4,1,80,3.2,471,49,http://content8.flixster.com/movie/10/83/87/10838794_det.jpg
1405,Beavis and Butt-Head Do America,1996,beavis_and_butthead_do_america,6.2,51,36,15,70,6.4,12,8,4,66,3,19512,61,http://content9.flixster.com/movie/25/53/255323_det.jpg
1406,La c√©r√©monie,1995,1075705-ceremonie,7.7,27,25,2,92,7.4,12,11,1,91,3.9,747,85,http://content8.flixster.com/movie/30/64/306422_det.jpg
1407,Scream,1996,1074316-scream,7,53,43,10,81,6.6,14,10,4,71,3.2,50339,70,http://content7.flixster.com/movie/10/84/96/10849637_det.jpg
1408,The Last of the Mohicans,1992,1040678-last_of_the_mohicans,8,32,31,1,96,7.9,7,7,0,100,3.6,34073,84,http://content6.flixster.com/movie/27/61/276124_det.jpg
1409,Michael Clayton,2007,michael_clayton,7.6,192,173,19,90,7.9,37,35,2,94,3.6,123924,72,http://content8.flixster.com/movie/99/32/72/9932722_det.jpg
1410,The Evening Star,1996,evening_star,4.2,25,6,19,24,4.2,6,1,5,16,3.2,1029,59,http://content8.flixster.com/movie/25/99/259926_det.jpg
1411,Hamlet,1996,1075422-hamlet,8.2,54,51,3,94,7.2,14,11,3,78,3.8,5816,86,http://content7.flixster.com/movie/10/94/26/10942625_det.jpg
1412,Some Mother's Son,1996,some_mothers_son,6.3,15,10,5,66,6.8,6,3,3,50,4,520,86,http://content8.flixster.com/movie/34/90/07/3490070_det.jpg
1413,The Whole Wide World,1996,whole_wide_world,6.9,15,12,3,80,0,4,3,1,75,3.6,707,73,http://content8.flixster.com/movie/25/86/258602_det.jpg
1414,The Mother,2003,1132642-mother,7,88,68,20,77,7.4,32,29,3,90,3.4,862,61,http://content7.flixster.com/movie/27/51/275101_det.jpg
1415,Les voleurs,1996,1076146-thieves,7,11,9,2,81,0,4,4,0,100,3.4,257,64,http://content7.flixster.com/movie/10/19/65/10196545_det.jpg
1416,Evita,1996,evita,6.5,31,19,12,61,6.4,6,4,2,66,3.1,8855,65,http://content9.flixster.com/movie/25/44/254419_det.jpg
1417,The Portrait of a Lady,1996,1074321-portrait_of_a_lady,5.5,28,12,16,42,6.2,6,3,3,50,3.2,2438,50,http://content8.flixster.com/movie/26/56/265694_det.jpg
1419,Walkabout,1971,walkabout,8.1,26,24,2,92,0,3,3,0,100,3.9,1862,86,http://content6.flixster.com/movie/27/00/270092_det.jpg
1420,Message to Love: The Isle of Wight Festival,1997,message-to-love,0,0,0,0,0,0,0,0,0,0,0,0,0,http://images.rottentomatoescdn.com/images/defaults/poster_default.gif
1421,The Grateful Dead,1977,the-grateful-dead,0,0,0,0,0,0,0,0,0,0,0,0,0,http://content6.flixster.com/movie/10/83/90/10839040_det.jpg
1422,Murder at 1600,1997,murder_at_1600,5,30,10,20,33,5.3,6,1,5,16,2.9,4012,48,http://content8.flixster.com/movie/10/92/33/10923346_det.jpg
1423,Hearts and Minds,1974,hearts-and-minds,0,0,0,0,0,0,0,0,0,0,0,0,0,http://content9.flixster.com/movie/10/88/83/10888339_det.jpg
1425,Fierce Creatures,1997,fierce_creatures,5.6,31,17,14,54,5.6,5,1,4,20,3.1,3023,56,http://content8.flixster.com/movie/10/89/15/10891554_det.jpg
1426,Zeus and Roxanne,1997,zeus_and_roxanne,4.4,7,3,4,42,0,1,0,1,0,2.9,1549,47,http://content8.flixster.com/movie/26/30/263014_det.jpg
1427,Turbulence,1997,1074496-turbulence,3.2,18,3,15,16,0,4,0,4,0,2.5,718,23,http://content9.flixster.com/movie/10/84/08/10840899_det.jpg
1428,Angel Baby,1995,,\N,\N,\N,\N,\N,\N,\N,\N,\N,\N,\N,\N,\N,\N
1429,Ging chaat goo si 4: Ji gaan daan yam mo,1996,jackie_chans_first_strike,6,21,11,10,52,0,4,2,2,50,3,4216,55,http://content6.flixster.com/movie/26/65/266524_det.jpg
1430,Underworld,2003,underworld,4.7,155,47,108,30,4.4,32,5,27,15,3.6,101467,82,http://content9.flixster.com/movie/10/88/49/10884903_det.jpg
1431,Beverly Hills Ninja,1997,beverly_hills_ninja,3.2,28,4,24,14,4.6,8,3,5,37,2.8,13679,54,http://content9.flixster.com/movie/25/95/259519_det.jpg
1432,Metro,1997,1074675-1074675-metro,4,33,5,28,15,3.6,9,1,8,11,2.6,2757,31,http://content7.flixster.com/movie/62/77/83/6277833_det.jpg
1433,The Time Machine,2002,1112951-time_machine,4.8,146,41,105,28,5,32,6,26,18,2.7,10389,45,http://content6.flixster.com/movie/10/91/76/10917636_det.jpg
1434,The Strangers,2008,the_strangers,5,146,65,81,44,4.8,26,13,13,50,3.1,55773,48,http://content9.flixster.com/movie/11/12/79/11127923_det.jpg
1437,The Cement Garden,1993,evolutionary-masturbation,0,0,0,0,0,0,0,0,0,0,0,0,0,http://images.rottentomatoescdn.com/images/defaults/poster_default.gif
1438,Dante's Peak,1997,dantes_peak,4.9,25,7,18,28,4.8,7,0,7,0,2.7,20021,45,http://content7.flixster.com/movie/10/91/66/10916621_det.jpg
1439,Meet Wally Sparks,1997,meet_wally_sparks,2.5,14,2,12,14,0,2,1,1,50,2.6,586,32,http://content6.flixster.com/movie/27/78/277828_det.jpg
1440,Amos & Andrew,1993,amos_and_andrew,4,23,5,18,21,3.9,8,1,7,12,2.7,1624,36,http://content6.flixster.com/movie/32/93/27/3293272_det.jpg
1441,Benny & Joon,1993,benny_and_joon,5.7,30,22,8,73,5.1,8,4,4,50,3.6,28905,85,http://content7.flixster.com/movie/10/90/45/10904585_det.jpg
1442,Prefontaine,1997,prefontaine,6.4,26,16,10,61,6.7,9,5,4,55,3.7,1530,79,http://content8.flixster.com/movie/25/51/255198_det.jpg
1444,Guantanamera,1995,guantanamera,6.9,9,7,2,77,0,3,2,1,66,3.5,310,69,http://content9.flixster.com/movie/10/89/29/10892915_det.jpg
1445,McHale's Navy,1997,1076097-mchales_navy,2.2,29,1,28,3,1.7,7,0,7,0,2.6,1386,36,http://content8.flixster.com/movie/25/91/259102_det.jpg
1446,Kolja,1996,kolya,7.8,22,21,1,95,8.8,6,6,0,100,4.2,2011,91,http://content8.flixster.com/movie/26/24/262498_det.jpg
1447,Gridlock'd,1997,gridlockd,6.8,31,27,4,87,7.1,10,9,1,90,3.6,2054,79,http://content7.flixster.com/movie/28/37/283717_det.jpg
1449,Waiting for Guffman,1996,waiting_for_guffman,7.7,53,48,5,90,7.2,11,9,2,81,3.9,8495,90,http://content9.flixster.com/movie/10/87/12/10871239_det.jpg
1450,Kavkazskiy plennik,1996,prisoner-of-the-mountains,7.2,23,20,3,86,8.3,8,8,0,100,3.9,356,85,http://content7.flixster.com/movie/27/46/274693_det.jpg
1453,The Beautician and the Beast,1997,beautician_and_the_beast,4.6,18,3,15,16,4.7,6,1,5,16,2.4,2687,43,http://content9.flixster.com/movie/26/00/260003_det.jpg
1454,SubUrbia,1996,1075781-suburbia,6.3,21,13,8,61,6.4,6,3,3,50,3.3,1247,66,http://content7.flixster.com/movie/10/87/78/10877809_det.jpg
1455,Hotel de Love,1996,hotel_de_love,5.1,8,2,6,25,0,3,0,3,0,3.7,121,67,http://content8.flixster.com/movie/72/14/16/7214166_det.jpg
1456,The Pest,1997,pest,2.3,23,2,21,8,2.2,7,1,6,14,2.7,4963,63,http://content8.flixster.com/movie/25/85/258526_det.jpg
1457,Fools Rush In,1997,fools_rush_in,4.8,27,9,18,33,5.1,7,2,5,28,3,9687,61,http://content9.flixster.com/movie/31/38/313803_det.jpg
1458,Touch,1997,1074505-touch,4.7,17,5,12,29,0,3,0,3,0,2.9,494,36,http://content8.flixster.com/movie/39/55/09/3955094_det.jpg
1459,Absolute Power,1997,absolute_power,5.5,41,19,22,46,6.2,10,5,5,50,3.2,6094,52,http://content7.flixster.com/movie/55/34/87/5534877_det.jpg
1460,That Darn Cat,1997,1075251-that_darn_cat,3.8,14,1,13,7,0,4,0,4,0,2.5,2029,30,http://content6.flixster.com/movie/10/86/44/10864404_det.jpg
1461,Vegas Vacation,1997,vegas_vacation,3.8,28,4,24,14,3.2,10,1,9,10,3,7915,55,http://content7.flixster.com/movie/10/86/96/10869605_det.jpg
1463,That Old Feeling,1997,that_old_feeling,5,15,6,9,40,0,4,2,2,50,3,901,57,http://content6.flixster.com/movie/25/92/259296_det.jpg
1464,Lost Highway,1997,lost_highway,6.2,39,23,16,58,6,6,2,4,33,3.9,17451,87,http://content9.flixster.com/movie/10/89/41/10894179_det.jpg
1465,Rosewood,1997,rosewood,7.1,47,40,7,85,7,11,8,3,72,3.7,1445,82,http://content7.flixster.com/movie/27/01/270117_det.jpg
1466,Donnie Brasco,1997,donnie_brasco,7.8,54,47,7,87,7.1,16,12,4,75,3.7,40329,85,http://content7.flixster.com/movie/60/49/62/6049625_det.jpg
1468,Booty Call,1997,booty_call,4.2,12,3,9,25,5.4,6,2,4,33,2.8,3264,56,http://content9.flixster.com/movie/11/12/63/11126367_det.jpg
1471,Boys Life 2,1997,boys_life_2,6.7,5,4,1,80,0,2,2,0,100,3.3,79,64,http://content6.flixster.com/movie/10/85/10/10851024_det.jpg
1472,City of Industry,1997,city_of_industry,5.2,13,6,7,46,4.7,6,1,5,16,2.9,791,31,http://content8.flixster.com/movie/27/54/275494_det.jpg
1473,Children of Men,2006,children_of_men,8,208,193,15,92,7.8,41,37,4,90,3.7,127695,81,http://content6.flixster.com/movie/27/04/67/2704676_det.jpg
1474,Jungle 2 Jungle,1997,jungle_2_jungle,4,39,7,32,17,4.2,13,3,10,23,2.7,9218,44,http://content9.flixster.com/movie/25/96/259695_det.jpg
1475,Kama Sutra: A Tale of Love,1996,kama_sutra_a_tale_of_love,5,18,7,11,38,5.9,5,2,3,40,3.5,1793,72,http://content7.flixster.com/movie/11/12/12/11121289_det.jpg
1476,Private Parts,1997,private-parts,0,0,0,0,0,0,0,0,0,0,0,0,0,http://content7.flixster.com/movie/10/92/42/10924221_det.jpg
1477,Love Jones,1997,love_jones,6.4,15,10,5,66,6.8,5,4,1,80,4.2,4854,96,http://content7.flixster.com/movie/10/88/65/10886513_det.jpg
1479,The Saint,1997,saint,4.6,44,13,31,29,4.3,15,3,12,20,3.1,11647,62,http://content6.flixster.com/movie/10/86/88/10868812_det.jpg
1480,Smilla's Sense of Snow,1997,smillas_sense_of_snow,6,32,17,15,53,6.5,7,4,3,57,3.3,1224,59,http://content7.flixster.com/movie/27/65/276509_det.jpg
1482,Van Helsing,2004,unhuman,0,0,0,0,0,0,0,0,0,0,0,0,0,http://content8.flixster.com/movie/10/84/54/10845422_det.jpg
1483,Crash,2004,1144992-crash,7.1,197,148,49,75,7.1,39,30,9,76,4,98746,89,http://content7.flixster.com/movie/24/97/249717_det.jpg
1484,The Daytrippers,1996,daytrippers,6.4,22,16,6,72,0,4,3,1,75,3.5,621,67,http://content7.flixster.com/movie/28/48/284809_det.jpg
1485,Liar Liar,1997,liar_liar,6.9,51,42,9,82,7.5,15,13,2,86,3.4,93496,72,http://content6.flixster.com/movie/26/42/264208_det.jpg
1486,The Quiet Room,1996,quiet_room,0,4,3,1,75,0,0,0,0,0,0,0,0,http://content9.flixster.com/movie/10/91/52/10915291_det.jpg
1487,Selena,1997,1073427-selena,6,38,24,14,63,6.2,9,6,3,66,3.2,17729,76,http://content9.flixster.com/movie/10/86/75/10867511_det.jpg
1488,The Devil's Own,1997,devils_own,5.3,34,10,24,29,6.3,7,2,5,28,3,7624,46,http://content8.flixster.com/movie/21/77/85/2177854_det.jpg
1489,Cats Don't Dance,1997,cats_dont_dance,6.5,15,10,5,66,0,4,3,1,75,3.5,2510,72,http://content9.flixster.com/movie/10/88/92/10889223_det.jpg
1490,B*A*P*S,1997,baps,3,30,4,26,13,4.9,8,3,5,37,2.9,1372,57,http://content6.flixster.com/movie/10/84/83/10848328_det.jpg
1493,Love and Other Catastrophes,1996,love_and_other_catastrophes,5.5,13,6,7,46,0,3,0,3,0,3.8,270,75,http://content9.flixster.com/movie/10/90/14/10901411_det.jpg
1495,Turbo: A Power Rangers Movie,1997,turbo_a_power_rangers_movie,3.8,17,3,14,17,3.8,8,2,6,25,2.7,1946,42,http://content7.flixster.com/movie/10/94/61/10946113_det.jpg
1496,Anna Karenina,1935,1001063-anna_karenina,7.4,7,7,0,100,0,0,0,0,0,0,0,0,http://content7.flixster.com/movie/10/94/46/10944689_det.jpg
1497,Double Team,1997,double_team,3.8,19,2,17,10,4.8,5,0,5,0,2.2,4157,31,http://content6.flixster.com/movie/10/88/96/10889692_det.jpg
1498,Inventing the Abbotts,1997,inventing_the_abbotts,5.4,25,8,17,32,5.4,7,2,5,28,3.2,2432,54,http://content6.flixster.com/movie/10/86/16/10861636_det.jpg
1499,Anaconda,1997,anaconda,4.7,45,17,28,37,5.6,10,5,5,50,2.5,21526,32,http://content9.flixster.com/movie/10/85/54/10855479_det.jpg
1500,Grosse Pointe Blank,1997,grosse_pointe_blank,7.1,57,44,13,77,6.5,15,11,4,73,3.7,17815,85,http://content7.flixster.com/movie/26/73/267397_det.jpg
1501,Keys to Tulsa,1996,keys_to_tulsa,4.1,8,1,7,12,0,1,0,1,0,2.9,271,28,http://content6.flixster.com/movie/10/84/01/10840164_det.jpg
1502,KISS Meets the Phantom of the Park,1978,kiss-meets-the-phantom-of-the-park,0,0,0,0,0,0,0,0,0,0,0,0,0,http://content6.flixster.com/movie/31/31/313192_det.jpg
1503,8 Heads in a Duffel Bag,1997,8_heads_in_a_duffel_bag,3.3,18,2,16,11,0,4,0,4,0,2.6,2533,34,http://content6.flixster.com/movie/10/88/92/10889240_det.jpg
1504,Hollow Reed,1996,hollow_reed,7.4,12,11,1,91,0,3,2,1,66,3.1,40,47,http://content8.flixster.com/movie/10/85/78/10857874_det.jpg
1507,Paradise Road,1997,paradise_road,6,20,10,10,50,5.8,7,2,5,28,3.6,918,75,http://content7.flixster.com/movie/27/62/276221_det.jpg
1508,The Time Traveler's Wife,2009,time_travelers_wife,5.1,151,56,95,37,4.8,34,10,24,29,2.9,189828,65,http://content7.flixster.com/movie/10/92/43/10924397_det.jpg
1509,Walk All Over Me,2007,1194274-walk_all_over_me,0,4,2,2,50,0,1,0,1,0,3,609,37,http://content6.flixster.com/movie/10/91/88/10918812_det.jpg
1510,A Brother's Kiss,1997,brothers_kiss,0,4,4,0,100,0,2,2,0,100,2.9,289,44,http://content7.flixster.com/movie/28/48/284813_det.jpg
1511,Shekvarebuli kulinaris ataserti retsepti,1996,chef_in_love,6.4,10,6,4,60,0,3,1,2,33,3.5,32,50,http://content9.flixster.com/movie/10/87/72/10877223_det.jpg
1513,Romy and Michele's High School Reunion,1997,romy_and_micheles_high_school_reunion,6.2,49,34,15,69,5.9,16,9,7,56,2.8,12541,60,http://content6.flixster.com/movie/10/89/47/10894788_det.jpg
1514,Feng yue,1996,temptress_moon,6.4,13,8,5,61,6.2,5,2,3,40,3.5,585,67,http://content7.flixster.com/movie/27/05/270517_det.jpg
1515,Volcano,1997,1076267-volcano,5,38,16,22,42,4.5,10,3,7,30,2.7,14505,43,http://content8.flixster.com/movie/25/89/258910_det.jpg
1516,Children of the Revolution,1996,children_of_the_revolution,6.6,17,13,4,76,7,6,4,2,66,3.3,479,60,http://content9.flixster.com/movie/10/88/07/10880735_det.jpg
1517,Austin Powers: International Man of Mystery,1997,thomas-l-friedman-reporting-does-europe-hate-us2005,0,0,0,0,0,0,0,0,0,0,0,0,0,http://content7.flixster.com/movie/10/85/37/10853769_det.jpg
1518,Mujeres al borde de un ataque de nervios,1988,women_on_the_verge_of_a_nervous_breakdown,7.6,26,23,3,88,0,4,4,0,100,4,6254,88,http://content9.flixster.com/movie/10/87/03/10870371_det.jpg
1519,Broken English,2007,broken_english,6.3,73,47,26,64,6.2,23,14,9,60,3.4,14630,61,http://content9.flixster.com/movie/10/88/86/10888655_det.jpg
1520,The Ten Commandments,1956,1021015-ten_commandments,7.3,29,26,3,89,0,4,2,2,50,3.6,11440,83,http://content9.flixster.com/movie/25/22/252211_det.jpg
1522,Ripe,1996,ripe,4,5,0,5,0,0,2,0,2,0,0,0,0,http://content6.flixster.com/movie/10/86/20/10862068_det.jpg
1523,"Truth or Consequences, N.M.",1997,truth_or_consequences_nm,4.5,14,5,9,35,0,2,0,2,0,3.1,880,51,http://content6.flixster.com/movie/28/30/283020_det.jpg
1525,Warriors of Virtue,1997,warriors_of_virtue,4,10,1,9,10,0,4,0,4,0,2.9,927,45,http://content8.flixster.com/movie/26/48/264814_det.jpg
1526,Fathers' Day,1997,fathers_day,4,31,6,25,19,4.8,6,2,4,33,2.5,2603,31,http://content8.flixster.com/movie/24/53/74/2453742_det.jpg
1527,The Fifth Element,1997,fifth_element,6.3,53,38,15,71,5.2,10,4,6,40,3.7,84664,84,http://content7.flixster.com/movie/10/94/16/10941677_det.jpg
1528,Intimate Relations,1996,intimate_relations,5.2,7,1,6,14,0,3,0,3,0,3.6,31,64,http://content7.flixster.com/movie/10/86/21/10862101_det.jpg
1529,Nirgendwo in Afrika,2001,nowhere-in-africa,7.5,97,83,14,85,7.6,30,25,5,83,4,1773,88,http://content6.flixster.com/movie/10/93/76/10937636_det.jpg
1531,Losing Chase,1996,losing_chase,0,4,2,2,50,0,0,0,0,0,0,0,0,http://content7.flixster.com/movie/63/53/00/6353009_det.jpg
1532,Sprung,1997,sprung,4.2,9,2,7,22,0,4,0,4,0,3.5,343,70,http://content8.flixster.com/movie/27/92/279222_det.jpg
1533,La promesse,1996,la_promesse,7.7,19,18,1,94,7.7,8,8,0,100,3.9,599,85,http://content9.flixster.com/movie/30/43/304311_det.jpg
1534,Le bonheur,1965,le_bonheur,0,2,2,0,100,0,0,0,0,0,0,0,0,http://content6.flixster.com/movie/97/65/46/9765468_det.jpg
1535,Love! Valour! Compassion!,1997,love_valour_compassion,6.1,20,13,7,65,6.5,7,5,2,71,3.6,899,70,http://content6.flixster.com/movie/27/23/272396_det.jpg
1537,Shall we dansu?,1996,1078942-shall_we_dance,7.9,33,30,3,90,7.6,5,4,1,80,3.9,2687,86,http://content9.flixster.com/movie/10/91/66/10916667_det.jpg
1538,The Second Jungle Book: Mowgli & Baloo,1997,the-second-jungle-book-mowgli-baloo,0,0,0,0,0,0,0,0,0,0,0,0,0,http://content6.flixster.com/movie/90/13/91/9013916_det.jpg
1539,Twin Town,1997,twin_town,5.4,13,6,7,46,0,4,1,3,25,4.2,2298,90,http://content8.flixster.com/movie/94/77/97/9477974_det.jpg
1541,Addicted to Love,1997,addicted_to_love,5.6,30,17,13,56,6,5,3,2,60,2.8,4654,50,http://content9.flixster.com/movie/10/93/23/10932379_det.jpg
1542,Brassed Off,1996,brassed_off,6.6,28,22,6,78,6.4,6,4,2,66,3.5,2625,68,http://content7.flixster.com/movie/10/88/35/10883553_det.jpg
1543,The Designated Mourner,1997,designated_mourner,6.2,16,11,5,68,6.6,5,4,1,80,3.6,50,71,http://content9.flixster.com/movie/10/84/43/10844303_det.jpg
1544,The Lost World: Jurassic Park,1997,lost_world_jurassic_park,5.6,59,29,30,49,5.1,13,6,7,46,3.2,46513,55,http://content9.flixster.com/movie/10/84/11/10841191_det.jpg
1545,Ponette,1996,ponette,8.1,21,19,2,90,0,3,3,0,100,4.1,956,89,http://content9.flixster.com/movie/29/57/295707_det.jpg
1546,Schizopolis,1996,schizopolis,6.5,16,10,6,62,0,3,1,2,33,3.8,1164,79,http://content6.flixster.com/movie/10/93/41/10934148_det.jpg
1547,Saving Shiloh,2006,saving-shiloh,5.1,21,8,13,38,5.8,10,5,5,50,3.9,511,82,http://content7.flixster.com/movie/58/00/78/5800789_det.jpg
1548,The War at Home,2005,,\N,\N,\N,\N,\N,\N,\N,\N,\N,\N,\N,\N,\N,\N
1549,Rough Magic,1995,rough_magic,4.6,7,1,6,14,0,3,0,3,0,2.9,455,34,http://content9.flixster.com/movie/26/66/266691_det.jpg
1550,Trial and Error,1997,1077494-trial_and_error,5,29,12,17,41,7,6,3,3,50,2.7,602,27,http://content6.flixster.com/movie/26/36/263612_det.jpg
1551,Buddy,1997,1078022-buddy,5.4,19,5,14,26,6.2,6,2,4,33,2.8,1106,37,http://content6.flixster.com/movie/26/42/264224_det.jpg
1552,Con Air,1997,con_air,5.7,60,34,26,56,4.9,11,3,8,27,3.4,47142,77,http://content9.flixster.com/movie/59/50/55/5950555_det.jpg
1554,The Pillow Book,1996,pillow_book,6.7,26,20,6,76,0,3,3,0,100,3.8,4178,78,http://content9.flixster.com/movie/29/25/292599_det.jpg
1555,En avoir (ou pas),1995,,\N,\N,\N,\N,\N,\N,\N,\N,\N,\N,\N,\N,\N,\N
1556,Speed 2: Cruise Control,1997,speed_2_cruise_control,3.1,51,1,50,1,3.2,14,1,13,7,2.2,17521,28,http://content8.flixster.com/movie/26/58/265830_det.jpg
1558,Sudden Manhattan,1996,sudden-manhattan,5.6,6,4,2,66,0,0,0,0,0,0,0,0,http://content6.flixster.com/movie/10/84/93/10849332_det.jpg
1561,Wedding Bell Blues,1996,wedding_bell_blues,4,5,2,3,40,0,1,0,1,0,3.3,287,54,http://content7.flixster.com/movie/28/16/281613_det.jpg
1562,Batman & Robin,1997,10005205-batman,0,1,1,0,100,0,0,0,0,0,0,0,0,http://content7.flixster.com/movie/11/13/50/11135017_det.jpg
1563,Dream with the Fishes,1997,dream_with_the_fishes,6.1,19,11,8,57,0,3,2,1,66,3.7,452,79,http://content9.flixster.com/movie/28/09/280911_det.jpg
1564,Roseanna's Grave,1997,for_roseanna,5.8,7,3,4,42,0,4,2,2,50,3.6,557,73,http://content6.flixster.com/movie/10/86/08/10860840_det.jpg
1565,Head Above Water,1996,the-shape-of-water,0,0,0,0,0,0,0,0,0,0,0,0,0,http://content8.flixster.com/movie/10/86/75/10867562_det.jpg
1566,Hercules,1997,1078028-hercules,7,49,41,8,83,6.8,13,10,3,76,3.2,23787,68,http://content6.flixster.com/movie/25/25/252524_det.jpg
1567,The Last Time I Committed Suicide,1997,last_time_i_committed_suicide,0,3,1,2,33,0,0,0,0,0,0,0,0,http://content8.flixster.com/movie/10/89/67/10896710_det.jpg
1568,"Murder Me, Murder You",1983,,\N,\N,\N,\N,\N,\N,\N,\N,\N,\N,\N,\N,\N,\N
1569,My Best Friend's Wedding,1997,my_best_friends_wedding,6.5,54,39,15,72,5.9,17,10,7,58,3.3,64013,72,http://content7.flixster.com/movie/55/35/54/5535541_det.jpg
1570,Tetsuo II: Body Hammer,1992,tetsuo_ii_bodyhammer,0,3,2,1,66,0,1,1,0,100,3.4,1154,61,http://content9.flixster.com/movie/10/89/35/10893579_det.jpg
1571,Chacun cherche son chat,1996,when-the-cats-away,7.3,16,14,2,87,0,3,3,0,100,3.8,726,76,http://content7.flixster.com/movie/10/88/92/10889261_det.jpg
1572,Le m√©pris,1963,contempt,8.4,35,33,2,94,8.1,8,7,1,87,4.1,3449,86,http://content6.flixster.com/movie/10/93/40/10934024_det.jpg
1573,Face/Off,1997,faceoff,7.9,60,56,4,93,8.4,15,15,0,100,3.5,62348,81,http://content8.flixster.com/movie/10/85/08/10850854_det.jpg
1574,The Fall,2006,the-fall-2008,6.2,101,60,41,59,5.8,21,9,12,42,3.8,23397,85,http://content9.flixster.com/movie/10/87/50/10875031_det.jpg
1575,Gabbeh,1996,gabbeh,7.1,19,17,2,89,7.9,8,8,0,100,3.7,394,73,http://content7.flixster.com/movie/30/24/302493_det.jpg
1580,Men in Black,1997,men_in_black,7.5,67,61,6,91,7.3,19,16,3,84,3.5,73637,73,http://content7.flixster.com/movie/83/03/830325_det.jpg
1581,Out to Sea,1997,1077599-out_to_sea,5.3,20,7,13,35,0,4,1,3,25,3,1331,53,http://content6.flixster.com/movie/25/89/258996_det.jpg
1582,Wild America,1997,wild_america,4.5,18,3,15,16,4.9,5,0,5,0,2.9,3839,58,http://content9.flixster.com/movie/10/94/53/10945391_det.jpg
1583,A Simple Wish,1997,simple_wish,4.6,15,4,11,26,0,3,0,3,0,2.7,4830,40,http://content6.flixster.com/movie/26/50/265012_det.jpg
1584,Contact,1997,1078021-contact,6.8,55,37,18,67,6.5,13,7,6,53,3.1,19572,74,http://content9.flixster.com/movie/25/44/254411_det.jpg
1585,Love Serenade,1996,love_serenade,6.9,9,8,1,88,0,4,3,1,75,3.6,297,75,http://content7.flixster.com/movie/28/20/282097_det.jpg
1586,G.I. Jane,1997,gi_jane,6,29,16,13,55,6.4,6,3,3,50,3,11537,58,http://content8.flixster.com/movie/62/99/46/6299466_det.jpg
1587,Conan the Barbarian,1982,conan_the_barbarian,6.4,25,19,6,76,0,3,2,1,66,3.1,17014,66,http://content8.flixster.com/movie/28/20/282010_det.jpg
1588,George of the Jungle,1997,1077847-george_of_the_jungle,5.3,50,27,23,54,6.2,14,10,4,71,2.9,21989,47,http://content9.flixster.com/movie/25/63/256399_det.jpg
1589,Cop Land,1997,cop_land,6.5,59,42,17,71,6.1,18,13,5,72,3.1,8531,57,http://content6.flixster.com/movie/28/35/283596_det.jpg
1590,Event Horizon,1997,event_horizon,4.3,33,7,26,21,5.2,5,1,4,20,3.2,15014,63,http://content6.flixster.com/movie/26/93/269324_det.jpg
1591,Spawn,1997,spawn,4,40,8,32,20,4.2,9,2,7,22,2.8,18405,46,http://content8.flixster.com/movie/27/19/271926_det.jpg
1592,Air Bud,1997,air_bud,4.9,20,9,11,45,0,4,2,2,50,2.6,11606,42,http://content8.flixster.com/movie/25/88/258894_det.jpg
1593,Picture Perfect,1997,1078216-picture_perfect,5.4,40,19,21,47,5.2,9,3,6,33,2.7,4981,41,http://content9.flixster.com/movie/26/12/261223_det.jpg
1594,In the Company of Men,1997,in_the_company_of_men,7.9,53,47,6,88,7.9,13,12,1,92,3.7,1900,80,http://content9.flixster.com/movie/10/86/14/10861495_det.jpg
1595,Free Willy 3: The Rescue,1997,free_willy_3_the_rescue,4.7,15,6,9,40,0,2,2,0,100,2.8,7843,51,http://content6.flixster.com/movie/31/21/312112_det.jpg
1596,Career Girls,1997,career_girls,7.1,23,20,3,86,8.4,5,5,0,100,3.6,812,75,http://content7.flixster.com/movie/27/82/278213_det.jpg
1597,Conspiracy Theory,1997,conspiracy_theory,6.2,41,21,20,51,6.1,14,6,8,42,3.2,14632,66,http://content8.flixster.com/movie/10/88/46/10884674_det.jpg
1598,Desperate Measures,1998,desperate_measures,4.1,29,5,24,17,3.8,6,0,6,0,2.9,1973,39,http://content6.flixster.com/movie/27/79/277912_det.jpg
1599,Steel Magnolias,1989,steel_magnolias,5.8,18,12,6,66,0,1,1,0,100,3.6,26167,88,http://content7.flixster.com/movie/10/93/46/10934665_det.jpg
1600,She's So Lovely,1997,shes_so_lovely,6,41,26,15,63,6.9,7,6,1,85,3.2,1353,56,http://content6.flixster.com/movie/10/88/14/10881400_det.jpg
1601,Hoodlum,1997,1078030-hoodlum,5.5,19,8,11,42,7.2,6,5,1,83,3.3,2875,63,http://content9.flixster.com/movie/27/53/275303_det.jpg
1602,Leave It to Beaver,1997,leave_it_to_beaver,4,27,5,22,18,4.4,10,2,8,20,2.6,1310,35,http://content8.flixster.com/movie/26/58/265814_det.jpg
1603,Mimic,1997,mimic,6.3,30,17,13,56,6.3,6,3,3,50,2.7,5478,37,http://content9.flixster.com/movie/55/37/43/5537439_det.jpg
1604,Money Talks,1997,,\N,\N,\N,\N,\N,\N,\N,\N,\N,\N,\N,\N,\N,\N
1605,Excess Baggage,1997,excess_baggage,4.5,30,10,20,33,4.7,5,1,4,20,2.5,3231,37,http://content9.flixster.com/movie/26/36/263699_det.jpg
1606,Kull the Conqueror,1997,kull_the_conqueror,3.6,19,5,14,26,0,4,0,4,0,2.6,1819,35,http://content6.flixster.com/movie/10/93/54/10935432_det.jpg
1608,Air Force One,1997,air_force_one,7,50,39,11,78,7.1,18,15,3,83,3.2,26434,62,http://content8.flixster.com/movie/11/14/67/11146758_det.jpg
1609,One Eight Seven,1997,187,5.2,27,8,19,29,5.4,5,1,4,20,3.3,3318,68,http://content6.flixster.com/movie/27/35/273524_det.jpg
1610,The Hunt for Red October,1990,hunt_for_red_october,7.8,42,40,2,95,0,4,3,1,75,3.6,18875,84,http://content9.flixster.com/movie/26/27/262727_det.jpg
1611,My Own Private Idaho,1991,my_own_private_idaho,7,32,27,5,84,8.7,6,6,0,100,3.6,8810,79,http://content9.flixster.com/movie/10/93/52/10935275_det.jpg
1612,"Kiss Me, Guido",1997,kiss_me_guido,5.4,15,6,9,40,5.8,5,1,4,20,3.1,439,53,http://content9.flixster.com/movie/28/21/282199_det.jpg
1613,Star Maps,1997,star_maps,5,15,5,10,33,0,4,0,4,0,3.1,60,44,http://content9.flixster.com/movie/10/85/19/10851963_det.jpg
1614,In & Out,1997,in_and_out,6.9,28,20,8,71,8,5,5,0,100,2.9,4273,47,http://content7.flixster.com/movie/25/58/255829_det.jpg
1615,The Edge,1997,edge,6.3,46,27,19,58,6.4,11,6,5,54,3.2,5719,67,http://content8.flixster.com/movie/26/94/269418_det.jpg
1616,The Peacemaker,1997,1079516-peacemaker,6,31,13,18,41,5.4,6,0,6,0,2.8,6439,41,http://content8.flixster.com/movie/10/88/49/10884906_det.jpg
1617,L.A. Confidential,1997,la_confidential,8.6,83,82,1,98,8.1,21,20,1,95,3.7,25453,90,http://content7.flixster.com/movie/10/89/54/10895493_det.jpg
1619,Seven Years in Tibet,1997,1079716-seven_years_in_tibet,6.3,32,19,13,59,6.2,5,2,3,40,3.4,13241,71,http://content7.flixster.com/movie/23/12/92/2312921_det.jpg
1620,Kiss the Girls,1997,kiss_the_girls,5.4,28,9,19,32,5.4,6,2,4,33,3.3,9940,68,http://content9.flixster.com/movie/26/95/269591_det.jpg
1621,Soul Food,1997,soul_food,6.3,41,33,8,80,6.4,13,10,3,76,3.6,3884,85,http://content9.flixster.com/movie/10/88/06/10880611_det.jpg
1622,Kicked in the Head,1997,kicked_in_the_head,4.1,9,1,8,11,0,4,0,4,0,3.1,226,45,http://content8.flixster.com/movie/10/88/44/10884494_det.jpg
1623,Wishmaster,1997,wishmaster,3.4,27,6,21,22,2.9,5,1,4,20,2.8,3480,48,http://content7.flixster.com/movie/28/32/283225_det.jpg
1624,A Thousand Acres,1997,thousand_acres,4.3,47,11,36,23,3.7,14,1,13,7,3,932,40,http://content9.flixster.com/movie/10/88/70/10887047_det.jpg
1625,The Game,1997,1078955-game,7.2,43,30,13,69,7.2,11,7,4,63,3.5,23139,82,http://content9.flixster.com/movie/28/04/280403_det.jpg
1626,Fire Down Below,1997,1078038-fire_down_below,3.3,26,3,23,11,3.3,7,1,6,14,2.6,3327,48,http://content9.flixster.com/movie/27/36/273603_det.jpg
1627,U Turn,1997,u-turn,6.1,48,28,20,58,5.2,13,6,7,46,3.1,5988,59,http://content7.flixster.com/movie/27/09/270905_det.jpg
1628,The Day of the Locust,1975,day_of_the_locust,6.8,8,5,3,62,0,1,1,0,100,3.6,582,75,http://content9.flixster.com/movie/27/77/277703_det.jpg
1629,The MatchMaker,1997,1079208-matchmaker,5.6,26,14,12,53,0,4,2,2,50,3.3,1220,66,http://content9.flixster.com/movie/28/03/280315_det.jpg
1631,The Assignment,1997,1079452-assignment,5.8,19,11,8,57,6.2,5,3,2,60,3.3,825,60,http://content8.flixster.com/movie/27/70/277094_det.jpg
1632,A Smile Like Yours,1997,the-risk-is-yours,0,0,0,0,0,0,0,0,0,0,0,0,0,http://content9.flixster.com/movie/10/84/78/10847859_det.jpg
1633,Ulee's Gold,1997,ulees_gold,8,48,45,3,93,7.9,13,12,1,92,3.4,607,67,http://content6.flixster.com/movie/27/81/278192_det.jpg
1635,The Ice Storm,1997,ice_storm,7.6,56,46,10,82,7.3,13,10,3,76,3.6,7329,80,http://content7.flixster.com/movie/27/07/270713_det.jpg
1636,Stag,1997,stag,4.4,5,2,3,40,0,0,0,0,0,0,0,0,http://content7.flixster.com/movie/19/57/46/1957461_det.jpg
1639,Chasing Amy,1997,chasing_amy,7.5,66,60,6,90,7.4,22,20,2,90,3.5,27129,81,http://content7.flixster.com/movie/26/82/268201_det.jpg
1640,How to Be a Player,1997,how_to_be_a_player,3,7,1,6,14,0,1,0,1,0,3.4,1335,74,http://content8.flixster.com/movie/31/09/310922_det.jpg
1641,The Full Monty,1997,full_monty,7.6,41,39,2,95,7.6,7,7,0,100,3.3,12102,73,http://content7.flixster.com/movie/26/91/269101_det.jpg
1642,Indian Summer,1996,alive_and_kicking,6.7,6,5,1,83,0,2,2,0,100,3.2,492,45,http://content7.flixster.com/movie/10/70/10/10701045_det.jpg
1643,Mrs Brown,1997,mrs_brown,7.3,39,36,3,92,7.6,8,7,1,87,3.7,2021,76,http://content6.flixster.com/movie/25/66/256624_det.jpg
1644,I Know What You Did Last Summer,1997,i_know_what_you_did_last_summer,5.3,39,14,25,35,5.7,11,5,6,45,2.8,30659,49,http://content8.flixster.com/movie/10/86/89/10868922_det.jpg
1645,The Devil's Advocate,1997,devils_advocate,6.2,43,28,15,65,5.8,10,4,6,40,3.4,30966,78,http://content6.flixster.com/movie/83/07/830796_det.jpg
1646,RocketMan,1997,1079403-rocketman,3.9,15,4,11,26,5.7,5,2,3,40,3,3486,69,http://content7.flixster.com/movie/28/06/10/2806109_det.jpg
1647,Playing God,1997,playing_god,4.1,28,4,24,14,4.7,7,2,5,28,2.9,2458,39,http://content9.flixster.com/movie/10/46/52/10465263_det.jpg
1648,The House of Yes,1997,house_of_yes,5.9,35,22,13,62,6.3,8,5,3,62,3.7,1730,78,http://content9.flixster.com/movie/27/35/273507_det.jpg
1649,"Fast, Cheap & Out of Control",1997,fast_cheap_and_out_of_control,8.1,29,27,2,93,0,3,3,0,100,3.9,980,82,http://content7.flixster.com/movie/10/91/62/10916277_det.jpg
1650,Washington Square,1997,washington_square,7.2,27,22,5,81,7.6,6,4,2,66,3.4,579,58,http://content7.flixster.com/movie/10/93/23/10932321_det.jpg
1651,Telling Lies in America,1997,telling_lies_in_america,6.1,14,9,5,64,5.8,6,2,4,33,3,603,40,http://content9.flixster.com/movie/26/46/264615_det.jpg
1652,Year of the Horse,1997,year_of_the_horse_neil_young_and_crazy_horse_live,5.7,23,12,11,52,5.4,8,5,3,62,3.7,36,82,http://content9.flixster.com/movie/10/97/92/10979203_det.jpg
1653,Gattaca,1997,gattaca,7.1,55,45,10,81,6.1,11,6,5,54,3.5,36666,82,http://content9.flixster.com/movie/25/53/255319_det.jpg
1654,FairyTale: A True Story,1997,fairy-tale-a-true-story,6.2,21,11,10,52,6.7,6,3,3,50,3.3,1880,63,http://content9.flixster.com/movie/10/90/50/10905063_det.jpg
1655,The Phantom of the Opera,2004,phantom_of_the_opera,5,165,54,111,32,4.6,37,10,27,27,3.7,70849,86,http://content9.flixster.com/movie/35/84/18/3584187_det.jpg
1656,Swept from the Sea,1997,swept_from_the_sea,5.6,16,5,11,31,5,5,0,5,0,3.7,742,73,http://content8.flixster.com/movie/26/03/260322_det.jpg
1657,Wonderland,2003,wonderland,5,98,34,64,34,4.5,32,7,25,21,3.3,3666,67,http://content7.flixster.com/movie/26/94/269429_det.jpg
1658,A Life Less Ordinary,1997,life_less_ordinary,5.5,35,14,21,40,4.3,7,1,6,14,3.1,9301,57,http://content8.flixster.com/movie/38/48/02/3848022_det.jpg
1659,The Hurricane,1999,1093641-hurricane,7,112,93,19,83,7.3,31,29,2,93,3.7,10473,84,http://content8.flixster.com/movie/10/93/94/10939402_det.jpg
1660,Eve's Bayou,1997,eves_bayou,7.5,50,40,10,80,7.9,14,12,2,85,3.9,1799,87,http://content6.flixster.com/movie/10/88/76/10887660_det.jpg
1661,Switchback,1997,switchback,4.8,25,8,17,32,4.2,6,1,5,16,3,1273,45,http://content6.flixster.com/movie/27/62/276212_det.jpg
1662,Gang Related,1997,gang_related,5.6,15,9,6,60,0,3,1,2,33,3.6,1924,73,http://content9.flixster.com/movie/27/56/275627_det.jpg
1663,Stripes,1981,stripes,6.6,33,29,4,87,0,4,3,1,75,0,0,0,http://content9.flixster.com/movie/27/68/276891_det.jpg
1665,Bean,1997,bean,5.3,30,12,18,40,5.9,8,3,5,37,2.9,16961,56,http://content6.flixster.com/movie/26/58/265816_det.jpg
1666,Hugo Pool,1997,hugo_pool,3.4,8,1,7,12,0,3,1,2,33,3,956,43,http://content8.flixster.com/movie/11/13/80/11138030_det.jpg
1667,Mad City,1997,mad_city,5.3,27,10,17,37,4.9,6,1,5,16,2.9,2188,42,http://content6.flixster.com/movie/10/84/05/10840580_det.jpg
1668,One Night Stand,1997,1079718-one_night_stand,5,28,8,20,28,6.1,7,3,4,42,2.9,964,43,http://content8.flixster.com/movie/11/13/59/11135922_det.jpg
1669,The Tango Lesson,1997,tango_lesson,6,18,10,8,55,0,4,2,2,50,3.7,1178,73,http://content9.flixster.com/movie/10/92/62/10926247_det.jpg
1670,Welcome to Sarajevo,1997,welcome_to_sarajevo,6.9,25,19,6,76,7.6,5,4,1,80,3.5,985,75,http://content7.flixster.com/movie/10/90/11/10901161_det.jpg
1671,Deceiver,1997,deceiver,5.4,26,12,14,46,6,7,4,3,57,3.2,586,53,http://content7.flixster.com/movie/28/12/281297_det.jpg
1672,The Rainmaker,1997,1080867-rainmaker,6.9,44,37,7,84,7,11,9,2,81,3.3,5792,70,http://content8.flixster.com/movie/10/83/79/10837982_det.jpg
1673,Boogie Nights,1997,boogie_nights,8.1,64,59,5,92,8.8,11,11,0,100,3.5,22528,84,http://content9.flixster.com/movie/10/93/70/10937063_det.jpg
1674,Witness,1985,1023854-witness,8.1,31,29,2,93,0,3,2,1,66,3.5,7634,76,http://content9.flixster.com/movie/27/34/273491_det.jpg
1675,Incognito,1997,1082887-incognito,5.1,9,3,6,33,0,0,0,0,0,0,0,0,http://content7.flixster.com/movie/10/88/05/10880553_det.jpg
1676,Starship Troopers,1997,starship_troopers,6,55,33,22,60,6.3,14,8,6,57,3,24350,67,http://content9.flixster.com/movie/27/11/271119_det.jpg
1677,Critical Care,1997,critical_care,6.3,15,8,7,53,7.2,9,7,2,77,2.8,392,28,http://content6.flixster.com/movie/28/05/280504_det.jpg
1678,The Joy Luck Club,1993,joy_luck_club,6.9,31,26,5,83,6.9,7,5,2,71,3.7,4795,87,http://content9.flixster.com/movie/10/90/37/10903727_det.jpg
1679,Chairman of the Board,1998,chairman_of_the_board,2.4,7,1,6,14,0,0,0,0,0,0,0,0,http://content8.flixster.com/movie/10/88/59/10885922_det.jpg
1680,Sliding Doors,1998,sliding_doors,6.3,49,31,18,63,5.9,12,4,8,33,3.4,13328,74,http://content7.flixster.com/movie/10/87/38/10873849_det.jpg
1681,Mortal Kombat: Annihilation,1997,mortal_kombat_annihilation,2.5,29,2,27,6,2.5,9,0,9,0,2.5,12426,36,http://content7.flixster.com/movie/52/53/89/5253893_det.png
1682,The Truman Show,1998,truman_show,8.2,96,91,5,94,7.9,20,18,2,90,3.4,62890,82,http://content8.flixster.com/movie/11/12/69/11126926_det.jpg
1683,The Wings of the Dove,1997,wings_of_the_dove,7.8,28,24,4,85,9.1,7,7,0,100,3.7,1279,77,http://content9.flixster.com/movie/26/79/267919_det.jpg
1684,Mrs Dalloway,1997,mrs_dalloway,6.4,26,16,10,61,7.3,6,5,1,83,3.3,497,59,http://content6.flixster.com/movie/26/63/266312_det.jpg
1685,"I Love You, I Love You Not",1996,i_love_you_i_love_you_not,5.4,5,2,3,40,0,0,0,0,0,0,0,0,http://content6.flixster.com/movie/10/89/38/10893844_det.jpg
1686,Red Corner,1997,red_corner,5.1,22,7,15,31,5,6,1,5,16,3,1935,49,http://content6.flixster.com/movie/27/70/277016_det.jpg
1687,The Jackal,1997,jackal,4.2,25,3,22,12,0,4,0,4,0,3.1,12495,57,http://content9.flixster.com/movie/27/00/270015_det.jpg
1688,Anastasia,1997,1079818-anastasia,7.1,48,41,7,85,7.1,9,7,2,77,3.2,33076,70,http://content8.flixster.com/movie/10/93/87/10938762_det.jpg
1689,The Man Who Knew Too Little,1997,man_who_knew_too_little,5.4,30,12,18,40,4.9,6,2,4,33,3,4269,64,http://content9.flixster.com/movie/10/91/68/10916847_det.jpg
1690,Alien¬≥,1992,alien_3,5,39,15,24,38,5.8,7,4,3,57,3.1,30526,55,http://content9.flixster.com/movie/27/38/273891_det.jpg
1692,Alien Escape,1997,,\N,\N,\N,\N,\N,\N,\N,\N,\N,\N,\N,\N,\N,\N
1693,Amistad,1997,amistad,6.9,57,44,13,77,6.6,10,6,4,60,3.5,9716,75,http://content6.flixster.com/movie/26/82/268208_det.jpg
1694,The Apostle,1997,apostle,8,44,40,4,90,8,10,9,1,90,3.6,2049,75,http://content8.flixster.com/movie/26/41/264198_det.jpg
1695,Artemisia,1997,artemisia,6.3,22,14,8,63,6.4,6,4,2,66,3.4,390,67,http://content9.flixster.com/movie/27/47/274715_det.jpg
1696,Bent,1997,1087747-bent,6.3,20,13,7,65,4.8,5,0,5,0,3.8,3465,79,http://content7.flixster.com/movie/27/12/271209_det.jpg
1698,Les Boys,1997,les-boys,0,0,0,0,0,0,0,0,0,0,0,0,0,http://content9.flixster.com/movie/29/00/290011_det.jpg
1699,The Butcher Boy,1997,butcher_boy,7.5,58,46,12,79,7.8,13,11,2,84,3.7,1377,81,http://content9.flixster.com/movie/27/01/81/2701819_det.jpg
1701,Deconstructing Harry,1997,deconstructing_harry,7.2,33,23,10,69,7.5,6,4,2,66,3.6,5564,79,http://content8.flixster.com/movie/27/09/270998_det.jpg
1702,Flubber,1997,flubber,3.7,29,5,24,17,4.3,6,1,5,16,2.8,23244,43,http://content7.flixster.com/movie/10/90/92/10909265_det.jpg
1703,For Richer or Poorer,1997,for_richer_or_poorer,3.7,19,3,16,15,4.4,5,0,5,0,2.7,3367,47,http://content6.flixster.com/movie/25/83/258308_det.jpg
1704,Good Will Hunting,1997,good_will_hunting,8,69,67,2,97,7.9,16,16,0,100,3.9,63868,92,http://content6.flixster.com/movie/10/84/63/10846372_det.jpg
1707,Home Alone 3,1997,home_alone_3,4.3,21,5,16,23,5,6,2,4,33,2.6,22853,42,http://content7.flixster.com/movie/25/99/259909_det.jpg
1708,Ill Gotten Gains,1997,illgotten_gains,0,0,0,0,0,0,0,0,0,0,0,0,0,http://content6.flixster.com/movie/10/84/69/10846920_det.jpg
1709,Legal Deceit,1997,,\N,\N,\N,\N,\N,\N,\N,\N,\N,\N,\N,\N,\N,\N
1710,Man of Her Dreams,1997,fiance,0,0,0,0,0,0,0,0,0,0,0,0,0,http://content6.flixster.com/movie/10/88/32/10883228_det.jpg
1711,Midnight in the Garden of Good and Evil,1997,midnight_in_the_garden_of_good_and_evil,6.2,30,15,15,50,6.4,6,2,4,33,3.3,7144,65,http://content8.flixster.com/movie/26/74/267414_det.jpg
1713,Mousehunt,1997,mouse_hunt,5.3,28,12,16,42,4.8,7,1,6,14,2.8,9269,50,http://content9.flixster.com/movie/10/88/57/10885755_det.jpg
1714,Never Met Picasso,1996,never-met-picasso,0,0,0,0,0,0,0,0,0,0,0,0,0,http://content9.flixster.com/movie/10/84/99/10849911_det.jpg
1715,Office Killer,1997,office_killer,3.2,16,2,14,12,0,3,0,3,0,3,371,44,http://content6.flixster.com/movie/27/94/279416_det.jpg
1716,"Other Voices, Other Rooms",1995,other_voices_other_rooms,0,1,0,1,0,0,0,0,0,0,0,0,0,http://content9.flixster.com/movie/11/00/80/11008071_det.jpg
1717,Scream 2,1997,scream_2,6.8,66,53,13,80,7.4,17,16,1,94,2.9,29170,54,http://content8.flixster.com/movie/46/00/460098_det.jpg
1719,The Sweet Hereafter,1997,sweet_hereafter,8.8,52,52,0,100,8.6,16,16,0,100,4,3068,86,http://content7.flixster.com/movie/10/88/64/10886473_det.jpg
1720,Time Tracers,1997,,\N,\N,\N,\N,\N,\N,\N,\N,\N,\N,\N,\N,\N,\N
1721,Titanic,1997,titanic,7.4,97,80,17,82,6.6,29,21,8,72,3.3,464576,68,http://content8.flixster.com/movie/16/90/53/1690530_det.jpg
1722,Tomorrow Never Dies,1997,tomorrow_never_dies,5.9,55,30,25,54,4.8,12,4,8,33,3.1,19587,60,http://content6.flixster.com/movie/10/91/35/10913520_det.jpg
1723,Twisted,2004,twisted,2.9,132,2,130,1,3.2,36,0,36,0,2.8,2961,40,http://content6.flixster.com/movie/27/63/276304_det.jpg
1725,The Education of Little Tree,1997,education_of_little_tree,6.3,16,10,6,62,6.5,5,2,3,40,3.6,544,70,http://content9.flixster.com/movie/10/89/69/10896995_det.jpg
1726,The Postman,1997,postman,3.8,31,3,28,9,3,6,0,6,0,2.8,8147,51,http://content7.flixster.com/movie/26/92/269217_det.jpg
1727,The Horse Whisperer,1998,horse_whisperer,6.9,52,37,15,71,6.8,13,9,4,69,3.2,7903,71,http://content8.flixster.com/movie/10/87/81/10878142_det.jpg
1728,The Winter Guest,1997,winter_guest,6.5,24,15,9,62,7.2,5,3,2,60,3.6,994,69,http://content8.flixster.com/movie/27/10/271094_det.jpg
1729,Jackie Brown,1997,jackie_brown,7.3,68,58,10,85,6.3,18,11,7,61,3.5,36248,78,http://content9.flixster.com/movie/10/93/45/10934571_det.jpg
1730,Kundun,1997,kundun,7.3,58,44,14,75,6.7,15,10,5,66,3.7,3355,77,http://content9.flixster.com/movie/25/61/256127_det.jpg
1731,Mr. Magoo,1997,mr_magoo,2.3,26,1,25,3,2.3,8,0,8,0,2.3,2618,30,http://content8.flixster.com/movie/10/60/67/10606782_det.jpg
1732,The Big Lebowski,1998,big_lebowski,7.1,74,58,16,78,6.1,13,8,5,61,4,82903,93,http://content6.flixster.com/movie/10/95/21/10952108_det.jpg
1733,Afterglow,1997,afterglow,6.8,30,21,9,70,7.4,7,5,2,71,3,386,38,http://content7.flixster.com/movie/28/15/281593_det.jpg
1734,Ma vie en rose,1997,ma_vie_en_rose,7.4,20,18,2,90,7.6,5,5,0,100,4.1,3051,88,http://content8.flixster.com/movie/10/12/04/10120494_det.jpg
1735,Great Expectations,1998,1081200-great_expectations,5.4,32,12,20,37,5.4,7,3,4,42,3.4,10607,76,http://content6.flixster.com/movie/26/88/268896_det.jpg
1739,3 Ninjas: High Noon at Mega Mountain,1998,3_ninjas_high_noon_at_mega_mountain,0,4,0,4,0,0,1,0,1,0,2.5,7721,32,http://content8.flixster.com/movie/10/88/99/10889978_det.jpg
1740,Men of Means,1999,,\N,\N,\N,\N,\N,\N,\N,\N,\N,\N,\N,\N,\N,\N
1742,Caught Up,1998,caught_up,4.1,7,0,7,0,0,3,0,3,0,3.1,627,45,http://content6.flixster.com/movie/27/96/279600_det.jpg
1743,Arguing the World,1998,arguing_the_world,6.8,5,4,1,80,0,1,1,0,100,3.1,150,47,http://content9.flixster.com/movie/10/92/43/10924327_det.jpg
1744,Firestorm,1998,firestorm-1998,0,0,0,0,0,0,0,0,0,0,0,0,0,http://content8.flixster.com/movie/10/86/63/10866338_det.jpg
1746,Senseless,1998,1081501-senseless,3.4,14,1,13,7,0,3,0,3,0,2.8,1704,50,http://content8.flixster.com/movie/10/95/43/10954306_det.jpg
1747,Wag the Dog,1997,wag_the_dog,7.4,70,59,11,84,7.5,19,17,2,89,3.4,8216,72,http://content7.flixster.com/movie/26/87/268793_det.jpg
1748,Dark City,1998,forgotten_city,0,2,0,2,0,0,0,0,0,0,0,0,0,http://content6.flixster.com/movie/10/90/16/10901660_det.jpg
1749,The Leading Man,1996,the-leading-man,6.4,8,5,3,62,0,2,2,0,100,3.6,534,71,http://content7.flixster.com/movie/27/35/273509_det.jpg
1750,Star Kid,1997,star_kid,5.3,12,4,8,33,0,3,1,2,33,2.5,863,32,http://content8.flixster.com/movie/26/54/265402_det.jpg
1752,A Hard Rain's Gonna Fall,2008,,\N,\N,\N,\N,\N,\N,\N,\N,\N,\N,\N,\N,\N,\N
1753,Half Baked,1998,half_baked,4.2,24,7,17,29,0,2,0,2,0,3.4,26499,82,http://content8.flixster.com/movie/27/77/277702_det.jpg
1754,Fallen,1998,1080990-fallen,5.3,54,22,32,40,5.1,13,5,8,38,3.4,9162,75,http://content7.flixster.com/movie/26/99/269917_det.jpg
1755,Shooting Fish,1997,shooting_fish,5.8,28,16,12,57,5.2,5,1,4,20,3.5,1362,72,http://content8.flixster.com/movie/31/37/313798_det.jpg
1756,The Prophecy II,1998,prophecy_ii,4.7,6,2,4,33,0,0,0,0,0,0,0,0,http://content7.flixster.com/movie/12/28/76/1228765_det.jpg
1757,Duo luo tian shi,1995,fallen_angels_hong_kong,7.9,19,18,1,94,0,4,4,0,100,4,4014,86,http://content8.flixster.com/movie/30/83/308306_det.jpg
1759,"O Que √â Isso, Companheiro?",1997,four_days_in_september,6.2,15,8,7,53,6.2,5,2,3,40,3.5,524,70,http://content6.flixster.com/movie/10/92/03/10920376_det.jpg
1760,Spice World,1997,spice_world,4.5,33,9,24,27,5.1,7,1,6,14,2.1,9540,39,http://content6.flixster.com/movie/10/86/70/10867012_det.jpg
1762,Deep Rising,1998,deep_rising,4.2,27,8,19,29,3.9,6,1,5,16,2.8,3617,42,http://content6.flixster.com/movie/63/25/98/6325980_det.jpg
1765,A Letter from Death Row,1998,letter_from_death_row,0,0,0,0,0,0,0,0,0,0,0,0,0,http://content7.flixster.com/movie/10/88/60/10886093_det.jpg
1767,Music from Another Room,1998,music_from_another_room,5,6,2,4,33,0,0,0,0,0,0,0,0,http://content8.flixster.com/movie/25/98/259826_det.jpg
1769,The Replacement Killers,1998,replacement_killers,5.4,31,12,19,38,6,6,3,3,50,3,4222,51,http://content9.flixster.com/movie/11/12/30/11123091_det.jpg
1770,B. Monkey,1998,b_monkey,5.6,16,10,6,62,0,3,1,2,33,3.1,1126,49,http://content6.flixster.com/movie/27/29/272908_det.jpg
1771,The Night Flier,1997,the-night-flier,0,4,1,3,25,0,1,0,1,0,2.8,1507,37,http://content8.flixster.com/movie/11/12/39/11123974_det.jpg
1772,Blues Brothers 2000,1998,blues_brothers_2000,5.1,42,19,23,45,5.5,10,4,6,40,2.7,8002,42,http://content6.flixster.com/movie/10/87/73/10877388_det.jpg
1773,Tokyo Fist,1995,tokyo-fist,0,2,2,0,100,0,0,0,0,0,0,0,0,http://content8.flixster.com/movie/10/33/59/10335954_det.jpg
1774,Zardoz,1974,zardoz,5.2,18,8,10,44,0,1,0,1,0,3.1,2696,51,http://content6.flixster.com/movie/26/95/269596_det.jpg
1776,Joy Ride,2001,joy_ride,6.6,111,82,29,73,6.7,29,23,6,79,3.1,9370,63,http://content7.flixster.com/movie/27/21/272109_det.jpg
1777,The Wedding Singer,1998,wedding_singer,6.1,59,39,20,66,5.8,12,8,4,66,3.5,86088,76,http://content6.flixster.com/movie/10/87/41/10874148_det.jpg
1779,Sphere,1998,sphere,4,49,6,43,12,3.8,12,1,11,8,2.7,9112,38,http://content8.flixster.com/movie/25/90/259018_det.jpg
1780,Ayn Rand: A Sense of Life,1997,,5.8,11,6,5,54,0,3,1,2,33,3.4,268,58,http://content8.flixster.com/movie/29/91/299198_det.jpg
1781,A Further Gesture,1997,break-1996,0,4,3,1,75,0,0,0,0,0,0,0,0,http://images.rottentomatoescdn.com/images/defaults/poster_default.gif
1782,Little City,1997,little_city,0,3,1,2,33,0,0,0,0,0,0,0,0,http://content6.flixster.com/movie/27/51/275120_det.jpg
1783,Palmetto,1998,palmetto,5.1,31,11,20,35,5.2,6,1,5,16,2.7,679,28,http://content6.flixster.com/movie/27/64/276420_det.jpg
1784,As Good as It Gets,1997,as_good_as_it_gets,7.2,75,64,11,85,7.3,21,19,2,90,3.5,30872,81,http://content6.flixster.com/movie/55/35/60/5535608_det.jpg
1785,King of New York,1990,king_of_new_york,6,23,16,7,69,6.2,5,3,2,60,3.7,5329,77,http://content9.flixster.com/movie/10/92/96/10929695_det.jpg
1788,Men with Guns,1997,1082798-men_with_guns,7.6,26,23,3,88,0,4,4,0,100,3.9,476,84,http://content8.flixster.com/movie/10/92/05/10920542_det.jpg
1789,The Sadness of Sex,1995,sadness_of_sex,0,0,0,0,0,0,0,0,0,0,0,0,0,http://images.rottentomatoescdn.com/images/defaults/poster_default.gif
1791,Twilight,2008,twilight,5.5,196,98,98,50,5.9,36,20,16,55,4.1,256646,82,http://content9.flixster.com/movie/10/88/60/10886003_det.jpg
1792,U.S. Marshals,1998,us_marshals,4.9,30,8,22,26,5,7,1,6,14,3.2,12491,59,http://content7.flixster.com/movie/11/14/00/11140001_det.jpg
1793,Welcome to Woop Woop,1997,welcome_to_woop_woop,3.8,17,5,12,29,0,2,0,2,0,3.4,280,65,http://content7.flixster.com/movie/35/59/57/3559577_det.jpg
1794,Love and Death on Long Island,1997,love_and_death_on_long_island,8,35,31,4,88,8.3,6,6,0,100,3.2,643,54,http://content9.flixster.com/movie/10/87/51/10875171_det.jpg
1795,El callej√≥n de los milagros,1995,midaq-alley,0,0,0,0,0,0,0,0,0,0,0,0,0,http://content8.flixster.com/movie/30/95/309506_det.jpg
1796,In God's Hands,1998,in_gods_hands,2.9,6,0,6,0,0,0,0,0,0,0,0,0,http://content9.flixster.com/movie/26/01/260191_det.jpg
1797,Everest,1998,everest_1998,7.7,13,12,1,92,0,1,1,0,100,3.5,699,71,http://content6.flixster.com/movie/28/60/286012_det.jpg
1798,Hush,1998,1082899-hush,3.4,37,4,33,10,3.2,8,0,8,0,2.9,1448,43,http://content9.flixster.com/movie/10/87/07/10870779_det.jpg
1799,Suicide Kings,1997,suicide_kings,5.4,29,10,19,34,5.4,6,2,4,33,3.4,10831,72,http://content6.flixster.com/movie/28/08/280824_det.jpg
1801,The Man in the Iron Mask,1998,1082400-man_in_the_iron_mask,5.4,35,11,24,31,6.2,7,2,5,28,3.1,24313,60,http://content6.flixster.com/movie/10/89/35/10893580_det.jpg
1804,The Newton Boys,1998,newton_boys,6.3,36,22,14,61,5.7,8,3,5,37,2.9,1826,43,http://content7.flixster.com/movie/26/03/260393_det.jpg
1805,Where the Wild Things Are,2009,where_the_wild_things_are,6.9,241,176,65,73,6.4,40,26,14,65,3.4,236581,59,http://content9.flixster.com/movie/11/15/18/11151851_det.jpg
1806,Paulie,1998,paulie,6.1,36,22,14,61,5.9,12,4,8,33,2.8,3810,51,http://content9.flixster.com/movie/10/87/27/10872727_det.jpg
1807,"A Cool, Dry Place",1998,cool_dry_place,5.5,13,7,6,53,0,1,0,1,0,3.2,848,54,http://content8.flixster.com/movie/25/89/258906_det.jpg
1809,Hana-bi,1997,1091981-fireworks,8.2,18,17,1,94,0,2,2,0,100,4.3,3702,91,http://content8.flixster.com/movie/29/83/298330_det.jpg
1810,Primary Colors,1998,primary_colors,7.2,74,59,15,79,6.7,21,14,7,66,3,3209,55,http://content6.flixster.com/movie/10/87/54/10875476_det.jpg
1811,Niagara,1953,niagara,6.2,10,8,2,80,0,0,0,0,0,0,0,0,http://content6.flixster.com/movie/10/85/38/10853848_det.jpg
1812,Wide Awake,1998,1082432-wide_awake,4.9,29,12,17,41,4.6,7,2,5,28,3.3,1235,65,http://content6.flixster.com/movie/10/85/35/10853592_det.jpg
1814,A Price Above Rubies,1998,price_above_rubies,5.9,27,15,12,55,5.7,5,2,3,40,3.1,429,51,http://content6.flixster.com/movie/10/87/85/10878584_det.jpg
1815,East of Eden,1955,1006416-east_of_eden,8.2,30,26,4,86,0,3,2,1,66,4,5957,90,http://content7.flixster.com/movie/10/93/17/10931781_det.jpg
1816,Two Girls and a Guy,1997,two_girls_and_a_guy,5.6,57,30,27,52,6.4,18,10,8,55,2.8,1292,42,http://content7.flixster.com/movie/27/64/276425_det.jpg
1817,No Looking Back,1998,no_looking_back,5.3,21,8,13,38,5.4,5,1,4,20,3.5,561,66,http://content6.flixster.com/movie/28/15/281596_det.jpg
1819,Storefront Hitchcock,1998,storefront_hitchcock,7.5,8,7,1,87,0,0,0,0,0,0,0,0,http://content8.flixster.com/movie/10/89/08/10890838_det.jpg
1820,The Proposition,2005,proposition,7.3,123,107,16,86,7.4,31,27,4,87,3.6,20228,77,http://content6.flixster.com/movie/31/42/314204_det.jpg
1821,The Object of My Affection,1998,object_of_my_affection,5.8,48,24,24,50,5.6,11,5,6,45,3,6363,54,http://content7.flixster.com/movie/27/37/273725_det.jpg
1822,Meet the Deedles,1998,meet_the_deedles,2.4,26,1,25,3,3,5,0,5,0,2.6,1774,39,http://content9.flixster.com/movie/10/88/97/10889707_det.jpg
1824,Homegrown,1998,homegrown,5.9,15,7,8,46,0,3,2,1,66,3,1031,47,http://content7.flixster.com/movie/27/28/272817_det.jpg
1825,The Players Club,1998,players_club,5,15,4,11,26,6.3,5,3,2,60,3.6,5665,82,http://content6.flixster.com/movie/10/88/93/10889372_det.jpg
1826,Barney's Great Adventure,1998,barneys-adventure-bus,0,0,0,0,0,0,0,0,0,0,0,0,0,http://content9.flixster.com/movie/10/86/99/10869943_det.jpg
1827,Big,1988,big,7.9,52,50,2,96,6.8,5,4,1,80,3.4,33658,73,http://content9.flixster.com/movie/10/83/88/10838839_det.jpg
1829,Chinese Box,1997,chinese_box,6.4,21,13,8,61,6.6,5,3,2,60,3.3,700,57,http://content7.flixster.com/movie/28/39/283997_det.jpg
1831,Lost in Space,1998,lost_in_space,4.6,46,12,34,26,5.3,8,2,6,25,2.5,8293,30,http://content8.flixster.com/movie/10/89/34/10893434_det.jpg
1832,Heaven's Burning,1997,heavens_burning,0,3,1,2,33,0,1,0,1,0,2.9,633,30,http://content7.flixster.com/movie/27/91/279197_det.jpg
1833,Mercury Rising,1998,mercury_rising,4.2,35,6,29,17,4.6,8,1,7,12,3,7388,49,http://content6.flixster.com/movie/10/89/22/10892240_det.jpg
1834,The Spanish Prisoner,1997,spanish_prisoner,7.4,59,52,7,88,7.2,13,12,1,92,3.7,1863,80,http://content8.flixster.com/movie/10/91/35/10913514_det.jpg
1835,City of Angels,1998,starved,0,0,0,0,0,0,0,0,0,0,0,0,0,http://content6.flixster.com/movie/10/85/10/10851036_det.jpg
1836,The Last Days of Disco,1998,last_days_of_disco,6.3,51,34,17,66,7.4,11,9,2,81,3.2,1361,58,http://content6.flixster.com/movie/10/91/40/10914076_det.jpg
1837,The Odd Couple II,1998,odd_couple_ii,4.4,27,6,21,22,4.1,7,0,7,0,3.1,1418,57,http://content9.flixster.com/movie/11/14/28/11142855_det.jpg
1839,My Giant,1998,my_giant,4.8,26,5,21,19,4.5,6,0,6,0,2.6,1175,30,http://content8.flixster.com/movie/26/44/264422_det.jpg
1840,He Got Game,1998,he_got_game,6.9,60,48,12,80,6.8,18,14,4,77,3.6,8293,81,http://content8.flixster.com/movie/60/49/75/6049754_det.jpg
1841,The Gingerbread Man,1998,gingerbread_man,6.2,40,24,16,60,6.9,11,8,3,72,2.8,1101,27,http://content6.flixster.com/movie/11/14/76/11147696_det.jpg
1842,Illtown,1996,illtown,5.3,11,6,5,54,0,1,0,1,0,3.2,34,75,http://content9.flixster.com/movie/10/97/83/10978347_det.jpg
1843,Slappy and the Stinkers,1998,slappy_and_the_stinkers,0,4,0,4,0,0,0,0,0,0,0,0,0,http://content7.flixster.com/movie/26/58/265805_det.jpg
1844,Carne tr√©mula,1997,live_flesh,7.1,37,29,8,78,7.2,10,7,3,70,3.9,4009,86,http://content9.flixster.com/movie/27/12/271215_det.jpg
1845,Zero Effect,1998,zero_effect,6.7,38,25,13,65,6.2,5,2,3,40,3.5,1908,74,http://content7.flixster.com/movie/27/55/275597_det.jpg
1846,Nil by Mouth,1997,nil_by_mouth,6.2,19,12,7,63,7.6,5,4,1,80,4,1783,88,http://content6.flixster.com/movie/27/84/278420_det.jpg
1848,The Borrowers,1997,1081203-borrowers,6.6,24,17,7,70,7.5,7,6,1,85,2.8,4043,48,http://content7.flixster.com/movie/11/14/95/11149597_det.jpg
1849,Prince Valiant,1954,1033462-prince_valiant,0,0,0,0,0,0,0,0,0,0,0,0,0,http://content9.flixster.com/movie/25/83/258391_det.jpg
1850,"I Love You, Don't Touch Me!",1997,i_love_you_dont_touch_me,5.4,10,4,6,40,0,1,1,0,100,3.1,352,44,http://content6.flixster.com/movie/10/85/09/10850912_det.jpg
1851,Leather Jacket Love Story,1997,leather_jacket_love_story,0,3,1,2,33,0,0,0,0,0,0,0,0,http://content9.flixster.com/movie/28/90/289011_det.jpg
1853,An Alan Smithee Film: Burn Hollywood Burn,1997,burn_hollywood_burn,2.8,36,3,33,8,2.7,6,1,5,16,2.2,601,21,http://content6.flixster.com/movie/10/91/09/10910948_det.jpg
1854,Kissing a Fool,1998,kissing_a_fool,4.7,28,8,20,28,5.6,6,3,3,50,2.7,899,43,http://content7.flixster.com/movie/27/40/274009_det.jpg
1855,Krippendorf's Tribe,1998,krippendorfs_tribe,3.5,36,5,31,13,3.8,7,1,6,14,2.4,910,21,http://content9.flixster.com/movie/26/40/264003_det.jpg
1856,Kurt & Courtney,1998,kurt_and_courtney,5.3,21,12,9,57,0,3,2,1,66,3.1,1391,48,http://content8.flixster.com/movie/27/15/271522_det.jpg
1857,The Real Blonde,1997,real_blonde,5.4,26,9,17,34,6.2,6,3,3,50,2.9,430,39,http://content8.flixster.com/movie/27/91/279102_det.jpg
1858,Yat goh hiu yan,1997,1082420-mr_nice_guy,5.6,27,12,15,44,6,6,3,3,50,2.9,4726,52,http://content9.flixster.com/movie/11/14/69/11146999_det.jpg
1859,Ta'm e guilass,1997,taste_of_cherry,7.3,30,25,5,83,7.6,10,9,1,90,4,1878,84,http://content9.flixster.com/movie/10/87/21/10872163_det.jpg
1860,Karakter,1997,character,7.3,25,23,2,92,7.9,6,6,0,100,4.1,754,89,http://content8.flixster.com/movie/27/98/279814_det.jpg
1861,Budbringeren,1997,budbringeren-junk-mail,7.4,15,14,1,93,0,4,4,0,100,0,0,0,http://content7.flixster.com/movie/10/48/44/10484425_det.jpg
1862,Species II,1998,species_2,3.2,31,3,28,9,0,2,0,2,0,2.3,3562,26,http://content7.flixster.com/movie/11/15/11/11151153_det.jpg
1863,Major League: Back to the Minors,1998,major_league_back_to_the_minors,3,19,4,15,21,0,4,1,3,25,2.6,1952,31,http://content6.flixster.com/movie/25/94/259400_det.jpg
1864,Sour Grapes,1998,sour_grapes,3.5,13,3,10,23,0,3,0,3,0,2.8,451,38,http://content9.flixster.com/movie/27/66/276627_det.jpg
1865,Wild Man Blues,1997,wild_man_blues,7.2,37,32,5,86,7.4,9,8,1,88,3.4,581,61,http://content9.flixster.com/movie/10/97/90/10979007_det.jpg
1866,The Big Hit,1998,big_hit,5.1,39,16,23,41,6,10,5,5,50,3.1,4322,60,http://content8.flixster.com/movie/27/46/274626_det.jpg
1867,Tarzan and the Lost City,1998,tarzan_and_the_lost_city,2.2,18,1,17,5,2.2,5,0,5,0,2.6,985,35,http://content8.flixster.com/movie/11/14/23/11142390_det.jpg
1869,Black Dog,1998,black_dog,3.1,19,2,17,10,0,3,0,3,0,3,3586,62,http://content8.flixster.com/movie/10/86/90/10869030_det.jpg
1870,"Dancer, Texas Pop. 81",1998,dancer_texas,6.6,15,12,3,80,0,3,2,1,66,3.3,531,62,http://content6.flixster.com/movie/10/86/95/10869540_det.jpg
1871,Priyatel pokoynika,1997,friend-of-the-deceased,6.7,12,8,4,66,0,3,3,0,100,0,0,0,http://content9.flixster.com/movie/10/86/82/10868255_det.jpg
1872,Slumdog Millionaire,2008,slumdog_millionaire,8.2,220,206,14,93,8.2,38,36,2,94,4,328969,90,http://content9.flixster.com/movie/10/86/47/10864783_det.jpg
1873,Les mis√©rables,1998,1083326-les_miserables,6.9,41,31,10,75,6.6,11,6,5,54,3.6,7310,81,http://content9.flixster.com/movie/25/51/255107_det.jpg
1874,Still Breathing,1997,still_breathing,5.6,13,8,5,61,5.5,5,3,2,60,3.6,699,71,http://content6.flixster.com/movie/26/52/265224_det.jpg
1875,Clockwatchers,1997,clockwatchers,6.9,24,20,4,83,6.6,5,4,1,80,3.2,947,56,http://content7.flixster.com/movie/26/35/263513_det.jpg
1876,Deep Impact,1998,deep_impact,5.7,51,24,27,47,5.9,6,2,4,33,2.9,28624,51,http://content8.flixster.com/movie/10/88/98/10889858_det.jpg
1877,Little Men,1997,1081316-little_men,4.6,7,1,6,14,0,3,0,3,0,3.5,85,63,http://content7.flixster.com/movie/10/55/44/10554493_det.gif
1878,Face/Off,1997,faceoff,7.9,60,56,4,93,8.4,15,15,0,100,3.5,62348,81,http://content8.flixster.com/movie/10/85/08/10850854_det.jpg
1879,The Hanging Garden,1997,hanging_garden,7.3,16,15,1,93,0,4,4,0,100,3.6,485,70,http://content8.flixster.com/movie/10/90/64/10906450_det.jpg
1880,Lawn Dogs,1997,lawn_dogs,6.5,18,13,5,72,0,4,1,3,25,3.8,1154,84,http://content7.flixster.com/movie/27/69/276997_det.jpg
1881,Quest for Camelot,1998,quest_for_camelot,5.3,21,7,14,33,5.9,6,2,4,33,3.1,4041,62,http://content6.flixster.com/movie/10/91/52/10915264_det.jpg
1882,Godzilla,1998,godzilla,4.7,59,15,44,25,5.7,9,3,6,33,2.6,17658,38,http://content9.flixster.com/movie/25/99/259919_det.jpg
1883,Bulworth,1998,bulworth,7,61,46,15,75,7.6,10,8,2,80,3.1,3041,60,http://content6.flixster.com/movie/27/10/271016_det.jpg
1884,Fear and Loathing in Las Vegas,1998,fear_and_loathing_in_las_vegas,5.8,45,21,24,46,4.1,6,0,6,0,3.9,75860,90,http://content6.flixster.com/movie/10/88/64/10886456_det.jpg
1885,The Opposite of Sex,1998,opposite_of_sex,7.1,40,33,7,82,6.9,7,4,3,57,3.1,3268,57,http://content7.flixster.com/movie/27/31/273121_det.jpg
1886,I Got the Hook Up,1998,i_got_the_hookup,3,12,2,10,16,0,2,0,2,0,3.2,1133,68,http://content9.flixster.com/movie/10/88/71/10887139_det.jpg
1887,Almost Heroes,1998,almost_heroes,2.3,21,3,18,14,0,3,0,3,0,2.9,4626,63,http://content8.flixster.com/movie/60/49/77/6049770_det.jpg
1888,Hope Floats,1998,hope_floats,4.9,31,7,24,22,4.8,7,0,7,0,3.3,12082,73,http://content6.flixster.com/movie/26/48/264824_det.jpg
1889,Insomnia,2002,1114154-insomnia,7.7,166,153,13,92,7.8,33,31,2,93,3.2,18085,66,http://content6.flixster.com/movie/27/69/276996_det.jpg
1890,Little Boy Blue,1997,little_boy_blue,5,8,2,6,25,0,0,0,0,0,0,0,0,http://content9.flixster.com/movie/38/91/55/3891551_det.jpg
1891,Coyote Ugly,2000,coyote_ugly,3.9,94,20,74,21,3.6,27,5,22,18,3.2,65988,73,http://content7.flixster.com/movie/25/81/258105_det.jpg
1892,A Perfect Murder,1998,1083171-perfect_murder,6.2,49,27,22,55,6.2,14,8,6,57,3.1,9130,52,http://content9.flixster.com/movie/10/91/93/10919303_det.gif
1893,Jenseits der Stille,1996,beyond_silence,7.5,11,9,2,81,8,5,5,0,100,3.9,474,83,http://content7.flixster.com/movie/27/24/272409_det.jpg
1894,Six Days Seven Nights,1998,six_days_seven_nights,5.4,38,14,24,36,5.4,6,0,6,0,2.7,10008,41,http://content9.flixster.com/movie/10/87/45/10874539_det.jpg
1895,Can't Hardly Wait,1998,cant_hardly_wait,5.4,45,20,25,44,5.4,12,5,7,41,3.1,11719,60,http://content9.flixster.com/movie/25/65/256595_det.jpg
1896,Cousin Bette,1998,1084229-cousin_bette,6,21,10,11,47,5.6,5,1,4,20,3,408,38,http://content8.flixster.com/movie/27/12/271294_det.jpg
1897,High Art,1998,high_art,6.8,42,30,12,71,7.2,7,4,3,57,3.7,2153,76,http://content7.flixster.com/movie/10/89/19/10891985_det.jpg
1898,The Land Girls,1998,land_girls,6.7,17,11,6,64,6.1,7,2,5,28,3.3,693,54,http://content7.flixster.com/movie/15/52/22/1552225_det.jpg
1899,Passion in the Desert,1997,passion_in_the_desert,6.1,20,13,7,65,0,4,1,3,25,3.2,162,55,http://content7.flixster.com/movie/10/88/55/10885545_det.jpg
1900,Bacheha-Ye aseman,1997,the-children-of-heaven,7.6,25,21,4,84,7.6,5,4,1,80,4.4,3834,94,http://content6.flixster.com/movie/10/94/64/10946460_det.jpg
1901,Dear Jesse,1998,dear_jesse,6.8,6,5,1,83,0,1,1,0,100,3.8,29,100,http://content8.flixster.com/movie/10/91/90/10919006_det.jpg
1902,Dream for an Insomniac,1996,dream_for_an_insomniac,5,10,5,5,50,0,2,0,2,0,3.6,1167,74,http://content6.flixster.com/movie/27/87/278704_det.jpg
1903,Hav Plenty,1997,hav_plenty,5.2,21,8,13,38,6.6,6,4,2,66,3.9,465,80,http://content6.flixster.com/movie/27/22/272224_det.jpg
1904,Henry Fool,1997,henry_fool,7.4,26,22,4,84,0,3,2,1,66,3.8,1375,78,http://content8.flixster.com/movie/10/88/94/10889490_det.jpg
1906,Mr. Jealousy,1997,mr_jealousy,6.5,12,8,4,66,0,4,2,2,50,3.3,437,59,http://content7.flixster.com/movie/28/00/280097_det.jpg
1907,Mulan,1998,mulan,7.5,72,62,10,86,7,14,10,4,71,3.4,52938,78,http://content6.flixster.com/movie/11/14/84/11148476_det.jpg
1908,Resurrection Man,1998,resurrection_man,0,3,0,3,0,0,0,0,0,0,0,0,0,http://content7.flixster.com/movie/10/92/14/10921409_det.jpg
1909,The X Files,1998,xfiles_fight_the_future,6,68,43,25,63,5.9,15,8,7,53,3.3,13283,69,http://content6.flixster.com/movie/25/49/254904_det.jpg
1910,I Went Down,1997,i_went_down,7.2,19,16,3,84,0,4,2,2,50,4.2,202,88,http://content6.flixster.com/movie/50/89/57/5089576_det.jpg
1911,Doctor Dolittle,1998,dr_dolittle,5.2,49,21,28,42,5.5,8,4,4,50,2.8,23847,46,http://content6.flixster.com/movie/11/15/12/11151232_det.jpg
1912,Out of Sight,1998,1083436-1083436-out_of_sight,7.9,69,64,5,92,8,14,13,1,92,3.2,11285,65,http://content6.flixster.com/movie/10/88/64/10886428_det.jpg
1913,Picnic at Hanging Rock,1975,picnic_at_hanging_rock,8.3,29,27,2,93,9.7,5,5,0,100,4,3210,84,http://content9.flixster.com/movie/25/96/259615_det.jpg
1914,Smoke Signals,1998,smoke_signals,7.3,29,25,4,86,8.1,5,5,0,100,3.9,2767,83,http://content6.flixster.com/movie/25/44/254404_det.jpg
1915,Viagem ao Princ√≠pio do Mundo,1997,viagem-ao-principio-do-mundo-journey-to-the-beginning-of-the-world,6.2,5,3,2,60,0,0,0,0,0,0,0,0,http://content9.flixster.com/movie/10/94/65/10946519_det.jpg
1916,Buffalo '66,1998,buffalo_66,7,40,31,9,77,7.1,7,5,2,71,3.8,7504,87,http://content6.flixster.com/movie/10/87/71/10877180_det.jpg
1917,Armageddon,1998,armageddon,5.1,77,32,45,41,3.8,17,3,14,17,3.5,105398,77,http://content7.flixster.com/movie/55/05/68/5505685_det.jpg
1918,Lethal Weapon 4,1998,lethal_weapon_4,5.9,61,33,28,54,6.1,12,6,6,50,3.3,20840,70,http://content7.flixster.com/movie/11/12/88/11128829_det.jpg
1919,Madeline,1998,1083410-madeline,6.5,26,17,9,65,6.5,6,4,2,66,2.6,3549,45,http://content7.flixster.com/movie/25/93/259317_det.jpg
1920,Small Soldiers,1998,small_soldiers,6.2,41,19,22,46,6.8,12,6,6,50,2.8,9855,46,http://content6.flixster.com/movie/18/47/19/1847196_det.jpg
1921,Pi,1998,pi,7.2,49,42,7,85,6.7,11,8,3,72,3.8,33850,86,http://content7.flixster.com/movie/26/78/267897_det.jpg
1922,What Ever Happened to Baby Jane?,1962,,7.6,37,33,4,89,0,3,2,1,66,3.9,7128,89,http://content8.flixster.com/movie/10/93/55/10935590_det.jpg
1923,There's Something About Mary,1998,something_more,0,2,0,2,0,0,1,0,1,0,3.1,233,47,http://content7.flixster.com/movie/10/88/61/10886109_det.jpg
1924,Plan 9 from Outer Space,1958,plan-9-from-outer-space,4.9,30,19,11,63,0,1,1,0,100,2.8,6105,46,http://content8.flixster.com/movie/10/85/09/10850926_det.jpg
1925,Der Himmel √ºber Berlin,1987,wings_of_desire,8.5,39,38,1,97,7.5,6,5,1,83,4.4,9110,94,http://content9.flixster.com/movie/25/46/254691_det.jpg
1926,The Broadway Melody,1929,,5.4,16,6,10,37,0,4,2,2,50,2.9,515,31,http://content8.flixster.com/movie/11/12/95/11129594_det.jpg
1927,All Quiet on the Western Front,1930,1000642-all_quiet_on_the_western_front,8.6,32,31,1,96,7.8,5,5,0,100,3.8,3797,85,http://content6.flixster.com/movie/66/23/12/6623120_det.jpg
1928,Spirit: Stallion of the Cimarron,2002,spirit_stallion_of_the_cimarron,6.4,125,86,39,68,6.9,29,23,6,79,3.3,8302,72,http://content9.flixster.com/movie/10/87/48/10874827_det.jpg
1929,Grand Hotel,1932,grand_hotel,7.4,28,24,4,85,7.6,5,5,0,100,3.8,1661,77,http://content7.flixster.com/movie/29/63/296321_det.jpg
1930,Cavalcade,1933,cavalcade,6.7,14,9,5,64,0,4,4,0,100,3,314,35,http://content9.flixster.com/movie/10/88/00/10880031_det.jpg
1931,Mutiny on the Bounty,1935,1014481-mutiny_on_the_bounty,8.2,28,26,2,92,7.5,6,5,1,83,3.7,1846,79,http://content9.flixster.com/movie/10/88/45/10884511_det.jpg
1932,The Great Ziegfeld,1936,great_ziegfeld,6,21,12,9,57,6,5,3,2,60,3.4,704,60,http://content8.flixster.com/movie/30/32/303222_det.jpg
1933,The Life of Emile Zola,1937,life_of_emile_zola,7,20,14,6,70,7.2,5,4,1,80,3.6,620,72,http://content7.flixster.com/movie/10/84/90/10849013_det.jpg
1934,You Can't Take It with You,1938,1024312-you_cant_take_it_with_you,7.3,27,26,1,96,0,4,4,0,100,4,2934,87,http://content7.flixster.com/movie/10/91/55/10915585_det.jpg
1935,How Green Was My Valley,1941,how_green_was_my_valley,7.8,34,30,4,88,7.2,5,5,0,100,3.9,1995,83,http://content6.flixster.com/movie/30/92/309228_det.jpg
1936,Mrs. Miniver,1942,mrs_miniver,7.6,22,19,3,86,8.2,5,5,0,100,3.9,1307,85,http://content8.flixster.com/movie/10/08/01/10080150_det.jpg
1937,Going My Way,1944,going_my_way,7,19,14,5,73,0,4,3,1,75,3.8,1251,80,http://content6.flixster.com/movie/10/89/81/10898136_det.jpg
1938,The Lost Weekend,1945,lost_weekend,8.2,24,24,0,100,0,4,4,0,100,4,2562,86,http://content9.flixster.com/movie/10/95/53/10955391_det.jpg
1939,The Best Years of Our Lives,1946,best_years_of_our_lives,8.6,35,34,1,97,8.1,8,8,0,100,4.2,3330,91,http://content7.flixster.com/movie/10/17/14/10171413_det.jpg
1940,Gentleman's Agreement,1947,gentlemans_agreement,7,30,25,5,83,6.8,5,4,1,80,3.8,1308,79,http://content8.flixster.com/movie/30/79/307930_det.jpg
1941,Hamlet,1996,1075422-hamlet,8.2,54,51,3,94,7.2,14,11,3,78,3.8,5816,86,http://content7.flixster.com/movie/10/94/26/10942625_det.jpg
1942,All the King's Men,2006,keep-drinking-men,0,0,0,0,0,0,0,0,0,0,0,0,0,http://content6.flixster.com/movie/10/84/23/10842352_det.jpg
1943,The Greatest Show on Earth,1952,under-the-carp-banner2006,0,0,0,0,0,0,0,0,0,0,0,0,0,http://content6.flixster.com/movie/10/88/18/10881888_det.jpg
1944,From Here to Eternity,1953,1007931-from_here_to_eternity,8,40,35,5,87,7.9,7,6,1,85,3.9,4410,83,http://content9.flixster.com/movie/29/27/292711_det.jpg
1945,On the Waterfront,1954,on_the_waterfront,9,49,49,0,100,8.9,10,10,0,100,4.2,11904,94,http://content9.flixster.com/movie/29/10/291015_det.jpg
1946,Back to the Future,1985,back_to_the_future,8.4,54,52,2,96,7.3,6,5,1,83,3.8,126816,88,http://content6.flixster.com/movie/31/17/311700_det.jpg
1947,West Side Story,1961,west_side_story,8.1,49,45,4,91,8,7,6,1,85,3.5,18648,82,http://content9.flixster.com/movie/10/91/74/10917475_det.jpg
1948,Tom Jones,1963,tom_jones,7.8,26,21,5,80,0,4,3,1,75,3.3,1389,60,http://content9.flixster.com/movie/29/03/290315_det.jpg
1949,A Man for All Seasons,1966,1013162-man_for_all_seasons,7.8,27,23,4,85,0,4,3,1,75,4,2887,86,http://content6.flixster.com/movie/25/08/250892_det.jpg
1950,In the Heat of the Night,1967,in_the_heat_of_the_night,8.1,28,27,1,96,0,4,4,0,100,3.9,4274,90,http://content8.flixster.com/movie/25/71/257126_det.jpg
1951,Oliver!,1968,oliver,7.7,25,21,4,84,0,4,3,1,75,3.4,9490,72,http://content9.flixster.com/movie/11/15/34/11153479_det.jpg
1952,Midnight Cowboy,1969,midnight_cowboy,8.3,49,44,5,89,6.8,6,5,1,83,3.9,8994,87,http://content6.flixster.com/movie/10/88/51/10885192_det.jpg
1953,The French Connection,1971,french_connection,8.5,45,44,1,97,8.2,6,6,0,100,3.8,8751,86,http://content9.flixster.com/movie/10/93/21/10932163_det.jpg
1954,Rocky,1976,1017776-rocky,8.1,41,38,3,92,7.6,5,4,1,80,3.2,165793,65,http://content6.flixster.com/movie/10/89/83/10898396_det.jpg
1955,Kramer vs. Kramer,1979,kramer_vs_kramer,7.9,34,30,4,88,7.4,6,5,1,83,3.7,9401,85,http://content8.flixster.com/movie/10/92/41/10924118_det.jpg
1956,Ordinary People,1980,ordinary_people,7.9,32,29,3,90,7.5,6,5,1,83,3.8,5284,86,http://content8.flixster.com/movie/26/77/267722_det.jpg
1957,Chariots of Fire,1981,chariots_of_fire,7.4,36,31,5,86,7.4,6,5,1,83,3.6,7456,77,http://content7.flixster.com/movie/10/93/45/10934597_det.jpg
1958,Terms of Endearment,1983,terms_of_endearment,7.4,35,31,4,88,7.1,5,4,1,80,3.7,7594,82,http://content6.flixster.com/movie/26/77/267716_det.jpg
1959,Out of Africa,1985,out_of_africa,6.2,32,20,12,62,6.5,6,4,2,66,3.7,10166,84,http://content9.flixster.com/movie/10/85/35/10853583_det.jpg
1960,The Last Emperor,1987,last_emperor,7.9,44,40,4,90,7.6,9,7,2,77,3.7,7466,86,http://content8.flixster.com/movie/10/53/54/10535418_det.jpg
1961,Rain Man,1988,rain_man,7.6,54,47,7,87,4.5,7,2,5,28,3.8,42473,88,http://content6.flixster.com/movie/10/85/35/10853584_det.jpg
1962,Driving Miss Daisy,1989,driving_miss_daisy,7,41,32,9,78,7.9,8,8,0,100,3.4,7698,79,http://content6.flixster.com/movie/26/22/262224_det.jpg
1963,Take the Money and Run,1969,take_the_money_and_run,6.9,13,12,1,92,0,1,0,1,0,0,0,0,http://content9.flixster.com/movie/28/30/283091_det.jpg
1964,Klute,1971,klute,8,27,26,1,96,0,3,2,1,66,3.7,1593,78,http://content6.flixster.com/movie/27/26/272620_det.jpg
1965,Repo Man,1984,repo_man,7.9,37,36,1,97,0,4,4,0,100,3.4,5166,75,http://content8.flixster.com/movie/28/26/282606_det.jpg
1966,Metropolitan,1990,metropolitan,7.4,25,22,3,88,6.5,6,4,2,66,3.9,1143,83,http://content9.flixster.com/movie/10/88/49/10884911_det.jpg
1967,Labyrinth,1986,labyrinth,6,32,19,13,59,6.2,6,3,3,50,3.8,81222,85,http://content6.flixster.com/movie/10/84/45/10844548_det.jpg
1968,The Breakfast Club,1985,breakfast_club,7.5,42,38,4,90,6.2,6,4,2,66,3.9,93109,90,http://content7.flixster.com/movie/68/89/80/6889801_det.jpg
1969,A Nightmare on Elm Street Part 2: Freddy's Revenge,1985,nightmare_on_elm_street_2_freddys_revenge,4.8,23,10,13,43,0,2,2,0,100,3,19841,55,http://content6.flixster.com/movie/10/95/40/10954016_det.jpg
1970,A Nightmare on Elm Street 3: Dream Warriors,1987,nightmare_on_elm_street_3_a_dream_warriors,5.9,31,22,9,70,0,4,1,3,25,3.1,21954,68,http://content8.flixster.com/movie/10/95/40/10954014_det.jpg
1971,A Nightmare on Elm Street 4: The Dream Master,1988,nightmare_on_elm_street_4_the_dream_master,5.3,25,14,11,56,0,4,2,2,50,3,19043,60,http://content6.flixster.com/movie/10/95/40/10954012_det.jpg
1972,A Nightmare on Elm Street: The Dream Child,1989,nightmare_on_elm_street_5_the_dream_child,4.1,27,8,19,29,0,4,1,3,25,2.9,17837,56,http://content8.flixster.com/movie/10/95/40/10954010_det.jpg
1973,Freddy's Dead: The Final Nightmare,1991,freddys_dead_the_final_nightmare,3.9,25,5,20,20,0,4,3,1,75,3,12382,54,http://content8.flixster.com/movie/10/87/87/10878798_det.jpg
1974,Friday the 13th,1980,friday_the_13th_part_1,5.6,45,27,18,60,0,4,2,2,50,3.2,25534,66,http://content8.flixster.com/movie/10/87/23/10872306_det.jpg
1975,Friday the 13th Part 2,1981,friday_the_13th_part_2,4.4,30,10,20,33,0,1,0,1,0,3.1,13685,58,http://content6.flixster.com/movie/10/87/23/10872308_det.jpg
1976,Friday the 13th Part III,1982,friday_the_13th_part_3,3.5,22,3,19,13,0,0,0,0,0,0,0,0,http://content9.flixster.com/movie/10/87/23/10872307_det.jpg
1977,Friday the 13th: The Final Chapter,1984,friday-the-13th-the-final-chapter,4.3,21,5,16,23,0,0,0,0,0,0,0,0,http://content7.flixster.com/movie/10/87/23/10872321_det.jpg
1978,Friday the 13th: A New Beginning,1985,friday_the_13th_part_5_a_new_beginning,3.3,17,3,14,17,0,0,0,0,0,0,0,0,http://content8.flixster.com/movie/11/14/92/11149246_det.jpg
1979,Jason Lives: Friday the 13th Part VI,1986,friday_the_13th_part_6_jason_lives,5.1,24,13,11,54,0,0,0,0,0,0,0,0,http://content7.flixster.com/movie/11/14/92/11149245_det.jpg
1980,Friday the 13th Part VII: The New Blood,1988,friday_the_13th_part_7_the_new_blood,4.5,16,4,12,25,0,0,0,0,0,0,0,0,http://content6.flixster.com/movie/11/14/92/11149248_det.jpg
1981,Friday the 13th Part VIII: Jason Takes Manhattan,1989,friday_the_13th_part_8_jason_takes_manhattan,2.9,20,2,18,10,0,1,0,1,0,2.8,9749,45,http://content9.flixster.com/movie/11/14/92/11149247_det.jpg
1982,Halloween,2007,1179254-halloween,4.1,101,26,75,25,3.9,19,3,16,15,3.3,79946,64,http://content7.flixster.com/movie/10/92/20/10922093_det.jpg
1983,Halloween II,1981,halloween_ii,4.3,30,8,22,26,4.4,5,1,4,20,3.3,16555,67,http://content9.flixster.com/movie/27/57/275791_det.jpg
1984,Halloween III: Season of the Witch,1982,halloween_3_season_of_the_witch,4.2,15,5,10,33,0,2,1,1,50,2.2,7355,28,http://content7.flixster.com/movie/10/87/02/10870285_det.jpg
1985,Halloween 4: The Return of Michael Myers,1988,halloween_4_the_return_of_michael_myers,3.8,22,5,17,22,0,4,0,4,0,3.1,13190,61,http://content9.flixster.com/movie/28/53/285327_det.jpg
1986,Halloween 5,1989,halloween_5_the_revenge_of_michael_myers,3.6,21,3,18,14,0,2,1,1,50,3,11908,55,http://content9.flixster.com/movie/26/73/267307_det.jpg
1987,Prom Night,2008,prom_night,2.8,60,5,55,8,2.4,9,1,8,11,3,51435,46,http://content9.flixster.com/movie/10/66/75/10667503_det.jpg
1988,Hello Mary Lou: Prom Night II,1987,hello_mary_lou_prom_night_2,4,8,3,5,37,0,0,0,0,0,0,0,0,http://content6.flixster.com/movie/20/86/04/2086048_det.jpg
1989,Prom Night III: The Last Kiss,1990,prom_night_3_the_last_kiss,0,3,0,3,0,0,0,0,0,0,0,0,0,http://content8.flixster.com/movie/10/88/54/10885474_det.jpg
1990,Prom Night IV: Deliver Us from Evil,1992,prom_night_4_deliver_us_from_evil,2.1,5,0,5,0,0,0,0,0,0,0,0,0,http://content6.flixster.com/movie/10/89/46/10894616_det.jpg
1991,Bride of Chucky,1998,bride_of_chucky,5.3,30,13,17,43,0,4,1,3,25,2.6,20874,52,http://content7.flixster.com/movie/27/67/276717_det.jpg
1992,Child's Play 2,1990,childs_play_2,4.2,13,5,8,38,0,1,1,0,100,2.8,13499,52,http://content8.flixster.com/movie/27/38/273822_det.jpg
1993,Child's Play 3,1991,childs_play_3,4.3,11,3,8,27,0,1,0,1,0,2.8,12064,47,http://content8.flixster.com/movie/27/49/274994_det.jpg
1994,Poltergeist,1982,1016513-poltergeist,7.1,49,42,7,85,0,4,3,1,75,3.4,15891,74,http://content7.flixster.com/movie/25/42/254297_det.jpg
1995,Poltergeist II: The Other Side,1986,poltergeist_ii_the_other_side,4.7,17,7,10,41,0,1,0,1,0,0,0,0,http://content6.flixster.com/movie/10/88/23/10882352_det.jpg
1996,Poltergeist III,1988,poltergeist_iii,3.6,14,2,12,14,0,0,0,0,0,0,0,0,http://content8.flixster.com/movie/10/86/93/10869346_det.jpg
1997,The Exorcist,1973,exorcist,7.7,43,36,7,83,6.6,7,5,2,71,3.7,49968,83,http://content9.flixster.com/movie/28/02/280219_det.jpg
1998,Exorcist II: The Heretic,1977,exorcist_2_the_heretic,3.6,17,4,13,23,0,0,0,0,0,0,0,0,http://content9.flixster.com/movie/27/11/271111_det.jpg
1999,The Exorcist III,1990,exorcist_3,5.4,27,16,11,59,0,1,0,1,0,2.9,4879,55,http://content6.flixster.com/movie/11/15/20/11152092_det.jpg
2000,Lethal Weapon,1987,lethal_weapon,7.3,40,36,4,90,7.4,8,7,1,87,3.6,33975,81,http://content9.flixster.com/movie/11/12/88/11128835_det.jpg
2001,Lethal Weapon,1987,lethal_weapon,7.3,40,36,4,90,7.4,8,7,1,87,3.6,33975,81,http://content9.flixster.com/movie/11/12/88/11128835_det.jpg
2002,Lethal Weapon 3,1992,lethal_weapon_3,5.6,39,22,17,56,4.7,8,3,5,37,3.2,20151,68,http://content9.flixster.com/movie/11/12/88/11128831_det.jpg
2003,Gremlins,1984,gremlins,6.8,41,32,9,78,5,5,2,3,40,3.4,31525,70,http://content9.flixster.com/movie/26/50/265023_det.jpg
2004,Gremlins 2: The New Batch,1990,gremlins_2_the_new_batch,6.4,34,22,12,64,6.4,6,4,2,66,3,18308,58,http://content8.flixster.com/movie/26/05/260594_det.jpg
2005,The Goonies,1985,goonies,5.9,39,25,14,64,0,3,2,1,66,3.8,89625,88,http://content7.flixster.com/movie/25/37/253701_det.jpg
2006,The Mask of Zorro,1998,mask_of_zorro,7.1,66,54,12,81,6.5,13,10,3,76,3.3,31107,70,http://content8.flixster.com/movie/75/96/759614_det.jpg
2007,Polish Wedding,1998,polish_wedding,4.9,35,15,20,42,5.5,9,4,5,44,3,896,51,http://content8.flixster.com/movie/26/41/264126_det.jpg
2008,"This World, Then the Fireworks",1997,this_world_then_the_fireworks,3.7,5,1,4,20,0,0,0,0,0,0,0,0,http://content9.flixster.com/movie/70/62/75/7062759_det.jpg
2009,Soylent Green,1973,soylent_green,6,31,22,9,70,0,3,0,3,0,3.5,5747,71,http://content9.flixster.com/movie/25/44/254491_det.jpg
2010,Metropolis,1927,,8.9,98,97,1,98,8.8,23,23,0,100,4.1,17640,90,http://content8.flixster.com/movie/10/93/38/10933866_det.jpg
2011,Back to the Future Part II,1989,back_to_the_future_2,6,40,26,14,65,4.2,6,2,4,33,3.5,73208,80,http://content7.flixster.com/movie/85/76/857629_det.jpg
2012,Back to the Future Part III,1990,back_to_the_future_3,6.3,38,27,11,71,5.5,7,3,4,42,3.4,66354,74,http://content8.flixster.com/movie/85/76/857602_det.jpg
2013,The Poseidon Adventure,1972,1016584-poseidon_adventure,6.8,23,18,5,78,0,1,0,1,0,3.3,7876,72,http://content7.flixster.com/movie/25/66/256609_det.jpg
2014,Freaky Friday,2003,freaky_friday,7,140,123,17,87,7,34,29,5,85,2.9,73112,60,http://content8.flixster.com/movie/55/05/69/5505698_det.jpg
2015,The AbsentMinded Professor,1961,absentminded_professor,7.2,20,16,4,80,0,2,2,0,100,3.2,1425,61,http://content9.flixster.com/movie/25/31/253123_det.jpg
2016,The Apple Dumpling Gang Rides Again,1979,apple_dumpling_gang_rides_again,0,3,0,3,0,0,0,0,0,0,0,0,0,http://content6.flixster.com/movie/25/15/251596_det.jpg
2017,Babes in Toyland,1934,march_of_the_wooden_soldiers,8.4,12,12,0,100,0,2,2,0,100,3.6,865,78,http://content7.flixster.com/movie/29/10/291017_det.jpg
2018,Bambi,1942,bambi,8,38,34,4,89,0,4,4,0,100,3.4,39873,68,http://content9.flixster.com/movie/25/06/250691_det.jpg
2019,Shichinin no samurai,1954,1018639-seven_samurai,9.2,49,49,0,100,8.6,10,10,0,100,4.5,29509,97,http://content7.flixster.com/movie/39/91/08/3991085_det.jpg
2020,Dangerous Liaisons,1988,1005199-dangerous_liaisons,7.7,27,25,2,92,6.5,6,5,1,83,3.7,11359,84,http://content6.flixster.com/movie/26/84/268496_det.jpg
2021,Dune,1984,1006364-dune,6.1,26,16,10,61,0,2,0,2,0,3.4,17715,67,http://content7.flixster.com/movie/11/13/64/11136477_det.jpg
2022,The Last Temptation of Christ,1988,last_temptation_of_christ,7.3,46,38,8,82,7.5,7,6,1,85,3.7,7365,83,http://content8.flixster.com/movie/27/03/270314_det.jpg
2023,The Godfather: Part III,1990,godfather_part_iii,6.4,53,35,18,66,6.9,8,6,2,75,3.7,68556,79,http://content6.flixster.com/movie/11/12/76/11127688_det.jpg
2024,The Rapture,1991,rapture,6.5,24,16,8,66,0,2,1,1,50,3.2,627,61,http://content6.flixster.com/movie/10/36/23/10362392_det.jpg
2025,Lolita,1962,1012611-lolita,8,38,37,1,97,0,2,2,0,100,3.7,11593,80,http://content8.flixster.com/movie/30/09/300906_det.jpg
2026,Disturbing Behavior,1998,disturbing_behavior,4.4,33,10,23,30,5.2,6,2,4,33,2.7,4794,43,http://content9.flixster.com/movie/10/91/75/10917563_det.jpg
2027,Jane Austen's Mafia!,1998,1083535-mafia,4,42,6,36,14,4.4,7,0,7,0,2.7,1995,47,http://content8.flixster.com/movie/10/56/10/10561030_det.jpg
2028,Saving Private Ryan,1998,saving_private_ryan,8.2,92,84,8,91,8.1,19,17,2,89,4,139463,92,http://content8.flixster.com/movie/55/05/49/5505494_det.jpg
2029,Billy's Hollywood Screen Kiss,1998,billys_hollywood_screen_kiss,6.5,20,13,7,65,0,4,0,4,0,3.4,686,59,http://content9.flixster.com/movie/27/45/274507_det.jpg
2030,Dong gong xi gong,1996,east-palace-west-palace,6.3,5,3,2,60,0,0,0,0,0,0,0,0,http://content7.flixster.com/movie/99/50/16/9950165_det.jpg
2031,The Million Dollar Duck,1971,million_dollar_duck,3.5,5,0,5,0,0,1,0,1,0,0,0,0,http://content8.flixster.com/movie/25/17/251714_det.jpg
2032,The Barefoot Executive,1971,barefoot_executive,0,4,4,0,100,0,0,0,0,0,0,0,0,http://content7.flixster.com/movie/25/21/252113_det.jpg
2033,The Black Cauldron,1985,black_cauldron,5.8,27,16,11,59,6.2,5,3,2,60,3.1,5461,53,http://content8.flixster.com/movie/25/63/256314_det.jpg
2034,The Black Hole,1979,1002497-black_hole,5.1,26,11,15,42,0,3,2,1,66,3,2357,45,http://content7.flixster.com/movie/26/56/265625_det.jpg
2035,Blackbeard's Ghost,1968,blackbeards_ghost,5.6,9,7,2,77,0,1,1,0,100,3.3,1038,69,http://content8.flixster.com/movie/25/12/251298_det.jpg
2036,Blank Check,1994,blank_check,2.6,7,1,6,14,0,0,0,0,0,0,0,0,http://content6.flixster.com/movie/26/16/261604_det.jpg
2037,Candleshoe,1977,candleshoe,0,1,1,0,100,0,0,0,0,0,0,0,0,http://content9.flixster.com/movie/31/06/310619_det.jpg
2038,The Cat from Outer Space,1978,cat_from_outer_space,0,4,1,3,25,0,0,0,0,0,0,0,0,http://content6.flixster.com/movie/25/35/253516_det.jpg
2039,Cheetah,1989,cheetah,5.5,7,3,4,42,0,1,1,0,100,3.3,357,59,http://content9.flixster.com/movie/25/30/253015_det.jpg
2040,The Computer Wore Tennis Shoes,1969,computer_wore_tennis_shoes,5.6,5,3,2,60,0,0,0,0,0,0,0,0,http://content6.flixster.com/movie/10/94/21/10942176_det.jpg
2041,Condorman,1981,condorman,3.9,12,3,9,25,0,1,1,0,100,2.9,1334,49,http://content8.flixster.com/movie/26/60/266014_det.jpg
2042,D2: The Mighty Ducks,1994,d2_the_mighty_ducks,3.8,13,2,11,15,0,1,0,1,0,2.9,13731,55,http://content6.flixster.com/movie/26/03/260324_det.jpg
2043,Darby O'Gill and the Little People,1959,darby_ogill_and_the_little_people,6.9,13,13,0,100,0,1,1,0,100,3.5,2183,71,http://content8.flixster.com/movie/25/12/251206_det.jpg
2044,The Devil and Max Devlin,1981,devil_and_max_devlin,3.9,8,1,7,12,0,0,0,0,0,0,0,0,http://content6.flixster.com/movie/10/88/51/10885128_det.jpg
2045,A Far Off Place,1993,far_off_place,4.9,9,3,6,33,0,2,0,2,0,3.3,2508,62,http://content7.flixster.com/movie/26/00/260001_det.jpg
2046,Flight of the Navigator,1986,flight_of_the_navigator,5.7,7,5,2,71,0,0,0,0,0,0,0,0,http://content9.flixster.com/movie/25/42/254223_det.jpg
2047,The Gnome-Mobile,1967,gnomemobile,0,1,1,0,100,0,1,1,0,100,3.4,654,62,http://content7.flixster.com/movie/10/88/31/10883141_det.jpg
2048,The Great Mouse Detective,1986,the-great-mouse-detective,6.8,15,12,3,80,0,2,2,0,100,3.3,8687,70,http://content9.flixster.com/movie/25/12/251227_det.jpg
2049,The Happiest Millionaire,1967,happiest_millionaire,0,4,2,2,50,0,1,0,1,0,3.8,694,78,http://content7.flixster.com/movie/10/90/10/10901049_det.jpg
2050,Herbie Goes Bananas,1980,herbie_goes_bananas,0,4,1,3,25,0,1,1,0,100,2.9,2642,53,http://content6.flixster.com/movie/10/90/14/10901432_det.jpg
2051,Herbie Goes to Monte Carlo,1977,herbie_goes_to_monte_carlo,5,8,5,3,62,0,0,0,0,0,0,0,0,http://content7.flixster.com/movie/10/87/61/10876121_det.jpg
2052,Hocus Pocus,1993,1045250-hocus_pocus,4.1,21,6,15,28,0,3,0,3,0,3.1,21690,67,http://content9.flixster.com/movie/25/36/253607_det.jpg
2053,Honey I Blew Up the Kid,1992,honey_i_blew_up_the_kid,4.9,16,7,9,43,0,2,1,1,50,2.5,10297,32,http://content9.flixster.com/movie/10/87/98/10879839_det.jpg
2054,"Honey, I Shrunk the Kids",1989,honey_i_shrunk_the_kids,6.1,30,22,8,73,0,4,3,1,75,2.9,22644,47,http://content6.flixster.com/movie/10/87/98/10879840_det.jpg
2055,Hot Lead and Cold Feet,1978,hot_lead_and_cold_feet,0,1,1,0,100,0,0,0,0,0,0,0,0,http://content8.flixster.com/movie/25/20/252018_det.jpg
2056,In Search of the Castaways,1962,in_search_of_the_castaways,0,4,3,1,75,0,0,0,0,0,0,0,0,http://content9.flixster.com/movie/25/13/251327_det.jpg
2057,Homeward Bound: The Incredible Journey,1993,homeward_bound_the_incredible_journey,6.5,22,19,3,86,6.9,8,7,1,87,3.2,15019,66,http://content8.flixster.com/movie/10/91/53/10915370_det.jpg
2058,The Negotiator,1998,negotiater,0,0,0,0,0,0,0,0,0,0,0,0,0,http://content7.flixster.com/movie/10/84/05/10840545_det.jpg
2059,The Parent Trap,1998,1083414-parent_trap,7,34,27,7,79,6.5,7,4,3,57,3.1,41455,67,http://content9.flixster.com/movie/10/88/10/10881003_det.jpg
2060,BASEketball,1998,baseketball,5,49,20,29,40,4.5,13,3,10,23,3.2,19777,74,http://content7.flixster.com/movie/10/84/59/10845905_det.jpg
2061,Full Tilt Boogie,1997,full-tilt-boogie,0,0,0,0,0,0,0,0,0,0,0,0,0,http://content7.flixster.com/movie/10/89/35/10893537_det.jpg
2062,The Governess,1998,governess,6.4,33,22,11,66,7,6,4,2,66,3.2,534,49,http://content9.flixster.com/movie/27/94/279427_det.jpg
2063,Le septi√®me ciel,1997,1091957-seventh_heaven,5.3,7,4,3,57,0,1,1,0,100,3.4,192,62,http://content9.flixster.com/movie/10/17/86/10178627_det.jpg
2064,Roger & Me,1989,roger_and_me,8.8,27,27,0,100,0,0,0,0,0,0,0,0,http://content9.flixster.com/movie/10/85/07/10850715_det.jpg
2065,The Purple Rose of Cairo,1985,purple_rose_of_cairo,7.7,29,26,3,89,0,0,0,0,0,0,0,0,http://content9.flixster.com/movie/25/86/258623_det.jpg
2066,Out of the Past,1947,out_of_the_past,8.6,25,24,1,96,8.6,5,5,0,100,4.2,2206,91,http://content8.flixster.com/movie/10/08/01/10080146_det.jpg
2067,Doctor Zhivago,1965,1006037-doctor_zhivago,7.2,32,27,5,84,6,5,3,2,60,3.8,11535,85,http://content7.flixster.com/movie/88/17/87/8817873_det.jpg
2068,Fanny och Alexander,1982,fanny_and_alexander,8.9,33,33,0,100,8.4,11,11,0,100,4.4,5627,93,http://content8.flixster.com/movie/10/85/35/10853534_det.jpg
2069,The Trip to Bountiful,1985,trip_to_bountiful,7.2,7,7,0,100,0,1,1,0,100,4,434,82,http://content7.flixster.com/movie/25/68/256893_det.jpg
2070,Tender Mercies,1983,tender_mercies,7.3,20,17,3,85,0,0,0,0,0,0,0,0,http://content6.flixster.com/movie/26/62/266228_det.jpg
2071,And the Band Played On,1993,and_the_band_played_on,7.3,8,8,0,100,0,0,0,0,0,0,0,0,http://content9.flixster.com/movie/10/88/42/10884243_det.jpg
2072,The 'burbs,1989,burbs,5.2,13,6,7,46,0,2,1,1,50,3.3,10248,68,http://content8.flixster.com/movie/55/12/57/5512574_det.jpg
2073,Fandango,1985,1007073-fandango,6.3,6,3,3,50,0,0,0,0,0,0,0,0,http://content7.flixster.com/movie/80/53/86/8053869_det.jpg
2074,Il portiere di notte,1974,night_porter,5.6,20,13,7,65,0,4,1,3,25,3.6,1475,73,http://content8.flixster.com/movie/10/92/32/10923206_det.jpg
2075,Mephisto,1981,mephisto,6.9,16,11,5,68,5.5,5,2,3,40,3.9,757,86,http://content7.flixster.com/movie/28/80/288005_det.jpg
2076,Blue Velvet,1986,blue_velvet,8.4,33,30,3,90,0,4,2,2,50,4,25218,88,http://content8.flixster.com/movie/28/20/282022_det.jpg
2077,The Journey of Natty Gann,1985,journey_of_natty_gann,6.7,13,12,1,92,0,3,3,0,100,3.5,1251,73,http://content8.flixster.com/movie/25/90/259006_det.jpg
2078,The Jungle Book,1967,1031385-jungle_book,7.3,27,24,3,88,0,2,1,1,50,3.5,35715,70,http://content7.flixster.com/movie/25/07/250701_det.jpg
2079,Kidnap,2008,kidnap2008,0,0,0,0,0,0,0,0,0,0,0,0,0,http://content6.flixster.com/movie/10/88/41/10884176_det.jpg
2080,Lady and the Tramp,1955,lady_and_the_tramp,7.4,31,27,4,87,0,4,1,3,25,3.5,37042,73,http://content7.flixster.com/movie/10/84/96/10849641_det.jpg
2081,The Little Mermaid,1989,1012450-little_mermaid,8,51,46,5,90,7.3,7,6,1,85,3.6,80670,83,http://content8.flixster.com/movie/25/06/250622_det.jpg
2082,The Mighty Ducks,1992,mighty_ducks,3.8,25,2,23,8,3.2,5,0,5,0,3.1,14328,64,http://content7.flixster.com/movie/25/87/258701_det.jpg
2083,The Muppet Christmas Carol,1992,muppet_christmas_carol,6,30,20,10,66,4.4,7,3,4,42,0,0,0,http://content8.flixster.com/movie/10/88/72/10887222_det.jpg
2084,Newsies,1992,newsies,4.5,23,7,16,30,3.6,7,1,6,14,3.8,10436,88,http://content7.flixster.com/movie/25/39/253905_det.jpg
2085,One Hundred and One Dalmatians,1961,1036674-101_dalmatians,8,37,36,1,97,7.6,5,5,0,100,3.3,29711,63,http://content7.flixster.com/movie/10/92/06/10920681_det.jpg
2086,One Magic Christmas,1985,one_magic_christmas,5.4,9,5,4,55,0,1,0,1,0,3.4,844,66,http://content8.flixster.com/movie/25/31/253198_det.jpg
2087,Peter Pan,2003,1128577-peter_pan,6.8,132,100,32,75,6.3,33,23,10,69,3.3,47413,68,http://content7.flixster.com/movie/10/91/88/10918857_det.jpg
2088,Popeye,1980,1016534-popeye,5.8,27,15,12,55,0,4,2,2,50,2.6,6384,39,http://content9.flixster.com/movie/25/49/254991_det.jpg
2089,The Rescuers Down Under,1990,rescuers_down_under,6,22,14,8,63,6.5,5,3,2,60,3.2,8757,62,http://content9.flixster.com/movie/25/13/251311_det.jpg
2090,The Rescuers,1977,rescuers,6.6,25,21,4,84,0,3,3,0,100,3.2,7689,66,http://content9.flixster.com/movie/25/09/250903_det.jpg
2091,Race to Witch Mountain,2009,,5.1,145,61,84,42,5.3,29,13,16,44,3.2,150558,50,http://content9.flixster.com/movie/10/91/55/10915591_det.jpg
2092,The Return of Jafar,1994,return_of_jafar,3.6,9,2,7,22,0,0,0,0,0,0,0,0,http://content7.flixster.com/movie/10/93/64/10936425_det.jpg
2093,Return to Oz,1985,1017488-return_to_oz,5.7,20,11,9,55,0,3,1,2,33,3.1,14348,62,http://content7.flixster.com/movie/26/51/265105_det.jpg
2094,The Rocketeer,1991,rocketeer,5.8,50,30,20,60,5.8,9,5,4,55,2.9,8053,54,http://content8.flixster.com/movie/25/59/255906_det.jpg
2095,The Shaggy D.A.,1976,shaggy_da,5.4,8,4,4,50,0,1,0,1,0,3.2,263,55,http://content6.flixster.com/movie/60/85/58/6085588_det.jpg
2096,Sleeping Beauty,1959,1019187-sleeping_beauty,7.8,32,29,3,90,0,4,3,1,75,3.4,42607,75,http://content8.flixster.com/movie/30/64/306418_det.jpg
2097,Something Wicked This Way Comes,1983,something_wicked_this_way_comes,6.1,23,13,10,56,0,4,3,1,75,3.4,2097,64,http://content9.flixster.com/movie/26/58/265895_det.jpg
2098,Son of Flubber,1963,son_of_flubber,6.2,6,5,1,83,0,0,0,0,0,0,0,0,http://content7.flixster.com/movie/25/22/252221_det.jpg
2099,Song of the South,1946,song_of_the_south,5.6,7,3,4,42,0,2,0,2,0,3.6,1559,77,http://content9.flixster.com/movie/21/77/83/2177835_det.jpg
2100,Splash,1984,1019641-splash,6.9,35,32,3,91,5.6,5,3,2,60,3,12492,52,http://content8.flixster.com/movie/26/50/265002_det.jpg
2101,Squanto: A Warrior's Tale,1994,squanto_a_warriors_tale,5.6,9,5,4,55,0,2,0,2,0,3.3,515,62,http://content6.flixster.com/movie/26/18/261816_det.jpg
2102,Steamboat Willie,1928,steamboat-willie,0,0,0,0,0,0,0,0,0,0,0,0,0,http://content7.flixster.com/movie/10/58/45/10584557_det.jpg
2103,Tall Tale,1995,tall_tale_the_unbelievable_adventure,5.5,9,4,5,44,0,1,1,0,100,0,0,0,http://content8.flixster.com/movie/10/90/45/10904586_det.jpg
2104,Tex,1982,tex,6.9,11,9,2,81,0,3,2,1,66,3.5,695,66,http://content9.flixster.com/movie/26/63/266395_det.jpg
2105,TRON,1982,tron,6,37,25,12,67,0,4,1,3,25,3.3,14666,69,http://content6.flixster.com/movie/10/91/41/10914152_det.jpg
2106,Swing Kids,1993,swing_kids,4.6,12,4,8,33,0,3,1,2,33,3.5,4819,79,http://content7.flixster.com/movie/10/92/09/10920937_det.jpg
2107,Halloween H20: 20 Years Later,1998,halloween_h2o,5.5,54,28,26,51,5.9,10,5,5,50,2.8,14935,57,http://content8.flixster.com/movie/10/88/13/10881306_det.jpg
2108,L.A. Story,1991,la_story,7.4,32,30,2,93,7.8,7,7,0,100,3.2,3117,70,http://content8.flixster.com/movie/26/57/265702_det.jpg
2109,The Jerk,1979,jerk,6.5,30,25,5,83,0,4,2,2,50,3.6,10847,83,http://content9.flixster.com/movie/27/59/275903_det.jpg
2110,Dead Men Don't Wear Plaid,1982,dead_men_dont_wear_plaid,6.5,22,17,5,77,0,0,0,0,0,0,0,0,http://content6.flixster.com/movie/10/90/61/10906132_det.jpg
2111,The Man with Two Brains,1983,man_with_two_brains,6,20,14,6,70,0,1,0,1,0,3,4360,57,http://content7.flixster.com/movie/10/92/03/10920301_det.jpg
2112,Grand Canyon,1991,1037642-grand_canyon,6.9,24,18,6,75,0,2,2,0,100,3.4,1857,65,http://content6.flixster.com/movie/11/15/35/11153528_det.jpg
2113,Graveyard Shift,1990,1031376-graveyard_shift,3.8,8,1,7,12,0,0,0,0,0,0,0,0,http://content6.flixster.com/movie/27/73/277316_det.jpg
2114,The Outsiders,1983,outsiders,6.1,31,20,11,64,4.7,7,2,5,28,3.6,24069,81,http://content6.flixster.com/movie/10/89/23/10892396_det.jpg
2115,Indiana Jones and the Temple of Doom,1984,indiana_jones_and_the_temple_of_doom,7.2,59,50,9,84,6.5,7,4,3,57,3.7,87518,80,http://content8.flixster.com/movie/10/92/11/10921138_det.jpg
2116,The Lord of the Rings: The Return of the King,2003,lord_of_the_rings_the_return_of_the_king,8.6,239,225,14,94,8.6,43,42,1,97,3.7,288649,83,http://content7.flixster.com/movie/10/84/07/10840741_det.jpg
2117,Nineteen Eighty-Four,1984,1000055-1984,6.4,14,11,3,78,0,1,1,0,100,3.5,17133,70,http://content7.flixster.com/movie/10/88/05/10880581_det.jpg
2118,The Dead Zone,2002,,\N,\N,\N,\N,\N,\N,\N,\N,\N,\N,\N,\N,\N,\N
2119,Maximum Overdrive,1986,maximum_overdrive,2.9,11,2,9,18,0,0,0,0,0,0,0,0,http://content7.flixster.com/movie/28/13/281313_det.jpg
2120,Needful Things,1993,needful_things,4,22,6,16,27,0,3,0,3,0,3,2983,48,http://content6.flixster.com/movie/28/40/284092_det.jpg
2121,Cujo,1983,cujo,5.6,27,16,11,59,0,0,0,0,0,0,0,0,http://content9.flixster.com/movie/27/87/278791_det.jpg
2122,Children of the Corn,1984,1004047-children_of_the_corn,4.1,22,8,14,36,0,0,0,0,0,0,0,0,http://content9.flixster.com/movie/10/91/84/10918483_det.jpg
2123,All Dogs Go to Heaven,1989,,5.2,9,4,5,44,0,1,1,0,100,3.2,20551,60,http://content6.flixster.com/movie/10/87/86/10878600_det.jpg
2124,The Addams Family,1991,addams_family,5.6,39,23,16,58,4.1,7,1,6,14,3.2,28704,65,http://content8.flixster.com/movie/26/64/266402_det.jpg
2125,Ever After,1998,ever_after_a_cinderella_story,7.5,61,55,6,90,6.8,17,13,4,76,3.5,71637,81,http://content7.flixster.com/movie/26/10/261017_det.jpg
2126,Snake Eyes,1998,snake_eyes,5.2,64,26,38,40,4.9,14,6,8,42,2.8,8922,40,http://content9.flixster.com/movie/27/39/273915_det.jpg
2127,"First Love, Last Rites",1997,first_love_last_rites,6.1,8,3,5,37,0,0,0,0,0,0,0,0,http://content8.flixster.com/movie/10/89/01/10890198_det.jpg
2128,Safe Men,1998,safe_men,6,19,11,8,57,0,3,0,3,0,3.4,851,60,http://content9.flixster.com/movie/24/53/01/2453019_det.jpg
2129,Die Salzm√§nner von Tibet,1997,the-saltmen-of-tibet,0,0,0,0,0,0,0,0,0,0,0,0,0,http://content9.flixster.com/movie/10/92/75/10927511_det.jpg
2130,Atlantic City,1980,atlantic_city,8.7,19,19,0,100,0,0,0,0,0,0,0,0,http://content6.flixster.com/movie/27/24/272496_det.jpg
2131,H√∂stsonaten,1978,autumn_sonata,8,19,18,1,94,0,1,1,0,100,4.1,2226,90,http://content7.flixster.com/movie/26/49/264925_det.jpg
2132,Who's Afraid of Virginia Woolf?,1966,whos_afraid_of_virginia_woolf,8.6,31,30,1,96,0,4,3,1,75,4.1,5164,91,http://content8.flixster.com/movie/11/14/16/11141682_det.jpg
2133,Adventures in Babysitting,1987,adventures_in_babysitting,6.2,21,16,5,76,0,1,0,1,0,3.2,12565,64,http://content8.flixster.com/movie/25/41/254110_det.jpg
2134,Weird Science,1985,1023316-weird_science,5.6,25,14,11,56,0,3,1,2,33,3.2,14712,69,http://content8.flixster.com/movie/26/37/263714_det.jpg
2135,Doctor Dolittle,1998,dr_dolittle,5.2,49,21,28,42,5.5,8,4,4,50,2.8,23847,46,http://content6.flixster.com/movie/11/15/12/11151232_det.jpg
2136,The Nutty Professor,1996,1071708-nutty_professor,6,51,34,17,66,6.7,15,13,2,86,2.9,25286,50,http://content8.flixster.com/movie/25/91/259122_det.jpg
2137,Charlotte's Web,2006,charlottes_web,7,142,111,31,78,6.9,35,25,10,71,3.3,39179,67,http://content9.flixster.com/movie/31/82/33/3182335_det.jpg
2138,Watership Down,1978,watership_down,7,27,22,5,81,0,2,1,1,50,3.6,5277,82,http://content7.flixster.com/movie/11/15/28/11152877_det.jpg
2139,The Secret of NIMH,1982,secret_of_nimh,6.8,18,17,1,94,6.5,5,4,1,80,3.5,7964,79,http://content6.flixster.com/movie/10/88/77/10887724_det.jpg
2140,The Dark Crystal,1982,dark_crystal,6.1,30,21,9,70,0,2,1,1,50,3.6,35382,78,http://content8.flixster.com/movie/25/47/254714_det.jpg
2141,An American Tail,1986,american_tail,6.2,24,15,9,62,4.8,6,2,4,33,3.3,13516,68,http://content8.flixster.com/movie/25/15/251502_det.jpg
2142,An American Tail: Fievel Goes West,1991,american_tail_fievel_goes_west,5.4,9,3,6,33,0,2,1,1,50,3.2,16427,58,http://content6.flixster.com/movie/25/31/253108_det.jpg
2143,Legend,1985,1012164-legend,5.4,21,11,10,52,0,1,0,1,0,3.5,26271,73,http://content6.flixster.com/movie/25/40/254000_det.jpg
2144,Sixteen Candles,1984,sixteen_candles,7,31,27,4,87,6.2,5,3,2,60,3.7,44572,84,http://content8.flixster.com/movie/27/90/279006_det.jpg
2145,Pretty in Pink,1986,pretty_in_pink,6.3,30,24,6,80,0,4,3,1,75,3.5,37255,81,http://content6.flixster.com/movie/10/91/49/10914992_det.jpg
2146,St. Elmo's Fire,1985,st_elmos_fire,4.7,29,13,16,44,0,0,0,0,0,0,0,0,http://content9.flixster.com/movie/10/94/35/10943539_det.jpg
2147,The Clan of the Cave Bear,1986,clan_of_the_cave_bear,3.7,8,1,7,12,0,1,0,1,0,2.9,1148,48,http://content8.flixster.com/movie/10/88/22/10882214_det.jpg
2148,House M.D.,2004,,\N,\N,\N,\N,\N,\N,\N,\N,\N,\N,\N,\N,\N,\N
2149,House II: The Second Story,1987,house_2_the_second_story,3,9,0,9,0,0,0,0,0,0,0,0,0,http://content8.flixster.com/movie/26/13/261314_det.jpg
2150,The Gods Must Be Crazy,1980,the-gods-must-be-crazy,7.4,19,18,1,94,0,1,1,0,100,3.5,7965,78,http://content7.flixster.com/movie/11/15/34/11153477_det.jpg
2151,The Gods Must Be Crazy II,1989,gods_must_be_crazy_2,5.1,11,6,5,54,0,2,1,1,50,3.4,2600,69,http://content7.flixster.com/movie/10/90/47/10904733_det.jpg
2152,Air Bud: Golden Receiver,1998,air-bud-golden-receiver,4,17,1,16,5,0,3,0,3,0,2.7,7798,41,http://content6.flixster.com/movie/10/87/66/10876644_det.jpg
2154,How Stella Got Her Groove Back,1998,how_stella_got_her_groove_back,5.5,47,23,24,48,5.8,12,7,5,58,3.1,4439,72,http://content8.flixster.com/movie/10/88/71/10887130_det.jpg
2155,Slums of Beverly Hills,1998,slums_of_beverly_hills,6.9,58,46,12,79,7.3,13,12,1,92,3.3,1834,64,http://content6.flixster.com/movie/27/43/274320_det.jpg
2156,Il testimone dello sposo,1998,1084447-best_man,5.7,7,4,3,57,0,2,1,1,50,2.7,49,38,http://content7.flixster.com/movie/10/85/32/10853253_det.jpg
2157,La femme de chambre du Titanic,1997,chambermaid_on_the_titanic,6.5,16,13,3,81,0,1,1,0,100,0,0,0,http://content6.flixster.com/movie/10/92/19/10921924_det.jpg
2158,"Henry: Portrait of a Serial Killer, Part 2",1996,henry-portrait-of-a-serial-killer-part-2,0,0,0,0,0,0,0,0,0,0,0,0,0,http://content9.flixster.com/movie/11/14/63/11146379_det.jpg
2159,Henry: Portrait of a Serial Killer,1986,henry-portrait-of-a-serial-killer,7.3,41,36,5,87,6.5,7,6,1,85,3.6,2890,72,http://content7.flixster.com/movie/11/14/63/11146381_det.jpg
2160,Rosemary's Baby,1968,hush_little_baby_dont_you_cry,0,0,0,0,0,0,0,0,0,0,0,0,0,http://images.rottentomatoescdn.com/images/defaults/poster_default.gif
2161,The Neverending Story III,1994,neverending_story_3_the_escape_from_fantasia,0,3,1,2,33,0,0,0,0,0,0,0,0,http://content9.flixster.com/movie/10/88/07/10880743_det.jpg
2162,The Neverending Story II: The Next Chapter,1990,neverending_story_2_the_the_next_chapter,3.3,6,0,6,0,0,0,0,0,0,0,0,0,http://content7.flixster.com/movie/25/62/256297_det.jpg
2163,Attack of the Killer Tomatoes!,1978,attack-of-the-killer-tomatoes,3.9,11,3,8,27,0,0,0,0,0,0,0,0,http://content6.flixster.com/movie/10/92/32/10923244_det.jpg
2164,Surf Nazis Must Die,1987,surf_nazis_must_die,0,4,0,4,0,0,0,0,0,0,0,0,0,http://content8.flixster.com/movie/27/80/278026_det.jpg
2165,Your Friends & Neighbors,1998,your_friends_and_neighbors,7,55,42,13,76,6.4,20,13,7,65,3.3,1418,60,http://content7.flixster.com/movie/10/93/56/10935653_det.jpg
2166,Return to Paradise,1998,1083688-return_to_paradise,6.6,44,31,13,70,6.8,11,8,3,72,3.5,1723,76,http://content7.flixster.com/movie/28/43/284397_det.jpg
2167,Blade,1998,,5.7,83,46,37,55,4.6,24,7,17,29,3.6,87683,78,http://content6.flixster.com/movie/35/84/20/3584204_det.jpg
2168,Dance with Me,1998,dance_with_me,5.4,40,19,21,47,5.2,11,5,6,45,3.2,7621,68,http://content9.flixster.com/movie/25/56/255603_det.jpg
2169,Dead Man on Campus,1998,dead_man_on_campus,3.6,34,5,29,14,2.8,11,0,11,0,2.7,3796,50,http://content9.flixster.com/movie/10/87/18/10871827_det.jpg
2170,Wrongfully Accused,1998,wrongfully_accused,3.8,31,7,24,22,2.9,6,0,6,0,2.8,2483,56,http://content9.flixster.com/movie/10/92/01/10920195_det.jpg
2171,Next Stop Wonderland,1998,next_stop_wonderland,6.8,41,30,11,73,5.7,7,3,4,42,3.5,910,70,http://content7.flixster.com/movie/10/86/22/10862269_det.jpg
2172,Strike!,1998,all_i_wanna_do,6.8,12,8,4,66,0,3,1,2,33,3.5,2267,69,http://content9.flixster.com/movie/25/92/259223_det.jpg
2173,The Navigator: A Mediaeval Odyssey,1988,1014781-navigator,6.5,5,4,1,80,0,0,0,0,0,0,0,0,http://content6.flixster.com/movie/10/87/32/10873272_det.jpg
2174,Beetle Juice,1988,beetlejuice,7,42,34,8,80,6.4,7,5,2,71,3.4,84134,77,http://content9.flixster.com/movie/45/46/63/4546639_det.jpg
2175,Deja Vu,2006,new-orleans-exposed-before-and-after-katrina,0,0,0,0,0,0,0,0,0,0,0,0,0,http://content6.flixster.com/movie/10/84/17/10841796_det.jpg
2176,Rope,1948,rope,7.8,31,30,1,96,0,2,1,1,50,4,9199,89,http://content8.flixster.com/movie/25/62/256210_det.jpg
2177,Family Plot,1976,family_plot,7,20,19,1,95,0,2,2,0,100,3.3,1981,57,http://content6.flixster.com/movie/10/88/55/10885532_det.jpg
2178,Frenzy,1972,frenzy,7.4,30,26,4,86,0,2,2,0,100,3.6,3790,74,http://content6.flixster.com/movie/27/01/270104_det.jpg
2179,Topaz,1969,topaz,6.4,17,12,5,70,0,1,1,0,100,3,1779,39,http://content9.flixster.com/movie/26/00/260091_det.jpg
2180,Torn Curtain,1966,torn_curtain,6.5,16,13,3,81,0,1,0,1,0,3.3,2910,55,http://content9.flixster.com/movie/25/86/258619_det.jpg
2181,Marnie,1964,marnie,6.8,19,16,3,84,0,1,0,1,0,0,0,0,http://content6.flixster.com/movie/25/65/256512_det.jpg
2182,The Wrong Man,1956,1024191-wrong_man,8.3,18,16,2,88,0,1,0,1,0,3.6,2616,72,http://content8.flixster.com/movie/10/88/80/10888034_det.jpg
2183,The Man Who Knew Too Much,1956,1013209-man_who_knew_too_much,7.7,28,25,3,89,0,3,2,1,66,0,0,0,http://content8.flixster.com/movie/10/92/45/10924554_det.gif
2184,The Trouble with Harry,1955,trouble_with_harry,7.4,19,17,2,89,0,1,1,0,100,3.6,3827,73,http://content9.flixster.com/movie/10/91/87/10918787_det.jpg
2185,I Confess,1953,i_confess,7.2,20,17,3,85,0,3,2,1,66,3.6,2474,70,http://content7.flixster.com/movie/95/95/29/9595297_det.jpg
2186,Strangers on a Train,1951,strangers_on_a_train,8.7,40,39,1,97,7.3,5,4,1,80,4,9106,91,http://content9.flixster.com/movie/10/93/77/10937755_det.jpg
2187,Stage Fright,1950,1019777-stage_fright,7,16,14,2,87,0,3,2,1,66,3.4,2015,61,http://content8.flixster.com/movie/10/91/56/10915662_det.jpg
2188,54,1998,54,4.1,62,8,54,12,3.4,14,1,13,7,2.8,4129,45,http://content6.flixster.com/movie/27/08/270804_det.jpg
2189,I Married a Strange Person!,1997,i_married_a_strange_person,6.1,9,7,2,77,0,1,1,0,100,3.8,688,80,http://content6.flixster.com/movie/31/02/310292_det.jpg
2190,Why Do Fools Fall in Love,1998,why_do_fools_fall_in_love,5.8,54,29,25,53,6.5,19,13,6,68,3.5,1989,73,http://content6.flixster.com/movie/10/92/01/10920176_det.jpg
2191,Keep the Aspidistra Flying,1997,merry_war,7,21,18,3,85,0,4,4,0,100,3.2,753,50,http://content6.flixster.com/movie/10/89/29/10892908_det.jpg
2192,Regarde la mer,1997,see_the_sea,7.3,8,8,0,100,0,2,2,0,100,3.4,370,61,http://content9.flixster.com/movie/28/97/289727_det.jpg
2193,Willow,1988,willow,5.4,26,12,14,46,0,4,0,4,0,3.4,36518,76,http://content6.flixster.com/movie/10/53/47/10534748_det.jpg
2194,The Untouchables,1987,untouchables,7.2,42,34,8,80,7.9,7,6,1,85,3.8,40677,87,http://content8.flixster.com/movie/27/92/279214_det.jpg
2195,Dirty Work,1998,1083480-dirty_work,3.9,30,5,25,16,3.5,7,0,7,0,3.1,3838,66,http://content7.flixster.com/movie/10/91/46/10914685_det.jpg
2196,Knock Off,1998,knock_off,2.9,38,3,35,7,3.6,9,2,7,22,2.6,1992,32,http://content7.flixster.com/movie/27/91/279101_det.jpg
2197,Firelight,1997,firelight,5.2,13,6,7,46,0,3,2,1,66,3.8,672,81,http://content9.flixster.com/movie/10/45/86/10458659_det.jpg
2199,Griffin & Phoenix,2006,1171877-phoenix,0,0,0,0,0,0,0,0,0,0,0,0,0,http://content9.flixster.com/movie/10/89/92/10899243_det.jpg
2200,Under Capricorn,1949,1022317-under_capricorn,5.9,6,4,2,66,0,2,1,1,50,3,851,37,http://content6.flixster.com/movie/29/74/297492_det.jpg
2201,The Paradine Case,1947,paradine_case,6.2,8,6,2,75,0,1,1,0,100,3.2,1208,46,http://content6.flixster.com/movie/30/47/304708_det.jpg
2202,Lifeboat,1944,lifeboat,7.8,20,19,1,95,0,3,2,1,66,3.8,2621,84,http://content7.flixster.com/movie/11/15/13/11151377_det.jpg
2203,Shadow of a Doubt,1943,1018688-shadow_of_a_doubt,8.9,30,30,0,100,0,4,4,0,100,4,5376,89,http://content6.flixster.com/movie/10/89/08/10890840_det.jpg
2204,Saboteur,1942,saboteur,6.7,14,11,3,78,0,1,0,1,0,3.6,2467,72,http://content7.flixster.com/movie/25/76/257625_det.jpg
2205,Mr. & Mrs. Smith,2005,mr_and_mrs_smith,6,202,116,86,57,5.6,39,18,21,46,3.4,230941,63,http://content8.flixster.com/movie/24/98/249802_det.jpg
2206,Guilty by Suspicion,1991,guilty_by_suspicion,6.2,16,11,5,68,0,2,1,1,50,3.2,728,51,http://content8.flixster.com/movie/10/89/64/10896454_det.jpg
2207,Jamaica Inn,1939,1010889-jamaica_inn,5.5,10,7,3,70,0,1,0,1,0,3,1259,38,http://content6.flixster.com/movie/29/98/299800_det.jpg
2208,The Lady Vanishes,1938,1011813-lady_vanishes,8.3,33,32,1,96,0,3,3,0,100,4,4078,87,http://content8.flixster.com/movie/92/28/922862_det.jpg
2209,Young and Innocent,1937,young_and_innocent,7.5,13,13,0,100,0,2,2,0,100,3.4,889,61,http://content6.flixster.com/movie/95/36/953684_det.jpg
2210,Sabotage,1936,1018044-sabotage,7.3,7,7,0,100,0,1,1,0,100,3.5,1459,68,http://content9.flixster.com/movie/24/84/79/2484791_det.jpg
2211,Secret Agent,1936,1018483-secret_agent,7.6,10,10,0,100,0,0,0,0,0,0,0,0,http://content8.flixster.com/movie/10/35/29/10352954_det.jpg
2212,The Man Who Knew Too Much,1956,1013209-man_who_knew_too_much,7.7,28,25,3,89,0,3,2,1,66,0,0,0,http://content8.flixster.com/movie/10/92/45/10924554_det.gif
2214,Number Seventeen,1932,number_17,0,2,0,2,0,0,0,0,0,0,0,0,0,http://content8.flixster.com/movie/24/83/27/2483274_det.gif
2215,Rich and Strange,1931,rich_and_strange,6.4,10,7,3,70,0,1,1,0,100,0,0,0,http://content7.flixster.com/movie/71/88/718873_det.jpg
2216,The Skin Game,1931,1046655-skin_game,0,3,0,3,0,0,2,0,2,0,2.7,145,27,http://content9.flixster.com/movie/10/85/41/10854159_det.jpg
2218,Juno and the Paycock,1930,juno_and_the_paycock,5.1,7,4,3,57,0,2,0,2,0,0,0,0,http://content8.flixster.com/movie/24/89/81/2489814_det.gif
2219,A Perfect Murder,1998,1083171-perfect_murder,6.2,49,27,22,55,6.2,14,8,6,57,3.1,9130,52,http://content9.flixster.com/movie/10/91/93/10919303_det.gif
2220,The Manxman,1929,manxman,0,2,2,0,100,0,1,1,0,100,3.1,502,37,http://content7.flixster.com/movie/30/66/306601_det.jpg
2221,Blackmail,1929,1002540-blackmail,6.7,9,8,1,88,0,1,1,0,100,3.4,1310,63,http://content8.flixster.com/movie/11/13/96/11139670_det.jpg
2222,Champagne,1928,1057837-champagne,0,1,0,1,0,0,0,0,0,0,0,0,0,http://content7.flixster.com/movie/10/83/87/10838705_det.jpg
2223,The Farmer's Wife,1928,the-farmers-wife2005,0,0,0,0,0,0,0,0,0,0,0,0,0,http://content6.flixster.com/movie/10/84/53/10845328_det.jpg
2225,Easy Virtue,2008,1202807-easy_virtue,5.8,120,63,57,52,5.8,26,13,13,50,3.1,16900,48,http://content7.flixster.com/movie/10/86/91/10869105_det.jpg
2226,The Ring,2002,ring,6.6,169,120,49,71,6.3,32,18,14,56,3,146246,50,http://content8.flixster.com/movie/10/86/94/10869458_det.jpg
2227,The Lodger,2009,1205668-lodger,3.6,23,4,19,17,2.5,6,0,6,0,2.9,1023,36,http://content8.flixster.com/movie/10/92/98/10929834_det.jpg
2229,The Pleasure Garden,1925,the-pleasure-garden,0,1,1,0,100,0,0,0,0,0,0,0,0,http://content8.flixster.com/movie/10/90/64/10906458_det.jpg
2231,Rounders,1998,1083659-rounders,6.2,76,49,27,64,5,19,8,11,42,3.7,21780,86,http://content8.flixster.com/movie/10/87/41/10874162_det.jpg
2232,Cube,1997,cube,6.1,33,20,13,60,6,6,3,3,50,3.5,22869,75,http://content8.flixster.com/movie/26/85/268594_det.jpg
2233,Digging to China,1998,digging_to_china,4.4,7,3,4,42,0,1,0,1,0,3.7,506,70,http://content6.flixster.com/movie/10/83/99/10839932_det.jpg
2234,Kinsey,2004,kinsey,7.6,187,168,19,89,7.9,39,36,3,92,3.4,6162,72,http://content6.flixster.com/movie/10/94/53/10945324_det.jpg
2235,One Man's Hero,1999,one_mans_hero,4.8,8,3,5,37,0,1,0,1,0,3.1,305,48,http://content9.flixster.com/movie/10/87/98/10879803_det.jpg
2236,Simon Birch,1998,simon_birch,5.8,32,14,18,43,5.4,6,2,4,33,3.4,8747,76,http://content7.flixster.com/movie/25/50/255097_det.jpg
2237,Without Limits,1998,without_limits,6.5,37,29,8,78,6.8,15,13,2,86,4,1947,88,http://content6.flixster.com/movie/25/48/254804_det.jpg
2238,Pasqualino Settebellezze,1975,seven_beauties,8.2,9,8,1,88,0,1,1,0,100,4,557,87,http://content7.flixster.com/movie/11/13/90/11139021_det.jpg
2239,Travolti da un insolito destino nell'azzurro mare d'agosto,1974,1020710-swept_away,5.9,16,11,5,68,0,2,2,0,100,3.7,857,77,http://content8.flixster.com/movie/11/13/01/11130142_det.jpg
2240,My Bodyguard,1980,my_bodyguard,6.5,25,21,4,84,0,4,3,1,75,3.4,1236,67,http://content9.flixster.com/movie/25/60/256015_det.jpg
2241,Class,1983,class,4.7,12,3,9,25,0,2,1,1,50,3,1523,47,http://content8.flixster.com/movie/27/39/273910_det.jpg
2242,"Grandview, U.S.A.",1984,grandview_usa,0,1,0,1,0,0,0,0,0,0,0,0,0,http://content7.flixster.com/movie/59/97/32/5997325_det.jpg
2243,Broadcast News,1987,broadcast_news,8.1,38,37,1,97,7.8,7,7,0,100,3.5,2524,71,http://content9.flixster.com/movie/10/87/82/10878247_det.jpg
2244,The Allnighter,1987,allnighter,2.5,7,0,7,0,0,3,0,3,0,2.9,329,39,http://content6.flixster.com/movie/26/41/264196_det.jpg
2245,Working Girl,1988,working_girl,6.7,36,30,6,83,7.2,7,6,1,85,3.1,6043,61,http://content6.flixster.com/movie/31/40/314096_det.jpg
2246,Stars and Bars,1988,stars_and_bars,0,1,1,0,100,0,0,0,0,0,0,0,0,http://content9.flixster.com/movie/92/87/09/9287099_det.gif
2247,Married to the Mob,1988,married_to_the_mob,7.2,22,19,3,86,0,0,0,0,0,0,0,0,http://content9.flixster.com/movie/34/35/63/3435639_det.jpg
2248,Say Anything...,1989,say_anything,8.1,38,38,0,100,7.9,6,6,0,100,3.6,20891,82,http://content8.flixster.com/movie/59/54/51/5954518_det.jpg
2249,My Blue Heaven,1990,1029161-my_blue_heaven,5.5,16,11,5,68,0,1,1,0,100,3,2634,54,http://content8.flixster.com/movie/25/65/256502_det.jpg
2250,Men Don't Leave,1990,men_dont_leave,6.6,16,12,4,75,0,2,1,1,50,3.4,202,54,http://content9.flixster.com/movie/97/18/86/9718863_det.jpg
2251,The Cabinet of Dr. Ramirez,1991,,\N,\N,\N,\N,\N,\N,\N,\N,\N,\N,\N,\N,\N,\N
2252,Heroes,2006,heroes-and-villians,0,0,0,0,0,0,0,0,0,0,0,0,0,http://content8.flixster.com/movie/10/85/26/10852618_det.jpg
2253,Toys,1992,toys,4.1,22,6,16,27,0,3,0,3,0,2.6,6312,39,http://content9.flixster.com/movie/10/87/80/10878095_det.jpg
2255,Young Doctors in Love,1982,young_doctors_in_love,4.2,6,0,6,0,0,1,0,1,0,2.7,366,33,http://content8.flixster.com/movie/27/43/274394_det.jpg
2256,Parasite,1982,1015940-parasite,2.2,5,0,5,0,0,0,0,0,0,0,0,0,http://content6.flixster.com/movie/10/86/97/10869728_det.jpg
2257,No Small Affair,1984,no_small_affair,5.7,6,4,2,66,0,0,0,0,0,0,0,0,http://content6.flixster.com/movie/28/45/284592_det.jpg
2258,Shao Lin san shi liu fang,1978,36th-chamber-of-shaolin-shao-lin-san-shi-liu-fang,0,1,0,1,0,0,0,0,0,0,0,0,0,http://content9.flixster.com/movie/11/12/46/11124615_det.jpg
2259,Blame It on Rio,1984,blame_it_on_rio,2.9,22,2,20,9,0,3,0,3,0,2.8,1097,36,http://content8.flixster.com/movie/27/23/272302_det.jpg
2260,Filth and Wisdom,2008,filth_and_wisdom,3.9,58,15,43,25,4.2,23,7,16,30,3,1070,42,http://content6.flixster.com/movie/10/86/05/10860500_det.jpg
2261,One Crazy Summer,1986,one_crazy_summer,5.6,15,9,6,60,0,2,1,1,50,3.3,3309,62,http://content9.flixster.com/movie/25/79/257919_det.jpg
2262,Last Night,1998,1094041-last_night,7.2,49,41,8,83,7.1,9,7,2,77,3.8,1691,84,http://content9.flixster.com/movie/18/18/56/1818567_det.jpg
2263,The Seventh Sign,1988,seventh_sign,3.7,16,3,13,18,0,1,0,1,0,3.1,3031,55,http://content9.flixster.com/movie/27/25/272507_det.jpg
2264,We're No Angels,1989,1023286-were_no_angels,5.1,18,9,9,50,0,1,1,0,100,2.9,2176,43,http://content8.flixster.com/movie/26/25/262514_det.jpg
2265,Nothing But Trouble,1991,1033647-nothing_but_trouble,2.2,10,1,9,10,0,1,0,1,0,0,0,0,http://content9.flixster.com/movie/10/93/53/10935391_det.jpg
2266,The Butcher's Wife,1991,butchers_wife,3.8,13,3,10,23,0,2,0,2,0,2.7,1218,30,http://content8.flixster.com/movie/26/15/261514_det.jpg
2267,Mortal Thoughts,1991,mortal_thoughts,5.6,13,8,5,61,0,2,1,1,50,2.9,1404,33,http://content9.flixster.com/movie/27/64/276491_det.jpg
2268,A Few Good Men,1992,few_good_men,6.8,42,35,7,83,7.5,8,8,0,100,3.6,26934,83,http://content6.flixster.com/movie/28/17/281708_det.jpg
2269,Indecent Proposal,1993,indecent_proposal,4.7,35,13,22,37,0,3,1,2,33,2.9,7358,50,http://content8.flixster.com/movie/10/88/26/10882670_det.jpg
2270,A Century of Cinema,1994,,\N,\N,\N,\N,\N,\N,\N,\N,\N,\N,\N,\N,\N,\N
2271,Permanent Midnight,1998,permanent_midnight,5.7,51,30,21,58,6.4,11,7,4,63,3.2,1302,55,http://content6.flixster.com/movie/10/91/85/10918516_det.jpg
2272,One True Thing,1998,one_true_thing,7.2,60,53,7,88,6.7,18,15,3,83,3.4,2813,65,http://content9.flixster.com/movie/27/34/273411_det.jpg
2273,Rush Hour,1998,rush_hour,6,62,37,25,59,5.5,14,7,7,50,3.4,73231,79,http://content9.flixster.com/movie/10/86/18/10861899_det.jpg
2275,Six-String Samurai,1998,sixstring_samurai,6,20,12,8,60,0,1,0,1,0,3.7,2140,75,http://content9.flixster.com/movie/25/85/258595_det.jpg
2276,A Soldier's Daughter Never Cries,1998,soldiers_daughter_never_cries,7,24,19,5,79,7.3,7,5,2,71,3.4,482,62,http://content8.flixster.com/movie/28/35/283598_det.jpg
2278,Ronin,1998,ronin,6.3,60,41,19,68,5.8,14,8,6,57,3.5,26379,76,http://content6.flixster.com/movie/26/94/269492_det.jpg
2279,Urban Legend,1998,urban_legend,4.3,48,10,38,20,4.1,12,2,10,16,2.7,15231,46,http://content6.flixster.com/movie/27/43/274304_det.jpg
2280,Clay Pigeons,1998,clay_pigeons,6.2,51,32,19,62,5,10,2,8,20,3.4,2336,67,http://content7.flixster.com/movie/10/93/49/10934953_det.jpg
2281,Snitch,1998,monument_ave,7,19,17,2,89,0,4,4,0,100,3.3,386,58,http://content6.flixster.com/movie/27/90/279024_det.jpg
2282,Pecker,1998,pecker,5.7,43,23,20,53,4.7,6,1,5,16,3.2,3201,63,http://content9.flixster.com/movie/10/03/99/10039927_det.jpg
2283,The Sheltering Sky,1990,sheltering_sky,5.2,22,10,12,45,5,7,3,4,42,3.8,1679,79,http://content7.flixster.com/movie/10/87/41/10874153_det.jpg
2284,Bandit Queen,1994,bandit_queen,7.5,25,25,0,100,7.6,10,10,0,100,3.6,1049,72,http://content6.flixster.com/movie/30/97/309708_det.jpg
2285,If....,1968,if1968,7.9,30,29,1,96,0,4,3,1,75,4.1,2971,88,http://content6.flixster.com/movie/32/05/41/3205416_det.jpg
2286,The Fiendish Plot of Dr. Fu Manchu,1980,fiendish_plot_of_dr_fu_manchu,3.6,10,2,8,20,0,1,0,1,0,3,277,45,http://content6.flixster.com/movie/10/90/09/10900940_det.jpg
2287,Ils,2006,ils,6,50,30,20,60,6,12,6,6,50,3.4,4393,62,http://content8.flixster.com/movie/10/91/34/10913458_det.jpg
2288,The Thing,1982,the-thing-la-cosa,0,0,0,0,0,0,0,0,0,0,0,0,0,http://images.rottentomatoescdn.com/images/defaults/poster_default.gif
2289,The Player,1992,player-the,0,0,0,0,0,0,0,0,0,0,0,0,0,http://images.rottentomatoescdn.com/images/defaults/poster_default.gif
2290,Stardust Memories,1980,stardust_memories,6.6,24,17,7,70,0,4,1,3,25,3.8,2789,80,http://content6.flixster.com/movie/26/09/260912_det.jpg
2291,Edward Scissorhands,1990,edward_scissorhands,7.6,53,48,5,90,6.8,9,7,2,77,3.8,145994,88,http://content9.flixster.com/movie/10/92/33/10923351_det.jpg
2292,Overnight Delivery,1998,overnight-delivery,4.9,7,3,4,42,0,0,0,0,0,0,0,0,http://content9.flixster.com/movie/72/69/77/7269771_det.jpg
2293,Shadrach,1998,shadrach,5.8,16,8,8,50,5,5,0,5,0,3.6,134,59,http://content7.flixster.com/movie/26/58/265825_det.jpg
2294,Antz,1998,antz,7.7,86,82,4,95,7.5,24,23,1,95,2.9,33465,47,http://content8.flixster.com/movie/25/71/257118_det.jpg
2295,Impostor,2001,impostor,3.9,91,19,72,20,3.6,25,4,21,16,3,1418,46,http://content6.flixster.com/movie/10/86/93/10869340_det.jpg
2296,A Night at the Roxbury,1998,night_at_the_roxbury,3.4,54,6,48,11,2.6,11,0,11,0,3.1,27913,67,http://content7.flixster.com/movie/25/48/254893_det.jpg
2297,What Dreams May Come,1998,what_dreams_may_come,5.7,66,36,30,54,5.8,16,9,7,56,3.6,31618,85,http://content6.flixster.com/movie/26/24/262404_det.jpg
2298,Strangeland,1998,strangeland,2.3,16,1,15,6,0,2,0,2,0,3.5,4041,65,http://content9.flixster.com/movie/26/91/269119_det.jpg
2299,The Battle of the Sexes,1959,1001811-battle_of_the_sexes,0,1,1,0,100,0,0,0,0,0,0,0,0,http://content8.flixster.com/movie/10/85/42/10854282_det.jpg
2300,The Producers,2005,producers_the_movie_musical,5.8,150,76,74,50,5,36,10,26,27,3.1,31343,63,http://content7.flixster.com/movie/31/17/311717_det.jpg
2301,History of the World: Part I,1981,history-of-the-world-part-i1981,5.6,25,15,10,60,0,0,0,0,0,0,0,0,http://content6.flixster.com/movie/26/69/266900_det.jpg
2302,My Cousin Vinny,1992,my_cousin_vinny,6.9,38,33,5,86,7,8,6,2,75,0,0,0,http://content6.flixster.com/movie/26/78/267816_det.jpg
2303,Nashville,1975,nashville,8.6,39,37,2,94,9,5,5,0,100,4.1,3090,84,http://content6.flixster.com/movie/28/40/284024_det.jpg
2304,Love Is the Devil: Study for a Portrait of Francis Bacon,1998,artists-of-the-20th-century-francis-bacon,0,0,0,0,0,0,0,0,0,0,0,0,0,http://content8.flixster.com/movie/10/84/61/10846182_det.jpg
2305,Slam,1998,slam,6.8,21,13,8,61,7.2,8,5,3,62,3.9,549,80,http://content6.flixster.com/movie/10/87/44/10874408_det.jpg
2306,Holy Man,1998,holy_man,3.6,49,6,43,12,3.8,12,1,11,8,2.4,3310,30,http://content6.flixster.com/movie/26/48/264896_det.jpg
2307,One Tough Cop,1998,one_tough_cop,4.2,20,5,15,25,4,6,1,5,16,2.8,405,28,http://content9.flixster.com/movie/10/87/67/10876715_det.jpg
2308,Detroit 9000,1973,detroit_9000,5.4,6,1,5,16,0,2,0,2,0,2.9,572,48,http://content9.flixster.com/movie/28/19/281915_det.jpg
2310,The Mighty Ducks,1992,mighty_ducks,3.8,25,2,23,8,3.2,5,0,5,0,3.1,14328,64,http://content7.flixster.com/movie/25/87/258701_det.jpg
2311,2010,1984,2010_the_year_we_make_contact,5.7,25,16,9,64,0,2,2,0,100,3.2,5956,58,http://content7.flixster.com/movie/10/92/01/10920113_det.jpg
2312,Children of a Lesser God,1986,children_of_a_lesser_god,7.1,24,20,4,83,0,1,1,0,100,3.6,2089,76,http://content8.flixster.com/movie/27/05/270510_det.jpg
2313,The Elephant Man,1980,1006527-elephant_man,8.2,33,30,3,90,0,4,2,2,50,3.9,16869,90,http://content8.flixster.com/movie/10/86/50/10865070_det.jpg
2314,Beloved,1998,1057370-beloved,7.1,66,51,15,77,7.3,24,20,4,83,3.3,2521,68,http://content8.flixster.com/movie/26/97/269718_det.jpg
2315,Bride of Chucky,1998,bride_of_chucky,5.3,30,13,17,43,0,4,1,3,25,2.6,20874,52,http://content7.flixster.com/movie/27/67/276717_det.jpg
2316,Practical Magic,1998,practical_magic,4.4,54,11,43,20,3.7,15,1,14,6,3.2,24912,73,http://content7.flixster.com/movie/10/88/77/10887761_det.jpg
2317,Life During Wartime,1997,alarmist,5.6,11,6,5,54,0,1,0,1,0,0,0,0,http://content6.flixster.com/movie/10/85/12/10851272_det.jpg
2318,Happiness,1998,1084175-happiness,7.9,44,37,7,84,7.8,9,7,2,77,4,11088,88,http://content8.flixster.com/movie/28/63/286314_det.jpg
2319,Reach the Rock,1998,reach_the_rock,4.5,8,3,5,37,0,1,0,1,0,3.4,22,60,http://content6.flixster.com/movie/10/87/70/10877068_det.jpg
2320,Apt Pupil,1998,apt_pupil,6,55,29,26,52,5.5,14,7,7,50,3.1,5334,57,http://content8.flixster.com/movie/27/24/272414_det.jpg
2321,Pleasantville,1998,pleasantville,7.5,82,70,12,85,6.9,22,16,6,72,3.3,22512,73,http://content7.flixster.com/movie/63/98/91/6398913_det.jpg
2322,Soldier,1998,1083934-soldier,3.5,50,5,45,10,3.6,15,2,13,13,2.8,5503,46,http://content9.flixster.com/movie/26/95/269595_det.jpg
2323,Valkyrie,2008,valkyrie,6,185,113,72,61,6,37,22,15,59,3.5,113378,66,http://content9.flixster.com/movie/10/86/48/10864803_det.jpg
2324,La vita √® bella,1997,1084398-life_is_beautiful,7.5,84,66,18,78,5.7,16,9,7,56,4.3,65601,96,http://content7.flixster.com/movie/53/81/55/5381553_det.jpg
2325,Orgazmo,1997,orgazmo,5.1,32,15,17,46,4.1,7,1,6,14,3.2,9287,66,http://content6.flixster.com/movie/10/54/78/10547824_det.jpg
2326,Shattered Image,1998,shattered_image,4.8,14,4,10,28,0,4,0,4,0,0,0,0,http://content6.flixster.com/movie/10/98/13/10981364_det.jpg
2327,Tales from the Darkside: The Movie,1990,tales_from_the_darkside_the_movie,4.5,14,5,9,35,0,3,1,2,33,3.1,2283,49,http://content7.flixster.com/movie/10/84/02/10840229_det.jpg
2328,Interview with the Vampire: The Vampire Chronicles,1994,interview_with_the_vampire,5.8,45,26,19,57,4.6,10,4,6,40,3.7,77706,85,http://content6.flixster.com/movie/28/01/280124_det.jpg
2329,American History X,1998,american_history_x,7.2,72,60,12,83,6.6,21,15,6,71,4.2,140060,96,http://content9.flixster.com/movie/10/85/69/10856931_det.jpg
2330,Hands on a Hard Body: The Documentary,1997,hands_on_a_hard_body,7.1,19,16,3,84,6.8,6,6,0,100,4.1,320,89,http://content6.flixster.com/movie/26/62/266204_det.jpg
2331,Living Out Loud,1998,living_out_loud,6.3,31,18,13,58,5.8,7,3,4,42,3.4,845,60,http://content6.flixster.com/movie/10/87/03/10870304_det.jpg
2332,Belly,1998,belly,3.9,15,2,13,13,0,2,0,2,0,3.9,6432,86,http://content9.flixster.com/movie/10/91/60/10916003_det.jpg
2333,Gods and Monsters,1998,gods_and_monsters,8.4,48,46,2,95,8.5,9,8,1,88,3.7,3109,80,http://content6.flixster.com/movie/10/89/49/10894936_det.jpg
2334,The Siege,1998,1085113-siege,5.8,59,26,33,44,5,13,4,9,30,3.1,8405,56,http://content9.flixster.com/movie/28/38/283891_det.jpg
2335,The Waterboy,1998,waterboy,4.6,72,23,49,31,3.8,17,4,13,23,3.4,79240,74,http://content7.flixster.com/movie/25/44/254405_det.jpg
2336,Elizabeth,1998,1084153-elizabeth,7.3,47,38,9,80,8.3,9,9,0,100,3.8,19341,86,http://content7.flixster.com/movie/10/83/89/10838937_det.jpg
2337,Velvet Goldmine,1998,velvet_goldmine,6.5,38,21,17,55,5.7,5,1,4,20,3.7,10467,80,http://content9.flixster.com/movie/69/65/48/6965487_det.jpg
2338,I Still Know What You Did Last Summer,1998,i_still_know_what_you_did_last_summer,3.3,53,4,49,7,3.9,11,2,9,18,2.6,19948,42,http://content7.flixster.com/movie/10/89/02/10890281_det.jpg
2339,I'll Be Home for Christmas,1998,1088110-ill_be_home_for_christmas,3.9,40,7,33,17,3.5,16,2,14,12,2.6,3438,46,http://content7.flixster.com/movie/26/44/264429_det.jpg
2340,Meet Joe Black,1998,meet_joe_black,5.6,36,18,18,50,5.6,5,2,3,40,3.4,38972,80,http://content6.flixster.com/movie/26/64/266412_det.jpg
2341,Dancing at Lughnasa,1998,dancing_at_lughnasa,6.1,31,20,11,64,6.5,5,2,3,40,3.4,869,59,http://content8.flixster.com/movie/10/94/53/10945390_det.jpg
2342,Hard Core Logo,1996,hard-core-logo,6.4,12,8,4,66,0,4,4,0,100,0,0,0,http://content6.flixster.com/movie/51/27/99/5127996_det.jpg
2343,The Naked Man,1998,naked_man,4.9,5,1,4,20,0,0,0,0,0,0,0,0,http://content6.flixster.com/movie/10/92/02/10920280_det.gif
2344,Runaway Train,1985,runaway_train,7.1,27,23,4,85,0,4,3,1,75,3.5,1615,71,http://content6.flixster.com/movie/27/34/273496_det.jpg
2345,Desert Bloom,1986,desert_bloom,7,9,7,2,77,0,1,0,1,0,0,0,0,http://content6.flixster.com/movie/10/88/94/10889464_det.jpg
2346,The Stepford Wives,2004,stepford_wives,4.7,163,43,120,26,4.9,37,11,26,29,2.6,14476,36,http://content6.flixster.com/movie/25/84/258412_det.jpg
2347,The Pope of Greenwich Village,1984,pope_of_greenwich_village,7.4,9,8,1,88,0,1,1,0,100,3.5,970,68,http://content8.flixster.com/movie/10/91/54/10915474_det.jpg
2348,Sid and Nancy,1986,sid_and_nancy,7.3,31,28,3,90,7.4,7,6,1,85,3.5,6365,75,http://content6.flixster.com/movie/28/34/283412_det.jpg
2349,Mona Lisa Smile,2003,mona_lisa_smile,4.9,147,51,96,34,5.2,41,18,23,43,3.1,23577,61,http://content9.flixster.com/movie/25/59/255923_det.jpg
2350,Heart Condition,1990,heart_condition,3.3,7,0,7,0,0,2,0,2,0,2.9,842,43,http://content7.flixster.com/movie/89/73/70/8973709_det.jpg
2351,Le notti di Cabiria,1957,nights_of_cabiria,8.7,35,34,1,97,8.4,11,11,0,100,4.4,3465,94,http://content7.flixster.com/movie/29/88/298801_det.jpg
2352,The Big Chill,1983,big_chill,6.1,31,21,10,67,5.5,6,3,3,50,3.6,4386,79,http://content7.flixster.com/movie/26/86/268601_det.jpg
2353,Enemy of the State,1998,enemy_of_the_state,6.4,81,57,24,70,6.2,20,13,7,65,3.5,34766,76,http://content9.flixster.com/movie/10/87/15/10871599_det.jpg
2354,The Rugrats Movie,1998,rugrats_movie,5.8,47,27,20,57,6.4,11,7,4,63,2.8,6870,42,http://content7.flixster.com/movie/11/13/75/11137533_det.jpg
2355,A Bug's Life,1998,bugs_life,7.9,80,73,7,91,7.5,18,17,1,94,3.3,64405,61,http://content9.flixster.com/movie/10/93/89/10938947_det.jpg
2356,Celebrity,1998,1084868-celebrity,5.6,37,15,22,40,5.6,5,1,4,20,3,3241,42,http://content7.flixster.com/movie/27/63/276393_det.jpg
2357,Central do Brasil,1998,central-do-brasil-central-station,7.9,48,45,3,93,8.1,13,12,1,92,4.2,3839,93,http://content9.flixster.com/movie/10/87/55/10875583_det.jpg
2358,Savior,1998,savior,6.8,8,5,3,62,0,2,1,1,50,3.7,947,78,http://content8.flixster.com/movie/27/46/274602_det.jpg
2359,Waking Ned,1998,waking_ned_devine,7,57,47,10,82,7,13,11,2,84,3.6,4612,85,http://content8.flixster.com/movie/10/87/79/10877990_det.jpg
2360,Festen,1998,1094723-celebration,8,36,33,3,91,8.3,5,5,0,100,4.3,5434,95,http://content7.flixster.com/movie/28/06/35/2806353_det.jpg
2361,Pink Flamingos,1972,pink_flamingos,6.6,35,28,7,80,0,4,2,2,50,3.6,4901,74,http://content9.flixster.com/movie/11/15/26/11152651_det.jpg
2362,Glen or Glenda,1953,glen_or_glenda,3.6,22,7,15,31,0,1,0,1,0,2.6,1851,35,http://content9.flixster.com/movie/11/15/29/11152907_det.gif
2363,Gojira,1954,gojira,7.6,57,53,4,92,7.5,17,15,2,88,4.1,2309,86,http://content7.flixster.com/movie/24/83/54/2483545_det.jpg
2364,Godzilla,1998,godzilla,4.7,59,15,44,25,5.7,9,3,6,33,2.6,17658,38,http://content9.flixster.com/movie/25/99/259919_det.jpg
2365,Kingu Kongu tai Gojira,1962,king-kong-vs-godzilla,4.4,11,4,7,36,0,1,0,1,0,3.1,2636,49,http://content9.flixster.com/movie/10/93/36/10933603_det.jpg
2366,King Kong,2005,king_kong,7.7,242,202,40,83,7.6,39,30,9,76,2.8,207337,52,http://content8.flixster.com/movie/10/93/36/10933606_det.jpg
2367,King Kong,2005,king_kong,7.7,242,202,40,83,7.6,39,30,9,76,2.8,207337,52,http://content8.flixster.com/movie/10/93/36/10933606_det.jpg
2368,King Kong Lives,1986,king_kong_lives,1.6,9,0,9,0,0,2,0,2,0,2.7,5069,37,http://content6.flixster.com/movie/10/93/36/10933604_det.jpg
2369,Desperately Seeking Susan,1985,desperately_seeking_susan,6.7,23,20,3,86,0,3,3,0,100,2.8,3449,55,http://content9.flixster.com/movie/10/85/87/10858779_det.jpg
2370,The Emerald Forest,1985,emerald_forest,7.2,15,13,2,86,0,0,0,0,0,0,0,0,http://content8.flixster.com/movie/10/87/04/10870434_det.jpg
2371,Fletch,1985,fletch,6.4,28,21,7,75,0,4,3,1,75,3.3,6895,78,http://content7.flixster.com/movie/25/49/254921_det.jpg
2372,Fletch Lives,1989,fletch_lives,4.1,13,4,9,30,0,1,0,1,0,2.9,2636,53,http://content6.flixster.com/movie/10/22/09/10220968_det.jpg
2373,Red Sonja,2011,1200704-red_sonja,0,0,0,0,0,0,0,0,0,0,0,0,0,http://content6.flixster.com/movie/10/89/27/10892708_det.jpg
2374,Gung Ho,1986,1009058-gung_ho,5.3,14,6,8,42,0,1,0,1,0,3,1121,45,http://content8.flixster.com/movie/25/77/257706_det.jpg
2375,The Money Pit,1986,money_pit,4.8,19,9,10,47,0,1,0,1,0,3,7189,59,http://content8.flixster.com/movie/10/88/20/10882090_det.jpg
2376,A View to a Kill,1985,view_to_a_kill,4.8,41,16,25,39,3.6,5,0,5,0,3.1,12502,49,http://content7.flixster.com/movie/10/84/49/10844985_det.jpg
2377,Lifeforce,1985,lifeforce,5.4,14,8,6,57,0,0,0,0,0,0,0,0,http://content7.flixster.com/movie/27/01/270125_det.jpg
2378,Police Academy,1984,police_academy,4.6,15,7,8,46,0,0,0,0,0,0,0,0,http://content9.flixster.com/movie/55/35/80/5535807_det.jpg
2379,Police Academy 2: Their First Assignment,1985,police_academy_2_their_first_assignment,3.1,13,3,10,23,0,0,0,0,0,0,0,0,http://content6.flixster.com/movie/63/13/98/6313984_det.jpg
2380,Police Academy 3: Back in Training,1986,police_academy_3_back_in_training,4.2,10,4,6,40,0,1,1,0,100,2.8,6533,49,http://content9.flixster.com/movie/10/92/26/10922667_det.jpg
2381,Police Academy 4: Citizens on Patrol,1987,police_academy_4_citizens_on_patrol,2.4,18,0,18,0,0,3,0,3,0,2.7,6328,46,http://content6.flixster.com/movie/74/31/04/7431048_det.jpg
2382,Police Academy 5: Assignment: Miami Beach,1988,police_academy_5_assignment_miami_beach,0,2,0,2,0,0,0,0,0,0,0,0,0,http://content9.flixster.com/movie/74/32/49/7432491_det.jpg
2383,Police Academy 6: City Under Siege,1989,police_academy_6_city_under_siege,1.2,7,0,7,0,0,0,0,0,0,0,0,0,http://content9.flixster.com/movie/10/87/13/10871319_det.jpg
2384,Babe: Pig in the City,1998,babe_pig_in_the_city,6.2,58,35,23,60,5.8,14,8,6,57,2.8,9741,45,http://content6.flixster.com/movie/10/88/34/10883432_det.jpg
2385,Home Fries,1998,home_fries,4.8,35,11,24,31,4.4,6,1,5,16,2.5,4100,34,http://content8.flixster.com/movie/26/35/263598_det.jpg
2386,Ringmaster,1998,ringmaster,3,23,5,18,21,0,4,1,3,25,2.1,443,19,http://content9.flixster.com/movie/28/53/285323_det.jpg
2387,Very Bad Things,1998,very_bad_things,5.6,50,22,28,44,5.1,12,3,9,25,3,5484,57,http://content9.flixster.com/movie/55/04/79/5504799_det.jpg
2388,Hamam,1997,steam_the_turkish_bath,6.3,16,13,3,81,6.4,5,3,2,60,3.7,781,75,http://content6.flixster.com/movie/10/88/94/10889472_det.jpg
2389,Psycho,1960,psycho,8.9,67,66,1,98,7.5,8,7,1,87,3.9,32475,90,http://content7.flixster.com/movie/68/89/78/6889781_det.jpg
2390,Little Voice,1998,little_voice,7.2,35,29,6,82,7.3,7,5,2,71,3.4,2979,68,http://content7.flixster.com/movie/27/33/273305_det.jpg
2391,A Simple Plan,1998,simple_plan,8.1,51,46,5,90,8.2,8,7,1,87,3.4,7546,74,http://content8.flixster.com/movie/27/20/272022_det.jpg
2392,Jack Frost,1998,1090089-jack_frost,3.8,47,7,40,14,4,14,3,11,21,2.8,6973,48,http://content7.flixster.com/movie/45/04/450445_det.jpg
2393,Star Trek: Insurrection,1998,star_trek_insurrection,5.8,64,35,29,54,6.7,12,9,3,75,3.1,13225,53,http://content8.flixster.com/movie/10/88/85/10888598_det.jpg
2394,The Prince of Egypt,1998,prince_of_egypt,7,82,64,18,78,6.7,25,18,7,72,3.1,16105,67,http://content6.flixster.com/movie/10/61/21/10612176_det.jpg
2395,Rushmore,1998,rushmore,7.8,82,71,11,86,7.4,17,13,4,76,3.7,34168,91,http://content8.flixster.com/movie/10/84/17/10841706_det.jpg
2396,Shakespeare in Love,1998,shakespeare_in_love,8.1,101,94,7,93,8,25,23,2,92,3.3,30161,76,http://content9.flixster.com/movie/27/61/276127_det.jpg
2397,Mass Appeal,1984,mass_appeal,0,2,2,0,100,0,0,0,0,0,0,0,0,http://content6.flixster.com/movie/19/57/91/1957912_det.jpg
2398,Miracle on 34th Street,1947,1013970-miracle_on_34th_street,8,31,29,2,93,0,2,2,0,100,3.5,5409,81,http://content7.flixster.com/movie/29/05/290513_det.jpg
2399,Santa Claus,1985,santa_claus_the_movie,4.1,17,3,14,17,0,1,0,1,0,3.1,2513,66,http://content7.flixster.com/movie/25/49/254909_det.jpg
2400,Prancer,1989,prancer,6,16,11,5,68,0,3,2,1,66,3,1515,53,http://content6.flixster.com/movie/25/12/251296_det.jpg
2401,Pale Rider,1985,pale_rider,7.3,24,22,2,91,0,4,3,1,75,3.6,8286,78,http://content9.flixster.com/movie/26/87/268795_det.jpg
2402,Rambo: First Blood Part II,1985,rambo-first-blood-part-ii,4.1,30,9,21,30,0,2,0,2,0,3.1,18865,63,http://content8.flixster.com/movie/11/13/69/11136978_det.jpg
2403,First Blood,1982,first_blood,7.1,35,30,5,85,6.2,5,4,1,80,3.5,23595,81,http://content6.flixster.com/movie/11/13/69/11136980_det.jpg
2404,Rambo III,1988,rambo_iii,4.6,28,10,18,35,0,4,2,2,50,2.9,16200,51,http://content6.flixster.com/movie/28/42/284216_det.jpg
2405,The Jewel of the Nile,1985,jewel_of_the_nile,4.9,19,9,10,47,0,1,1,0,100,3,7338,45,http://content7.flixster.com/movie/25/81/258117_det.jpg
2406,Romancing the Stone,1984,romancing_the_stone,7,42,36,6,85,0,4,1,3,25,3.2,14494,62,http://content6.flixster.com/movie/24/63/50/2463504_det.jpg
2407,Cocoon,1985,cocoon,6.1,23,18,5,78,0,4,3,1,75,3.1,7543,55,http://content6.flixster.com/movie/25/91/259100_det.jpg
2408,Cocoon: The Return,1988,cocoon_2_the_return,4.6,10,3,7,30,0,1,0,1,0,2.7,2029,37,http://content7.flixster.com/movie/26/09/260925_det.jpg
2409,Rocky II,1979,rocky_ii,6.4,23,16,7,69,0,3,2,1,66,3.4,51625,79,http://content9.flixster.com/movie/10/65/79/10657999_det.jpg
2410,Rocky III,1982,rocky_iii,5.4,29,18,11,62,0,2,1,1,50,3.3,48532,74,http://content7.flixster.com/movie/26/42/264213_det.jpg
2411,Rocky IV,1985,rocky_iv,4.7,34,15,19,44,0,4,0,4,0,3.4,53876,79,http://content7.flixster.com/movie/26/13/261393_det.jpg
2412,Rocky V,1990,rocky_v,4,29,7,22,24,3.9,5,2,3,40,2.8,34216,53,http://content6.flixster.com/movie/26/67/266728_det.jpg
2413,Clue,1985,clue,6.2,19,14,5,73,0,2,0,2,0,3.6,16850,85,http://content9.flixster.com/movie/10/84/07/10840775_det.jpg
2414,Young Sherlock Holmes,1985,young_sherlock_holmes,5.6,19,12,7,63,0,1,1,0,100,3.3,2485,63,http://content8.flixster.com/movie/11/14/28/11142866_det.jpg
2415,Violets Are Blue...,1986,violets_are_blue,5.3,7,4,3,57,0,1,1,0,100,3.4,93,39,http://content7.flixster.com/movie/99/32/54/9932549_det.jpg
2416,Back to School,1986,back-to-school,6.8,24,21,3,87,0,3,3,0,100,2.9,3814,60,http://content6.flixster.com/movie/74/28/48/7428484_det.jpg
2417,Heartburn,1986,heartburn,5.7,11,7,4,63,0,1,0,1,0,3.2,1466,52,http://content9.flixster.com/movie/27/30/273011_det.jpg
2418,Nothing in Common,1986,nothing_in_common,5.8,18,10,8,55,0,1,0,1,0,2.8,1198,38,http://content9.flixster.com/movie/26/21/262127_det.jpg
2419,Extremities,1986,extremities,5.9,7,4,3,57,0,0,0,0,0,0,0,0,http://content7.flixster.com/movie/27/74/277409_det.jpg
2420,The Karate Kid,1984,karate_kid,6.9,41,37,4,90,6.9,5,4,1,80,3.3,20688,71,http://content7.flixster.com/movie/11/12/21/11122169_det.jpg
2421,"The Karate Kid, Part II",1986,karate_kid_part_2,4.8,20,8,12,40,0,0,0,0,0,0,0,0,http://content9.flixster.com/movie/11/12/21/11122167_det.jpg
2422,"The Karate Kid, Part III",1989,karate_kid_part_iii,4.1,17,4,13,23,0,2,0,2,0,2.8,9109,46,http://content8.flixster.com/movie/11/12/21/11122166_det.jpg
2423,Christmas Vacation,1989,national_lampoons_christmas_vacation,6.2,34,21,13,61,6,5,2,3,40,3.5,21650,83,http://content9.flixster.com/movie/11/13/24/11132419_det.jpg
2424,You've Got Mail,1998,youve_got_mail,6.2,75,51,24,68,6.4,20,15,5,75,3.1,60706,70,http://content9.flixster.com/movie/25/38/253811_det.jpg
2425,The General,1926,1008166-general,8.9,38,35,3,92,0,4,2,2,50,4.4,3785,93,http://content6.flixster.com/movie/10/84/02/10840232_det.jpg
2426,The Theory of Flight,1998,theory_of_flight,5.6,19,10,9,52,5.1,5,1,4,20,3.5,345,63,http://content7.flixster.com/movie/10/88/46/10884673_det.jpg
2427,The Thin Red Line,1998,1084146-thin_red_line,7.1,80,63,17,78,7.5,22,21,1,95,3.4,27248,75,http://content7.flixster.com/movie/10/86/75/10867513_det.jpg
2428,The Faculty,1998,faculty,5.6,37,19,18,51,0,3,0,3,0,2.9,14071,55,http://content8.flixster.com/movie/27/10/271018_det.jpg
2429,Mighty Joe Young,1998,1084582-mighty_joe_young,5.8,42,22,20,52,7.2,5,4,1,80,2.8,10755,48,http://content6.flixster.com/movie/59/50/68/5950684_det.jpg
2430,Mighty Joe Young,1998,1084582-mighty_joe_young,5.8,42,22,20,52,7.2,5,4,1,80,2.8,10755,48,http://content6.flixster.com/movie/59/50/68/5950684_det.jpg
2431,Patch Adams,1998,patch_adams,4,55,13,42,23,3.8,16,4,12,25,3.3,20869,77,http://content9.flixster.com/movie/26/67/266723_det.jpg
2432,Stepmom,1998,stepmom,5.1,53,23,30,43,5.3,17,8,9,47,3.3,22696,75,http://content8.flixster.com/movie/25/55/255514_det.jpg
2433,A Civil Action,1998,civil_action,6.4,66,40,26,60,5.8,13,7,6,53,3.1,3573,53,http://content6.flixster.com/movie/25/60/256024_det.jpg
2434,Down in the Delta,1998,down_in_the_delta,6.8,22,17,5,77,7.4,6,5,1,83,3.6,434,68,http://content8.flixster.com/movie/10/88/75/10887554_det.jpg
2435,Hurlyburly,1998,hurlyburly,5.9,34,20,14,58,5.2,6,2,4,33,3.2,1455,56,http://content6.flixster.com/movie/27/49/274920_det.jpg
2436,Tea with Mussolini,1999,tea_with_mussolini,6.4,33,22,11,66,6.3,6,3,3,50,3.5,1769,72,http://content9.flixster.com/movie/25/77/257719_det.jpg
2437,Wilde,1997,,\N,\N,\N,\N,\N,\N,\N,\N,\N,\N,\N,\N,\N,\N
2439,Affliction,1997,affliction,7.6,44,38,6,86,8.8,7,7,0,100,3.4,1078,69,http://content6.flixster.com/movie/28/23/282312_det.jpg
2440,Another Day in Paradise,1998,1084699-another_day_in_paradise,5.7,46,26,20,56,6.1,12,7,5,58,3.2,1703,57,http://content8.flixster.com/movie/28/72/287214_det.jpg
2441,The Hi-Lo Country,1998,hilo_country,5.4,34,19,15,55,4.9,15,6,9,40,3.1,620,43,http://content7.flixster.com/movie/28/32/283293_det.jpg
2442,Hilary and Jackie,1998,hilary_and_jackie,7.5,43,38,5,88,7.9,13,12,1,92,3.7,1702,81,http://content7.flixster.com/movie/28/50/285029_det.jpg
2443,Playing by Heart,1998,playing_by_heart,6,51,32,19,62,6,12,6,6,50,3.6,5334,76,http://content6.flixster.com/movie/26/79/267924_det.jpg
2444,24 7: Twenty Four Seven,1997,twentyfourseven,5.7,20,7,13,35,5.6,5,1,4,20,3.9,451,84,http://content8.flixster.com/movie/10/87/22/10872274_det.jpg
2445,At First Sight,1999,1084607-at_first_sight,5.2,36,12,24,33,5.4,6,1,5,16,2.9,2599,48,http://content9.flixster.com/movie/10/88/64/10886407_det.jpg
2446,Requiem for a Dream,2000,requiem_for_a_dream,7.4,127,99,28,77,6.6,32,21,11,65,4.1,103666,93,http://content9.flixster.com/movie/29/00/290095_det.jpg
2447,Varsity Blues,1999,varsity_blues,5,51,20,31,39,5,13,5,8,38,3.2,17053,75,http://content8.flixster.com/movie/26/83/268322_det.jpg
2448,Virus,1999,1085867-virus,3.2,44,4,40,9,2.8,13,1,12,7,2.4,2719,26,http://content8.flixster.com/movie/10/92/06/10920690_det.jpg
2449,The Garbage Pail Kids Movie,1987,garbage_pail_kids_movie,1.9,11,0,11,0,0,1,0,1,0,2.6,1589,37,http://content6.flixster.com/movie/25/52/255220_det.jpg
2450,Howard the Duck,1986,howard_the_duck,2.5,32,5,27,15,0,3,0,3,0,2.6,7309,43,http://content6.flixster.com/movie/10/86/80/10868032_det.jpg
2451,The Ninth Gate,1999,ninth_gate,4.9,85,35,50,41,4,24,6,18,25,3.2,23993,60,http://content8.flixster.com/movie/26/73/267302_det.jpg
2452,The Gate II: Trespassers,1990,gate_2_return_to_the_nightmare,0,0,0,0,0,0,0,0,0,0,0,0,0,http://content7.flixster.com/movie/10/83/87/10838773_det.jpg
2453,The Boy Who Could Fly,1986,boy_who_could_fly,5.9,16,11,5,68,0,1,1,0,100,3.2,1754,63,http://content8.flixster.com/movie/26/06/260626_det.jpg
2454,The Fly,1986,1007602-fly,8,44,40,4,90,0,3,1,2,33,3.3,14099,74,http://content7.flixster.com/movie/11/15/27/11152781_det.jpg
2455,The Fly,1986,1007602-fly,8,44,40,4,90,0,3,1,2,33,3.3,14099,74,http://content7.flixster.com/movie/11/15/27/11152781_det.jpg
2456,The Fly II,1989,fly_ii,4.4,15,4,11,26,0,0,0,0,0,0,0,0,http://content8.flixster.com/movie/55/37/20/5537202_det.jpg
2457,Running Scared,2006,10004288-running_scared,4.5,128,51,77,39,4.4,31,10,21,32,3.6,35992,77,http://content8.flixster.com/movie/31/27/312798_det.jpg
2458,Armed and Dangerous,1986,1001180-armed_and_dangerous,3,7,1,6,14,0,0,0,0,0,0,0,0,http://content7.flixster.com/movie/26/07/260713_det.jpg
2459,The Texas Chainsaw Massacre,2003,texas_chainsaw_massacre,4.8,152,55,97,36,4.2,33,6,27,18,3.2,36030,67,http://content7.flixster.com/movie/11/13/31/11133149_det.jpg
2460,The Texas Chainsaw Massacre 2,1986,texas_chainsaw_massacre_2,4.6,21,9,12,42,0,2,0,2,0,2.9,8495,51,http://content8.flixster.com/movie/11/13/31/11133146_det.jpg
2461,Leatherface: Texas Chainsaw Massacre III,1990,leatherface_the_texas_chainsaw_massacre_3,3.4,14,2,12,14,0,1,0,1,0,2.9,6411,52,http://content6.flixster.com/movie/11/13/31/11133160_det.jpg
2462,The Return of the Texas Chainsaw Massacre,1994,texas_chainsaw_massacre_the_next_generation,3.2,28,4,24,14,0,4,0,4,0,2.4,5539,34,http://content6.flixster.com/movie/11/13/31/11133148_det.jpg
2463,Ruthless People,1986,ruthless_people,6.7,21,19,2,90,0,1,1,0,100,3.1,3852,62,http://content6.flixster.com/movie/26/87/268720_det.jpg
2464,Trick 'r Treat,2007,trick_r_treat,7.5,20,17,3,85,0,1,1,0,100,3.5,15410,67,http://content8.flixster.com/movie/10/85/55/10855534_det.jpg
2465,Deadly Friend,1986,deadly_friend,3.7,6,0,6,0,0,0,0,0,0,0,0,0,http://content6.flixster.com/movie/10/89/00/10890048_det.jpg
2466,Belizaire the Cajun,1986,belizaire_the_cajun,6.2,6,4,2,66,0,1,1,0,100,3.6,147,63,http://content7.flixster.com/movie/10/02/08/10020865_det.jpg
2467,Der Name der Rose,1986,name_of_the_rose,6.2,18,13,5,72,0,1,0,1,0,3.6,8830,83,http://content6.flixster.com/movie/10/87/20/10872096_det.jpg
2468,Jumpin' Jack Flash,1986,jumpin_jack_flash,3.9,18,5,13,27,0,1,0,1,0,2.8,4253,55,http://content6.flixster.com/movie/26/81/268196_det.jpg
2469,Peggy Sue Got Married,1986,peggy_sue_got_married,6.8,24,21,3,87,6.8,7,5,2,71,2.9,5428,47,http://content9.flixster.com/movie/10/88/36/10883627_det.jpg
2470,Crocodile Dundee,1986,crocodile_dundee,6.6,26,23,3,88,0,2,1,1,50,3,11828,55,http://content7.flixster.com/movie/25/53/255309_det.jpg
2471,'Crocodile' Dundee II,1988,crocodile_dundee_2,3.6,21,3,18,14,0,0,0,0,0,0,0,0,http://content8.flixster.com/movie/25/68/256818_det.jpg
2472,Tough Guys Don't Dance,1987,tough_guys_dont_dance,4.9,18,7,11,38,0,4,2,2,50,3.3,251,49,http://content7.flixster.com/movie/10/27/21/10272101_det.jpg
2473,Soul Man,1986,soul_man,3,22,3,19,13,0,4,1,3,25,2.6,1023,37,http://content9.flixster.com/movie/10/92/10/10921031_det.jpg
2474,The Color of Money,1986,color_of_money,7.3,34,31,3,91,6.8,8,6,2,75,3.3,8226,65,http://content7.flixster.com/movie/26/80/268025_det.jpg
2475,52 Pick-Up,1986,52_pickup,5.8,10,5,5,50,0,1,1,0,100,3.1,248,48,http://content9.flixster.com/movie/74/16/65/7416651_det.jpg
2476,Heartbreak Ridge,1986,heartbreak_ridge,6.7,13,11,2,84,0,1,1,0,100,3.5,4368,73,http://content6.flixster.com/movie/26/87/268724_det.jpg
2477,Firewalker,1986,firewalker,3,10,0,10,0,0,4,0,4,0,2.8,1109,41,http://content7.flixster.com/movie/25/99/259913_det.jpg
2478,¬°Three Amigos!,1986,1021312-three_amigos,5.2,17,9,8,52,0,1,0,1,0,3.1,12978,65,http://content7.flixster.com/movie/25/45/254593_det.jpg
2479,Gloria,1999,1085275-gloria,4.1,27,5,22,18,5.1,6,1,5,16,2.7,660,31,http://content8.flixster.com/movie/28/25/282502_det.jpg
2480,Nettoyage √† sec,1997,dry_cleaning,6.6,15,12,3,80,0,2,2,0,100,3.1,198,46,http://content7.flixster.com/movie/29/00/290097_det.jpg
2481,My Name Is Joe,1998,my_name_is_joe,7.3,23,20,3,86,8.1,5,5,0,100,3.8,1146,81,http://content8.flixster.com/movie/10/92/00/10920026_det.jpg
2482,Still Crazy,1998,still_crazy,6.5,25,18,7,72,7,6,4,2,66,3.8,1495,81,http://content7.flixster.com/movie/27/17/271701_det.jpg
2483,El d√≠a de la bestia,1995,el-dia-de-la-bestia-the-day-of-the-beast,6.7,9,7,2,77,0,0,0,0,0,0,0,0,http://content8.flixster.com/movie/10/88/29/10882962_det.jpg
2485,She's All That,1999,shes_all_that,4.9,55,21,34,38,4.8,12,3,9,25,3,53730,60,http://content9.flixster.com/movie/25/70/257015_det.jpg
2486,The 24 Hour Woman,1999,24_hour_woman,5.8,14,8,6,57,0,4,3,1,75,3.4,50,50,http://content7.flixster.com/movie/10/85/18/10851889_det.jpg
2487,"Blood, Guts, Bullets and Octane",1998,blood_guts_bullets_and_octane,5.4,22,10,12,45,0,3,0,3,0,2.9,645,40,http://content6.flixster.com/movie/10/94/87/10948704_det.jpg
2488,Peeping Tom,1960,peeping-tom,8.2,31,29,2,93,7.2,7,5,2,71,4,3195,85,http://content7.flixster.com/movie/10/93/89/10938985_det.gif
2489,Spanish Fly,1976,,\N,\N,\N,\N,\N,\N,\N,\N,\N,\N,\N,\N,\N,\N
2490,Payback,1999,1087648-payback,5.8,70,36,34,51,5,19,8,11,42,3.2,12940,67,http://content8.flixster.com/movie/26/99/269918_det.jpg
2491,Simply Irresistible,1999,simply_irresistible,4,29,4,25,13,4.9,5,1,4,20,2.9,6203,55,http://content9.flixster.com/movie/10/93/06/10930671_det.jpg
2492,20 Dates,1998,20_dates,4.8,31,12,19,38,3.1,10,0,10,0,0,0,0,http://content6.flixster.com/movie/50/89/30/5089308_det.jpg
2493,Comedian Harmonists,1997,the-harmonists,7,35,28,7,80,7.3,11,9,2,81,3.8,302,84,http://content6.flixster.com/movie/27/39/273912_det.jpg
2494,Last Days,2005,last_days,5.9,111,64,47,57,6,35,23,12,65,3.1,5692,53,http://content8.flixster.com/movie/97/93/84/9793842_det.jpg
2495,La plan√®te sauvage,1973,la-planete-sauvage-the-savage-planet-the-fantastic-planet-planet-of-incredible-creatures,7.1,22,19,3,86,0,2,1,1,50,4,2423,86,http://content8.flixster.com/movie/10/94/96/10949678_det.jpg
2496,Blast from the Past,1999,blast_from_the_past,6.1,35,21,14,60,6.7,5,4,1,80,2.9,12330,54,http://content7.flixster.com/movie/25/55/255505_det.jpg
2497,Message in a Bottle,1999,message_in_a_bottle,5.2,35,11,24,31,6,5,3,2,60,3.2,17649,67,http://content8.flixster.com/movie/25/52/255222_det.jpg
2498,My Favorite Martian,1963,,\N,\N,\N,\N,\N,\N,\N,\N,\N,\N,\N,\N,\N,\N
2499,"God Said, 'Ha!'",1998,god_said_ha,6.9,21,18,3,85,7.6,5,5,0,100,3.4,398,67,http://content8.flixster.com/movie/10/92/08/10920822_det.jpg
2500,Jawbreaker,1999,jawbreaker,3.3,57,4,53,7,3,19,0,19,0,2.8,8386,54,http://content9.flixster.com/movie/27/40/274003_det.jpg
2501,October Sky,1999,october_sky,7.6,70,63,7,90,7.2,14,12,2,85,3.6,12678,84,http://content9.flixster.com/movie/10/90/79/10907951_det.jpg
2502,Office Space,1999,office_space,6.8,88,70,18,79,6.4,24,17,7,70,4,78802,92,http://content6.flixster.com/movie/26/77/267704_det.jpg
2503,Sib,1998,the-apple-sib,7,20,16,4,80,8.2,5,5,0,100,3.7,409,77,http://content6.flixster.com/movie/54/93/28/5493284_det.jpg
2504,200 Cigarettes,1999,200_cigarettes,4.5,57,17,40,29,3.9,19,5,14,26,3,5146,54,http://content9.flixster.com/movie/27/52/275211_det.jpg
2505,8MM,1999,8mm,4.2,78,17,61,21,3.1,21,2,19,9,3,14973,56,http://content6.flixster.com/movie/27/13/271392_det.jpg
2506,The Other Sister,1999,other_sister,4.7,48,14,34,29,4.6,13,4,9,30,3.3,8954,68,http://content9.flixster.com/movie/10/85/05/10850507_det.jpg
2507,Breakfast of Champions,1999,breakfast_of_champions,4.2,44,11,33,25,3.4,13,1,12,7,2.5,1509,31,http://content6.flixster.com/movie/10/88/32/10883264_det.jpg
2508,The Break-Up,2006,break_up,5,187,62,125,33,4.5,40,8,32,20,3.1,107481,52,http://content8.flixster.com/movie/10/89/28/10892870_det.jpg
2509,Eight Days a Week,1997,eight_days_a_week,3.8,9,2,7,22,0,0,0,0,0,0,0,0,http://content9.flixster.com/movie/10/89/50/10895035_det.jpg
2510,Just the Ticket,1999,just_the_ticket,4.5,10,2,8,20,0,3,0,3,0,3,410,41,http://content8.flixster.com/movie/10/87/62/10876210_det.jpg
2511,The Long Goodbye,1973,,8.2,24,23,1,95,0,2,2,0,100,4,2667,88,http://content8.flixster.com/movie/27/12/271202_det.jpg
2512,Narayama-bushi k√¥,1983,ballad_of_narayama,8.2,9,9,0,100,0,1,1,0,100,4.3,634,91,http://content9.flixster.com/movie/54/85/56/5485567_det.jpg
2513,Pet Sematary,1989,pet_sematary,5.2,18,9,9,50,0,0,0,0,0,0,0,0,http://content9.flixster.com/movie/10/89/14/10891447_det.jpg
2514,Pet Sematary II,1992,pet_sematary_ii,4,16,5,11,31,0,0,0,0,0,0,0,0,http://content9.flixster.com/movie/27/33/273307_det.jpg
2515,Children of the Corn II: The Final Sacrifice,1992,children_of_the_corn_ii_the_final_sacrifice,2.3,8,2,6,25,0,1,0,1,0,2.8,2650,39,http://content6.flixster.com/movie/10/91/84/10918488_det.jpg
2516,Children of the Corn III: Urban Harvest,1995,children_of_the_corn_iii_urban_harvest,0,1,0,1,0,0,0,0,0,0,0,0,0,http://content8.flixster.com/movie/10/91/84/10918482_det.jpg
2517,Christine,1983,christine,5.7,21,14,7,66,0,4,1,3,25,3.2,10394,63,http://content7.flixster.com/movie/27/27/272713_det.jpg
2518,Night Shift,1982,night_shift,6.4,19,17,2,89,0,2,1,1,50,3.2,1720,55,http://content7.flixster.com/movie/27/12/271213_det.jpg
2519,House on Haunted Hill,1999,1093881-house_on_haunted_hill,4.4,53,13,40,24,3.5,11,2,9,18,2.9,13288,49,http://content9.flixster.com/movie/10/83/95/10839519_det.jpg
2520,Airport,1970,airport,5.9,13,9,4,69,0,1,0,1,0,3.1,2253,48,http://content8.flixster.com/movie/25/28/252814_det.jpg
2521,Airport 1975,1974,airport_1975,4.8,12,4,8,33,0,1,0,1,0,2.9,1688,36,http://content8.flixster.com/movie/10/86/72/10867214_det.jpg
2522,Airport '77,1977,id-1977,0,0,0,0,0,0,0,0,0,0,0,0,0,http://images.rottentomatoescdn.com/images/defaults/poster_default.gif
2523,Rollercoaster,1977,1017815-rollercoaster,6,6,3,3,50,0,0,0,0,0,0,0,0,http://content9.flixster.com/movie/26/40/264019_det.jpg
2524,The Towering Inferno,1974,towering_inferno,6.4,19,15,4,78,0,1,1,0,100,3.3,4474,67,http://content6.flixster.com/movie/10/91/66/10916636_det.gif
2525,Albino Alligator,1996,albino_alligator,5.5,17,8,9,47,5.4,6,2,4,33,3,1198,42,http://content8.flixster.com/movie/10/83/84/10838426_det.jpg
2526,Meteor,1979,1013772-meteor,3.6,11,1,10,9,0,0,0,0,0,0,0,0,http://content9.flixster.com/movie/98/66/17/9866171_det.jpg
2527,Westworld,1973,westworld,7.1,30,27,3,90,0,3,3,0,100,3.5,4334,68,http://content6.flixster.com/movie/26/56/265600_det.jpg
2528,Logan's Run,1976,logans_run,6.2,27,19,8,70,0,3,2,1,66,3.3,9250,65,http://content8.flixster.com/movie/26/47/264710_det.jpg
2529,Planet of the Apes,1968,1016397-planet_of_the_apes,7.4,44,39,5,88,5.5,5,3,2,60,3.4,12844,80,http://content7.flixster.com/movie/11/14/82/11148265_det.jpg
2530,Beneath the Planet of the Apes,1970,beneath_the_planet_of_the_apes,5.3,22,9,13,40,0,1,0,1,0,3,4261,46,http://content7.flixster.com/movie/10/94/47/10944737_det.jpg
2531,Battle for the Planet of the Apes,1973,battle_for_the_planet_of_the_apes,4.7,24,9,15,37,0,2,0,2,0,2.9,3262,38,http://content9.flixster.com/movie/10/94/47/10944739_det.jpg
2532,Conquest of the Planet of the Apes,1972,conquest_of_the_planet_of_the_apes,5.5,18,8,10,44,0,2,1,1,50,3,3697,49,http://content6.flixster.com/movie/10/94/47/10944736_det.jpg
2533,Escape from the Planet of the Apes,1971,escape_from_the_planet_of_the_apes,5.7,23,18,5,78,0,2,2,0,100,3,3852,49,http://content9.flixster.com/movie/10/94/47/10944735_det.jpg
2534,Avalanche Alley,2001,avalanche_alley,0,0,0,0,0,0,0,0,0,0,0,0,0,http://content8.flixster.com/movie/10/19/87/10198766_det.jpg
2535,10.5,2004,105,0,0,0,0,0,0,0,0,0,0,0,0,0,http://content9.flixster.com/movie/10/92/16/10921679_det.jpg
2536,The Concorde... Airport '79,1979,concorde_airport_79,4.3,5,1,4,20,0,2,1,1,50,2.5,369,23,http://content6.flixster.com/movie/10/86/72/10867212_det.jpg
2537,Beyond the Poseidon Adventure,1979,beyond_the_poseidon_adventure,0,2,0,2,0,0,1,0,1,0,2.7,1212,33,http://content6.flixster.com/movie/10/93/20/10932028_det.jpg
2538,Dancemaker,1998,dancemaker,7.9,10,9,1,90,0,2,2,0,100,0,0,0,http://content9.flixster.com/movie/10/94/54/10945419_det.jpg
2539,Analyze This,1999,analyze_this,6.4,101,69,32,68,6,22,14,8,63,3.1,15881,57,http://content6.flixster.com/movie/27/09/270996_det.jpg
2540,The Corruptor,1999,corruptor,5.3,46,22,24,47,5.7,15,8,7,53,3,2255,43,http://content7.flixster.com/movie/27/57/275717_det.jpg
2541,Cruel Intentions,1999,cruel_intentions,5.3,76,36,40,47,4.7,24,9,15,37,3.4,56824,79,http://content8.flixster.com/movie/11/12/58/11125862_det.jpg
2542,"Lock, Stock and Two Smoking Barrels",1998,,6.8,51,37,14,72,5.9,14,8,6,57,4,81696,92,http://content6.flixster.com/movie/10/51/33/10513304_det.jpg
2543,Six Ways to Sunday,1997,six-ways-to-sunday,4.8,10,4,6,40,0,1,0,1,0,3.3,459,58,http://content6.flixster.com/movie/27/80/278092_det.jpg
2544,L'√©cole de la chair,1998,school_of_flesh,6.1,18,13,5,72,0,4,4,0,100,3.5,272,59,http://content9.flixster.com/movie/28/37/283715_det.jpg
2545,Relax... It's Just Sex,1998,relax_its_just_sex,5.9,16,8,8,50,0,3,2,1,66,3.4,732,64,http://content7.flixster.com/movie/28/36/283605_det.jpg
2546,The Deep End of the Ocean,1999,deep_end_of_the_ocean,5.8,33,14,19,42,5.2,7,1,6,14,3.2,2998,62,http://content9.flixster.com/movie/26/23/262315_det.jpg
2548,The Rage: Carrie 2,1999,a-fit-of-rage,0,0,0,0,0,0,0,0,0,0,0,0,0,http://content9.flixster.com/movie/10/84/85/10848535_det.jpg
2549,Wing Commander,1999,wing_commander,2.8,46,5,41,10,2.2,11,0,11,0,2.2,2768,26,http://content6.flixster.com/movie/11/11/98/11119824_det.jpg
2550,The Haunting,1999,1090789-haunting,3.7,87,15,72,17,3.1,24,3,21,12,2.7,10812,42,http://content7.flixster.com/movie/10/81/95/10819505_det.jpg
2551,Dead Ringers,1988,dead_ringers,7.7,35,29,6,82,5.7,6,3,3,50,3.6,4690,80,http://content6.flixster.com/movie/28/49/284996_det.jpg
2552,My Boyfriend's Back,1993,my_boyfriends_back,3.4,10,1,9,10,0,2,0,2,0,2.7,1035,43,http://content7.flixster.com/movie/26/21/262125_det.jpg
2553,Village of the Damned,1995,1061401-village_of_the_damned,4,30,9,21,30,4.2,5,2,3,40,2.7,4194,36,http://content6.flixster.com/movie/11/15/07/11150724_det.jpg
2554,Children of the Damned,1964,children_of_the_damned,5.6,12,9,3,75,0,0,0,0,0,0,0,0,http://content6.flixster.com/movie/46/78/04/4678048_det.jpg
2555,Baby Geniuses,1999,baby_geniuses,1.9,43,1,42,2,2.1,10,0,10,0,2.5,8215,32,http://content7.flixster.com/movie/10/09/74/10097481_det.jpg
2556,Telling You,1998,telling_you,5.6,5,1,4,20,0,0,0,0,0,0,0,0,http://content7.flixster.com/movie/28/18/281817_det.jpg
2557,Seul contre tous,1998,i_stand_alone,7.7,20,17,3,85,0,2,2,0,100,3.9,1587,82,http://content8.flixster.com/movie/10/92/06/10920666_det.jpg
2558,Forces of Nature,1999,forces_of_nature,5.3,63,29,34,46,4.7,18,6,12,33,2.6,7489,37,http://content8.flixster.com/movie/26/02/260294_det.jpg
2559,The King and I,1956,1011605-king_and_i,8.2,19,19,0,100,0,1,1,0,100,3.6,12939,79,http://content9.flixster.com/movie/10/93/55/10935535_det.jpg
2560,Ravenous,1999,ravenous,5.5,36,14,22,38,5.2,6,2,4,33,3.6,4588,78,http://content6.flixster.com/movie/27/15/271516_det.jpg
2561,True Crime,1999,1084928-true_crime,6,38,20,18,52,6.8,6,5,1,83,3.2,2873,51,http://content6.flixster.com/movie/27/47/274704_det.jpg
2562,Bandits,2001,bandits,6.1,136,86,50,63,5.9,34,20,14,58,3.1,9238,56,http://content8.flixster.com/movie/25/90/259014_det.jpg
2563,Dangerous Beauty,1998,dangerous_beauty,6.4,26,18,8,69,6.8,7,5,2,71,4.1,2764,87,http://content9.flixster.com/movie/10/88/40/10884011_det.jpg
2565,The King and I,1956,1011605-king_and_i,8.2,19,19,0,100,0,1,1,0,100,3.6,12939,79,http://content9.flixster.com/movie/10/93/55/10935535_det.jpg
2566,Doug's 1st Movie,1999,dougs-first-movie,4.6,32,8,24,25,4.4,9,3,6,33,2.9,1446,43,http://content9.flixster.com/movie/10/92/34/10923411_det.jpg
2567,Edtv,1999,edtv,6.3,42,26,16,61,6.2,7,3,4,42,2.6,8130,31,http://content8.flixster.com/movie/26/08/260802_det.jpg
2568,The Mod Squad,1999,mod_squad,3,51,2,49,3,3.4,13,1,12,7,2.4,1890,21,http://content7.flixster.com/movie/10/90/66/10906641_det.jpg
2569,Among Giants,1998,among_giants,5.5,19,11,8,57,0,4,2,2,50,3.2,111,33,http://content9.flixster.com/movie/88/17/07/8817071_det.jpg
2570,A Walk on the Moon,1999,walk_on_the_moon,6.7,35,25,10,71,6.6,6,4,2,66,3.4,2848,67,http://content8.flixster.com/movie/26/82/268206_det.jpg
2571,The Matrix,1999,matrix,7.4,125,108,17,86,6.2,28,19,9,67,3.6,207333,81,http://content7.flixster.com/movie/16/90/52/1690525_det.jpg
2572,10 Things I Hate About You,1999,,6,58,34,24,58,6.3,12,7,5,58,3.3,207830,69,http://content8.flixster.com/movie/11/15/34/11153458_det.jpg
2573,Tango,1998,1084081-tango,6.8,20,14,6,70,8.5,5,4,1,80,3.9,767,82,http://content9.flixster.com/movie/10/88/99/10889971_det.jpg
2574,The Out-of-Towners,1999,1087047-outoftowners,5,34,8,26,23,4.9,5,1,4,20,2.6,2186,33,http://content6.flixster.com/movie/26/24/262496_det.jpg
2575,La vie r√™v√©e des anges,1998,dreamlife_of_angels,7.6,42,39,3,92,8,13,13,0,100,3.9,1181,83,http://content8.flixster.com/movie/10/89/39/10893934_det.jpg
2576,"Love, etc.",1996,love_etc,0,4,2,2,50,0,1,1,0,100,3.2,217,54,http://content6.flixster.com/movie/30/78/307828_det.jpg
2577,Metroland,1997,metroland,6.4,27,17,10,62,0,4,3,1,75,3.3,1014,55,http://content6.flixster.com/movie/10/07/07/10070744_det.jpg
2578,The Sticky Fingers of Time,1997,sticky_fingers_of_time,6.2,5,4,1,80,0,2,2,0,100,3,247,48,http://content8.flixster.com/movie/30/88/308802_det.jpg
2579,Following,1998,following,7.1,21,16,5,76,0,3,1,2,33,3.8,7121,85,http://content6.flixster.com/movie/27/19/271928_det.jpg
2580,Go,1999,1087053-go,7.6,72,66,6,91,7,19,15,4,78,3.2,8608,72,http://content9.flixster.com/movie/96/21/35/9621359_det.jpg
2581,Never Been Kissed,1999,never_been_kissed,5.7,79,44,35,55,5.4,25,12,13,48,3.3,53088,70,http://content8.flixster.com/movie/26/46/264622_det.jpg
2582,Shuang long hui,1992,twin-dragons,5.1,37,16,21,43,4.5,7,3,4,42,3.1,3144,55,http://content9.flixster.com/movie/26/13/261391_det.jpg
2583,Cookie's Fortune,1999,cookies_fortune,7.5,55,47,8,85,7.4,12,11,1,91,3.2,1364,57,http://content7.flixster.com/movie/26/33/263325_det.jpg
2584,Foolish Wives,1922,foolish-wives,9,7,7,0,100,0,0,0,0,0,0,0,0,http://content6.flixster.com/movie/10/93/43/10934300_det.jpg
2585,Los amantes del C√≠rculo Polar,1998,lovers_of_the_arctic_circle,7,23,19,4,82,0,4,4,0,100,4.3,3613,92,http://content6.flixster.com/movie/20/53/11/2053116_det.jpg
2586,Goodbye Lover,1998,goodbye_lover,4.7,33,10,23,30,3.6,10,1,9,10,2.9,457,35,http://content7.flixster.com/movie/27/57/275729_det.jpg
2587,Waking Life,2001,waking_life,7.4,137,109,28,79,7.6,32,26,6,81,4,17715,87,http://content6.flixster.com/movie/26/70/267000_det.jpg
2589,Friends & Lovers,1999,lovers-and-friends,0,0,0,0,0,0,0,0,0,0,0,0,0,http://content8.flixster.com/movie/10/87/56/10875646_det.jpg
2590,Hideous Kinky,1998,hideous_kinky,5.9,34,21,13,61,0,4,3,1,75,3.3,2069,56,http://content7.flixster.com/movie/27/38/273809_det.jpg
2591,Jeanne et le gar√ßon formidable,1998,jeanne-and-the-perfect-guy,5.8,5,3,2,60,0,2,2,0,100,3.3,323,55,http://content9.flixster.com/movie/11/14/85/11148555_det.jpg
2593,Il mostro,1994,1074910-monster,5.8,10,4,6,40,0,1,0,1,0,3.8,1005,78,http://content6.flixster.com/movie/10/89/45/10894520_det.jpg
2594,Abre los ojos,1997,open-your-eyes,7.4,45,38,7,84,6.9,8,6,2,75,3.9,11790,85,http://content9.flixster.com/movie/11/12/75/11127527_det.jpg
2595,Fotoamator,1998,,\N,\N,\N,\N,\N,\N,\N,\N,\N,\N,\N,\N,\N,\N
2596,SLC Punk!,1998,slc_punk,5.6,31,19,12,61,6.2,5,3,2,60,3.8,9837,89,http://content7.flixster.com/movie/26/96/269621_det.jpg
2597,Lost & Found,1999,1087050-lost_and_found,3.6,52,7,45,13,2.8,18,0,18,0,2.5,1416,30,http://content9.flixster.com/movie/11/15/13/11151339_det.jpg
2598,Pushing Tin,1999,pushing_tin,5.6,65,32,33,49,5.5,16,8,8,50,2.9,5381,43,http://content8.flixster.com/movie/27/16/271610_det.jpg
2599,Election,1999,election,7.8,101,93,8,92,7.7,23,21,2,91,3.3,11134,72,http://content9.flixster.com/movie/28/43/284319_det.jpg
2600,eXistenZ,1999,existenz,6.7,62,44,18,70,5.7,10,5,5,50,3.2,10592,65,http://content7.flixster.com/movie/26/87/268709_det.jpg
2601,A Little Bit of Soul,1998,little_bit_of_soul,0,4,2,2,50,0,0,0,0,0,0,0,0,http://content9.flixster.com/movie/10/87/32/10873203_det.jpg
2602,Xing xing wang,1977,the-mighty-peking-man,0,0,0,0,0,0,0,0,0,0,0,0,0,http://content6.flixster.com/movie/10/85/66/10856648_det.jpg
2603,Revolutionary Road,2008,revolutionary_road,6.7,194,133,61,68,6.9,36,25,11,69,3.5,46044,70,http://content8.flixster.com/movie/10/88/40/10884042_det.jpg
2604,Let It Come Down: The Life of Paul Bowles,1998,let_it_come_down_the_life_of_paul_bowles,0,3,3,0,100,0,2,2,0,100,3,172,45,http://content9.flixster.com/movie/30/68/306815_det.jpg
2605,Entrapment,1999,entrapment,5.2,80,30,50,37,4.7,18,7,11,38,3,17343,57,http://content8.flixster.com/movie/26/39/263902_det.jpg
2606,Idle Hands,1999,idle_hands,3.4,53,8,45,15,3,17,1,16,5,2.9,8232,57,http://content8.flixster.com/movie/10/87/43/10874314_det.jpg
2607,Get Real,1998,get_real,6.4,45,35,10,77,6.4,13,10,3,76,3.8,2164,79,http://content9.flixster.com/movie/27/09/270907_det.jpg
2609,Bian Lian,1996,the-king-of-masks,7.4,18,16,2,88,7.7,5,5,0,100,4.1,775,88,http://content8.flixster.com/movie/29/36/293698_det.jpg
2610,Three Seasons,1999,three_seasons_1999,6.7,30,24,6,80,0,4,4,0,100,0,0,0,http://content6.flixster.com/movie/12/80/57/1280576_det.jpg
2611,The Winslow Boy,1999,1087341-winslow_boy,7.9,35,34,1,97,8.2,6,6,0,100,3.6,768,70,http://content6.flixster.com/movie/25/19/251912_det.jpg
2612,Mildred Pierce,1945,mildred_pierce,7.6,30,26,4,86,0,2,2,0,100,4.1,2165,90,http://content7.flixster.com/movie/29/97/299713_det.jpg
2613,Night of the Comet,1984,night_of_the_comet,6.5,20,17,3,85,0,2,2,0,100,3.3,2733,57,http://content8.flixster.com/movie/14/81/67/1481678_det.jpg
2614,Chopping Mall,1986,chopping_mall,4.4,5,2,3,40,0,0,0,0,0,0,0,0,http://content8.flixster.com/movie/10/86/43/10864342_det.jpg
2615,My Science Project,1985,my_science_project,3.2,5,1,4,20,0,0,0,0,0,0,0,0,http://content8.flixster.com/movie/26/60/266022_det.jpg
2616,Dick Tracy,1990,1029314-dick_tracy,5.7,43,28,15,65,4.6,8,3,5,37,2.8,10803,44,http://content7.flixster.com/movie/10/86/72/10867225_det.jpg
2617,The Mummy,1999,1087270-mummy,5.7,81,44,37,54,5.1,17,7,10,41,3.4,79634,75,http://content9.flixster.com/movie/55/05/83/5505839_det.jpg
2618,The Castle,1997,the-castle,6.9,33,29,4,87,6.6,6,5,1,83,4.1,3419,91,http://content9.flixster.com/movie/26/92/269291_det.jpg
2619,Mascara,1987,1013470-mascara,0,0,0,0,0,0,0,0,0,0,0,0,0,http://content8.flixster.com/movie/10/89/46/10894674_det.jpg
2620,This Is My Father,1998,this_is_my_father,6.7,27,20,7,74,6,5,4,1,80,3.9,442,79,http://content9.flixster.com/movie/10/91/81/10918183_det.jpg
2621,Tian yu,1998,xiu_xiu_the_sent_down_girl,8,24,23,1,95,9,5,5,0,100,3.8,593,81,http://content9.flixster.com/movie/27/62/276223_det.jpg
2622,A Midsummer Night's Dream,1999,tales-of-the-night-fairies,0,0,0,0,0,0,0,0,0,0,0,0,0,http://images.rottentomatoescdn.com/images/defaults/poster_default.gif
2623,Trippin',1999,trippin,4.2,12,1,11,8,0,4,0,4,0,3.8,73,62,http://content6.flixster.com/movie/10/84/77/10847728_det.jpg
2624,Wand√¢furu raifu,1998,after_life,6.9,22,18,4,81,0,4,4,0,100,4.1,1840,90,http://content8.flixster.com/movie/29/55/295522_det.jpg
2625,Hak hap,1996,black_mask,4.9,28,14,14,50,0,1,0,1,0,0,0,0,http://content7.flixster.com/movie/28/46/284617_det.jpg
2626,Edge of Seventeen,1998,edge-of-seventeen2000,0,0,0,0,0,0,0,0,0,0,0,0,0,http://content9.flixster.com/movie/10/85/21/10852115_det.jpg
2627,The Endurance: Shackleton's Legendary Antarctic Expedition,2000,the-endurance,7.7,65,62,3,95,7.9,24,24,0,100,3.8,415,79,http://content7.flixster.com/movie/25/13/251325_det.jpg
2628,Star Wars: Episode I - The Phantom Menace,1999,star-warpd,0,0,0,0,0,0,0,0,0,0,0,0,0,http://content9.flixster.com/movie/10/80/46/10804663_det.jpg
2629,The Love Letter,1999,phantom_love,0,0,0,0,0,0,0,0,0,0,0,0,0,http://content8.flixster.com/movie/10/98/41/10984126_det.jpg
2630,Besieged,1998,besieged,7,46,34,12,73,6.7,12,7,5,58,3.7,762,80,http://content8.flixster.com/movie/27/79/277914_det.jpg
2631,Frogs for Snakes,1998,frogs_for_snakes,4.4,10,3,7,30,0,2,0,2,0,3.4,141,50,http://content9.flixster.com/movie/10/98/26/10982667_det.jpg
2632,Rekopis znaleziony w Saragossie,1965,the-saragossa-manuscript,7.3,10,9,1,90,0,2,2,0,100,4.2,509,90,http://content7.flixster.com/movie/29/89/298913_det.jpg
2633,The Mummy,1999,1087270-mummy,5.7,81,44,37,54,5.1,17,7,10,41,3.4,79634,75,http://content9.flixster.com/movie/55/05/83/5505839_det.jpg
2634,The Mummy,1999,1087270-mummy,5.7,81,44,37,54,5.1,17,7,10,41,3.4,79634,75,http://content9.flixster.com/movie/55/05/83/5505839_det.jpg
2635,The Mummy's Curse,1944,mummys_curse,6.2,7,4,3,57,0,0,0,0,0,0,0,0,http://content9.flixster.com/movie/52/44/11/5244119_det.jpg
2636,The Mummy's Ghost,1944,mummys_ghost,0,4,2,2,50,0,0,0,0,0,0,0,0,http://content8.flixster.com/movie/52/44/37/5244370_det.jpg
2637,The Mummy's Hand,1940,mummys_hand,6.1,7,5,2,71,0,0,0,0,0,0,0,0,http://content8.flixster.com/movie/52/44/31/5244318_det.jpg
2638,The Mummy: Tomb of the Dragon Emperor,2008,mummy_tomb_of_the_dragon_emperor,3.7,161,21,140,13,3.7,32,3,29,9,3,79989,40,http://content8.flixster.com/movie/10/87/58/10875846_det.jpg
2639,Mommie Dearest,1981,mommie_dearest,5.6,30,17,13,56,4.8,5,2,3,40,3.6,3417,78,http://content8.flixster.com/movie/25/48/254822_det.jpg
2640,Superman,1978,superman_the_movie,8,52,49,3,94,7.4,6,5,1,83,3.5,39510,77,http://content7.flixster.com/movie/10/86/72/10867249_det.jpg
2641,Superman II,1980,superman_ii,7.4,41,36,5,87,8.4,5,5,0,100,3.2,30072,66,http://content9.flixster.com/movie/25/68/256815_det.jpg
2642,Superman III,1983,superman_iii,4.4,40,9,31,22,0,3,0,3,0,2.7,17727,39,http://content6.flixster.com/movie/26/36/263604_det.jpg
2643,Superman IV: The Quest for Peace,1987,superman_iv_the_quest_for_peace,2.8,30,3,27,10,3.2,5,1,4,20,2.5,13076,30,http://content8.flixster.com/movie/26/26/262698_det.jpg
2644,Dracula,1931,1006234-dracula,7.7,42,39,3,92,7.7,6,6,0,100,3.6,8598,76,http://content9.flixster.com/movie/29/22/292203_det.jpg
2646,House of Dracula,1945,house_of_dracula,5.7,7,4,3,57,0,1,0,1,0,3.1,1009,41,http://content8.flixster.com/movie/10/88/76/10887610_det.jpg
2647,House of Frankenstein,1944,,5.6,10,6,4,60,0,0,0,0,0,0,0,0,http://content7.flixster.com/movie/34/10/20/3410205_det.jpg
2648,Frankenstein,1931,1007818-frankenstein,8.5,38,38,0,100,7.8,5,5,0,100,3.6,7211,81,http://content8.flixster.com/movie/28/83/288310_det.jpg
2649,Son of Frankenstein,1939,son_of_frankenstein,7.3,18,17,1,94,0,2,2,0,100,0,0,0,http://content6.flixster.com/movie/34/10/21/3410212_det.jpg
2650,The Ghost of Frankenstein,1942,ghost_of_frankenstein,6.3,8,7,1,87,0,0,0,0,0,0,0,0,http://content7.flixster.com/movie/10/86/19/10861913_det.jpg
2651,Frankenstein Meets the Wolf Man,1943,frankenstein_meets_the_wolf_man,5.2,10,3,7,30,0,0,0,0,0,0,0,0,http://content9.flixster.com/movie/10/95/43/10954335_det.jpg
2652,The Curse of Frankenstein,1957,curse_of_frankenstein,7.6,7,7,0,100,0,0,0,0,0,0,0,0,http://content8.flixster.com/movie/30/20/302002_det.jpg
2653,Son of Dracula,1943,,\N,\N,\N,\N,\N,\N,\N,\N,\N,\N,\N,\N,\N,\N
2654,The Wolf Man,1941,wolf_man,7.7,31,29,2,93,0,3,2,1,66,3.7,2541,77,http://content7.flixster.com/movie/10/95/43/10954333_det.jpg
2655,Howling II: Stirba - Werewolf Bitch,1985,howling_ii,3.1,6,1,5,16,0,1,0,1,0,2.5,1403,27,http://content6.flixster.com/movie/26/98/269892_det.jpg
2656,Tarantula,1955,tarantula,6.3,11,10,1,90,0,0,0,0,0,0,0,0,http://content8.flixster.com/movie/53/46/01/5346010_det.jpg
2657,The Rocky Horror Picture Show,1975,rocky_horror_picture_show,6.5,35,27,8,77,0,3,0,3,0,3.6,49873,85,http://content9.flixster.com/movie/10/86/90/10869035_det.jpg
2659,It Came from Hollywood,1982,it_came_from_hollywood,0,0,0,0,0,0,0,0,0,0,0,0,0,http://content9.flixster.com/movie/26/44/264411_det.jpg
2660,The Thing from Another World,1951,1021242-thing,7.7,26,23,3,88,0,2,1,1,50,3.6,2130,71,http://content6.flixster.com/movie/28/58/285828_det.jpg
2661,It Came from Outer Space,1953,it-came-from-outer-space,6.8,26,21,5,80,0,3,2,1,66,3.1,796,51,http://content7.flixster.com/movie/25/13/251313_det.jpg
2662,War of the Worlds,2005,war_of_the_worlds,7,244,178,66,72,6.7,42,28,14,66,2.9,162092,45,http://content8.flixster.com/movie/10/86/82/10868202_det.jpg
2663,It Came from Beneath the Sea,1955,it_came_from_beneath_the_sea,6,7,5,2,71,0,0,0,0,0,0,0,0,http://content9.flixster.com/movie/10/87/84/10878439_det.jpg
2664,Invasion of the Body Snatchers,1956,1010678-invasion_of_the_body_snatchers,8.9,36,36,0,100,0,2,2,0,100,3.6,3820,81,http://content8.flixster.com/movie/10/95/44/10954478_det.jpg
2665,Earth vs. the Flying Saucers,1956,earth_vs_the_flying_saucers,5.7,13,9,4,69,0,0,0,0,0,0,0,0,http://content6.flixster.com/movie/28/63/286324_det.jpg
2666,It Conquered the World,1956,it_conquered_the_world,5.6,5,4,1,80,0,0,0,0,0,0,0,0,http://content9.flixster.com/movie/54/38/31/5438315_det.jpg
2667,The Mole People,1956,mole_people,0,4,1,3,25,0,0,0,0,0,0,0,0,http://content9.flixster.com/movie/84/00/67/8400679_det.jpg
2668,Swamp Thing,1982,swamp_thing,5.8,26,18,8,69,0,3,1,2,33,2.7,3423,34,http://content6.flixster.com/movie/10/90/44/10904464_det.jpg
2669,Pork Chop Hill,1959,pork_chop_hill,0,4,4,0,100,0,0,0,0,0,0,0,0,http://content6.flixster.com/movie/29/88/298892_det.jpg
2670,Run Silent Run Deep,1958,run_silent_run_deep,7,7,7,0,100,0,0,0,0,0,0,0,0,http://content8.flixster.com/movie/29/23/292326_det.jpg
2671,Notting Hill,1999,notting_hill,7.1,97,80,17,82,6.8,28,21,7,75,3.3,85951,74,http://content9.flixster.com/movie/25/41/254107_det.jpg
2672,The Thirteenth Floor,1999,1089671-13th_floor,4.5,61,17,44,27,3.8,18,3,15,16,3,5631,61,http://content6.flixster.com/movie/10/87/41/10874152_det.jpg
2673,Mia aioniotita kai mia mera,1998,eternity_and_a_day,7.2,21,20,1,95,7.2,6,5,1,83,4.3,1029,91,http://content9.flixster.com/movie/91/04/04/9104047_det.jpg
2674,The Loss of Sexual Innocence,1999,loss_of_sexual_innocence,4.8,29,13,16,44,7,5,4,1,80,3.3,449,60,http://content7.flixster.com/movie/10/94/29/10942945_det.gif
2675,The Man with Rain in His Shoes,1998,twice_upon_a_yesterday,4.8,21,6,15,28,0,3,1,2,33,3.3,477,55,http://content9.flixster.com/movie/10/87/83/10878363_det.jpg
2676,Instinct,1999,instinct,4.3,66,18,48,27,3.7,15,3,12,20,3.2,4403,67,http://content6.flixster.com/movie/27/40/274000_det.jpg
2677,Buena Vista Social Club,1999,1087935-buena_vista_social_club,7.5,41,37,4,90,8.2,7,6,1,85,4,2963,88,http://content8.flixster.com/movie/10/89/19/10891962_det.jpg
2678,Desert Blue,1998,desert_blue,5.1,18,7,11,38,0,4,1,3,25,3.2,414,49,http://content6.flixster.com/movie/28/24/282492_det.jpg
2679,Finding North,1998,finding-north,4.7,9,4,5,44,0,1,0,1,0,2.9,277,33,http://content7.flixster.com/movie/30/65/306525_det.jpg
2681,Free Enterprise,1998,,\N,\N,\N,\N,\N,\N,\N,\N,\N,\N,\N,\N,\N,\N
2682,Limbo,1999,1087937-limbo,7,39,28,11,71,6.9,6,3,3,50,3.5,169,75,http://content6.flixster.com/movie/10/85/55/10855592_det.jpg
2683,Austin Powers: The Spy Who Shagged Me,1999,austin_powers_the_spy_who_shagged_me,6,85,44,41,51,5.6,20,11,9,55,3.3,70870,73,http://content9.flixster.com/movie/10/86/89/10868999_det.jpg
2685,Le nain rouge,1998,,\N,\N,\N,\N,\N,\N,\N,\N,\N,\N,\N,\N,\N,\N
2686,Le violon rouge,1998,red_violin,7.1,39,28,11,71,7.4,6,5,1,83,3.9,7025,91,http://content7.flixster.com/movie/10/84/36/10843629_det.jpg
2687,Tarzan,1999,tarzan,7.6,101,89,12,88,7.3,27,23,4,85,3.2,30231,63,http://content9.flixster.com/movie/25/12/251223_det.jpg
2688,The General's Daughter,1999,generals_daughter,4.3,87,19,68,21,3.5,23,3,20,13,3,6034,55,http://content6.flixster.com/movie/28/45/284516_det.jpg
2689,Get Smart's Bruce and Lloyd Out of Control,2008,get_smarts_bruce_and_loyd_out_of_control,0,2,1,1,50,0,0,0,0,0,0,0,0,http://content9.flixster.com/movie/10/85/85/10858579_det.jpg
2690,An Ideal Husband,1999,1091577-ideal_husband,7.4,63,54,9,85,7.4,15,14,1,93,3.4,2877,66,http://content9.flixster.com/movie/25/54/255491_det.jpg
2691,La leggenda del pianista sull'oceano,1998,legend_of_1900,6.2,35,19,16,54,6,5,2,3,40,4.2,5983,92,http://content9.flixster.com/movie/11/12/68/11126807_det.jpg
2692,Lola rennt,1998,run_lola_run,7.7,78,72,6,92,7.5,20,19,1,95,3.8,33702,88,http://content7.flixster.com/movie/26/72/267225_det.jpg
2693,Trekkies,1997,trekkies,7.3,41,35,6,85,6.9,6,4,2,66,3.4,1371,67,http://content9.flixster.com/movie/26/63/266319_det.jpg
2694,Big Daddy,1999,daddy-who,0,0,0,0,0,0,0,0,0,0,0,0,0,http://content6.flixster.com/movie/10/85/17/10851764_det.jpg
2695,The Lost Boys,1987,lost_boys,6.3,40,30,10,75,0,4,2,2,50,3.7,48695,85,http://content7.flixster.com/movie/10/93/70/10937097_det.jpg
2696,Le d√Æner de cons,1998,dinner_game,6.8,44,32,12,72,7.7,11,10,1,90,4.1,5214,90,http://content6.flixster.com/movie/10/91/04/10910436_det.jpg
2697,My Son the Fanatic,1997,my_son_the_fanatic,6.9,27,21,6,77,7.4,6,4,2,66,3.5,322,73,http://content7.flixster.com/movie/28/13/281325_det.jpg
2699,Arachnophobia,1990,arachnophobia,6.6,26,22,4,84,0,2,2,0,100,2.8,10804,43,http://content8.flixster.com/movie/25/87/258794_det.jpg
2700,South Park: Bigger Longer & Uncut,1999,south_park_bigger_longer_and_uncut,7,92,74,18,80,6.7,24,20,4,83,3.7,46689,86,http://content8.flixster.com/movie/11/12/93/11129370_det.jpg
2701,Wild Wild West,1999,wild_wild_west,3.9,102,21,81,20,3.7,24,4,20,16,2.7,31689,39,http://content8.flixster.com/movie/11/15/28/11152830_det.jpg
2702,Summer of Sam,1999,son-of-sam,0,0,0,0,0,0,0,0,0,0,0,0,0,http://content9.flixster.com/movie/10/88/16/10881687_det.jpg
2703,Broken Vessels,1998,broken_vessels,5.7,14,9,5,64,0,3,2,1,66,0,0,0,http://content6.flixster.com/movie/28/27/282796_det.jpg
2704,Les amants du Pont-Neuf,1991,lovers_on_the_bridge,7.1,14,11,3,78,0,2,2,0,100,4,1699,86,http://content9.flixster.com/movie/10/87/69/10876955_det.jpg
2705,"Fin ao√ªt, d√©but septembre",1998,late_august_early_september,6.7,22,18,4,81,7.6,7,7,0,100,3.5,332,61,http://content8.flixster.com/movie/10/88/53/10885374_det.jpg
2706,American Pie,1999,american_pie,5.7,115,67,48,58,5.5,25,13,12,52,3.4,203348,63,http://content8.flixster.com/movie/11/12/27/11122778_det.jpg
2707,Arlington Road,1999,arlington_road,6.1,86,52,34,60,5.7,19,9,10,47,3.3,6430,72,http://content6.flixster.com/movie/27/14/271400_det.jpg
2708,Conte d'automne,1998,autumn_tale,7.8,32,30,2,93,8.3,11,11,0,100,3.8,273,81,http://content6.flixster.com/movie/10/91/18/10911872_det.jpg
2709,Muppets from Space,1999,muppets_from_space,6.2,53,33,20,62,5.6,20,10,10,50,3,4740,55,http://content7.flixster.com/movie/10/87/15/10871517_det.jpg
2710,The Blair Witch Project,1999,blair_witch_project,7.5,125,106,19,84,7.2,28,25,3,89,2.5,23900,47,http://content8.flixster.com/movie/10/91/56/10915602_det.jpg
2711,My Life So Far,1999,my_life_so_far,6.3,25,18,7,72,6.2,5,3,2,60,3.1,618,41,http://content9.flixster.com/movie/26/06/260603_det.jpg
2712,Eyes Wide Shut,1999,eyes_wide_shut,7.3,119,93,26,78,6.7,26,18,8,69,2.9,26285,66,http://content6.flixster.com/movie/55/09/34/5509348_det.jpg
2713,Lake Placid,1999,lake_placid,5,68,26,42,38,4,17,4,13,23,2.6,12183,40,http://content7.flixster.com/movie/20/49/88/2049881_det.jpg
2714,The Wood,1999,wood,6,56,34,22,60,5.7,17,10,7,58,3.9,6421,90,http://content7.flixster.com/movie/26/79/267909_det.jpg
2715,The Velocity of Gary* *(Not His Real Name),1998,velocity_of_gary,4.1,17,4,13,23,0,1,0,1,0,3.1,516,49,http://content8.flixster.com/movie/27/56/275698_det.jpg
2716,Ghost Busters,1984,ghostbusters,7.6,46,43,3,93,6.2,5,3,2,60,3.6,65639,81,http://content8.flixster.com/movie/26/34/263418_det.jpg
2717,Ghostbusters II,1989,ghostbusters_2,5.2,34,18,16,52,5.4,5,3,2,60,3.2,30085,62,http://content7.flixster.com/movie/25/96/259625_det.jpg
2718,Drop Dead Gorgeous,1999,,\N,\N,\N,\N,\N,\N,\N,\N,\N,\N,\N,\N,\N,\N
2719,The Haunting,1999,1090789-haunting,3.7,87,15,72,17,3.1,24,3,21,12,2.7,10812,42,http://content7.flixster.com/movie/10/81/95/10819505_det.jpg
2720,Inspector Gadget,1999,inspector_gadget,4,61,13,48,21,3.9,21,4,17,19,2.3,11127,26,http://content8.flixster.com/movie/10/87/99/10879942_det.jpg
2721,Trick,1999,trick,6.8,22,17,5,77,6.8,6,4,2,66,3.7,1364,80,http://content8.flixster.com/movie/10/89/90/10899058_det.gif
2722,Deep Blue Sea,1999,1090759-deep_blue_sea,5.7,89,51,38,57,5.8,22,14,8,63,2.8,26286,44,http://content7.flixster.com/movie/27/10/271021_det.jpg
2723,Mystery Men,1999,mystery_men,5.7,100,60,40,60,5.7,28,17,11,60,2.8,14333,52,http://content6.flixster.com/movie/25/66/256628_det.jpg
2724,Runaway Bride,1999,runaway_bride,5.3,82,37,45,45,4.8,27,10,17,37,3,48629,57,http://content9.flixster.com/movie/10/84/58/10845851_det.jpg
2725,Twin Falls Idaho,1999,twin_falls_idaho,7.3,44,34,10,77,7.6,7,6,1,85,3.8,751,82,http://content7.flixster.com/movie/28/03/280317_det.jpg
2726,The Killing,1956,killing,8.3,26,25,1,96,0,3,3,0,100,4,5595,90,http://content7.flixster.com/movie/29/43/294317_det.jpg
2727,Killer's Kiss,1955,killers_kiss,6.8,17,14,3,82,0,3,3,0,100,3.3,2112,56,http://content8.flixster.com/movie/28/77/287714_det.jpg
2728,Spartacus,1960,1019544-spartacus,8.1,45,43,2,95,0,4,3,1,75,3.7,25019,79,http://content7.flixster.com/movie/25/94/259493_det.jpg
2729,Lolita,1962,1012611-lolita,8,38,37,1,97,0,2,2,0,100,3.7,11593,80,http://content8.flixster.com/movie/30/09/300906_det.jpg
2730,Barry Lyndon,1975,barry_lyndon,7.8,49,46,3,93,7.5,7,7,0,100,4.1,12262,90,http://content8.flixster.com/movie/26/20/262022_det.jpg
2731,Les quatre cents coups,1959,400_blows,9.3,48,48,0,100,8.8,8,8,0,100,4.4,9787,95,http://content6.flixster.com/movie/93/87/90/9387900_det.jpg
2732,Jules et Jim,1962,jules_and_jim,8.9,31,30,1,96,0,4,4,0,100,4.2,6006,89,http://content9.flixster.com/movie/10/85/31/10853127_det.jpg
2733,Vibes,1988,vibes,2.8,7,0,7,0,0,1,0,1,0,3.3,404,59,http://content6.flixster.com/movie/10/90/48/10904840_det.jpg
2734,The Mosquito Coast,1986,mosquito_coast,6.4,20,15,5,75,0,1,0,1,0,3.2,3391,55,http://content7.flixster.com/movie/26/00/260025_det.jpg
2735,The Golden Child,1986,golden_child,3.9,19,5,14,26,0,2,1,1,50,2.9,9053,49,http://content6.flixster.com/movie/25/60/256000_det.jpg
2736,Brighton Beach Memoirs,1986,brighton_beach_memoirs,5.7,9,6,3,66,0,1,0,1,0,3.4,596,69,http://content8.flixster.com/movie/31/07/310718_det.jpg
2737,The Assassination of Jesse James by the Coward Robert Ford,2007,assassination_of_jesse_james_by_the_coward_robert_ford,7.1,162,121,41,74,6.6,36,22,14,61,3.7,57534,73,http://content8.flixster.com/movie/10/93/78/10937894_det.jpg
2738,Crimes of the Heart,1986,crimes_of_the_heart,7.6,14,14,0,100,0,1,1,0,100,3.3,602,53,http://content9.flixster.com/movie/25/87/258799_det.jpg
2739,The Color Purple,1985,color_purple,6.7,24,21,3,87,0,1,1,0,100,3.9,30970,93,http://content9.flixster.com/movie/10/93/85/10938559_det.jpg
2741,No Mercy,1986,1015199-no_mercy,3.4,13,2,11,15,4.4,5,2,3,40,2.8,740,32,http://content8.flixster.com/movie/10/92/75/10927586_det.jpg
2742,Tenue de soir√©e,1986,menage,0,4,3,1,75,0,1,1,0,100,3.8,345,75,http://content8.flixster.com/movie/11/12/67/11126790_det.jpg
2743,Native Son,1986,1014759-native_son,6,9,5,4,55,0,4,1,3,25,3.4,71,61,http://content6.flixster.com/movie/10/84/88/10848836_det.jpg
2744,Otello,1992,,\N,\N,\N,\N,\N,\N,\N,\N,\N,\N,\N,\N,\N,\N
2745,The Mission,1986,1014027-mission,6.4,16,11,5,68,0,2,1,1,50,3.8,11307,83,http://content8.flixster.com/movie/10/91/81/10918186_det.jpg
2746,The Little Shop of Horrors,1960,1012514-little_shop_of_horrors,6.2,11,10,1,90,0,0,0,0,0,0,0,0,http://content9.flixster.com/movie/10/84/01/10840135_det.jpg
2747,The Little Shop of Horrors,1960,1012514-little_shop_of_horrors,6.2,11,10,1,90,0,0,0,0,0,0,0,0,http://content9.flixster.com/movie/10/84/01/10840135_det.jpg
2748,Allan Quatermain and the Lost City of Gold,1986,allan_quatermain_and_the_lost_city_of_gold,0,3,2,1,66,0,0,0,0,0,0,0,0,http://content7.flixster.com/movie/26/39/263925_det.jpg
2749,The Morning After,1986,morning_after,5.8,15,11,4,73,0,1,1,0,100,2.9,557,33,http://content8.flixster.com/movie/10/89/04/10890474_det.jpg
2750,Radio Days,1987,radio_days,7.9,21,20,1,95,0,1,1,0,100,3.8,3253,82,http://content9.flixster.com/movie/25/82/258223_det.jpg
2751,From the Hip,1987,from_the_hip,4.7,6,1,5,16,0,1,0,1,0,3.2,411,59,http://content6.flixster.com/movie/26/28/262808_det.jpg
2752,Outrageous Fortune,1987,outrageous_fortune,5,20,10,10,50,5,5,2,3,40,3,1206,54,http://content6.flixster.com/movie/27/11/271108_det.jpg
2753,The Bedroom Window,1987,bedroom_window,6,14,12,2,85,0,0,0,0,0,0,0,0,http://content9.flixster.com/movie/10/88/16/10881655_det.jpg
2754,Deadtime Stories,1986,deadtime_stories,0,3,0,3,0,0,0,0,0,0,0,0,0,http://content7.flixster.com/movie/37/14/58/3714585_det.jpg
2755,Light of Day,1987,light_of_day,5.2,12,7,5,58,0,1,1,0,100,3.1,311,41,http://content7.flixster.com/movie/90/71/22/9071221_det.jpg
2756,Wanted: Dead or Alive,1986,1023087-wanted_dead_or_alive,4.1,8,2,6,25,0,1,0,1,0,2.9,934,43,http://content7.flixster.com/movie/11/13/07/11130785_det.jpg
2757,Frances,1982,frances,7.6,15,14,1,93,0,1,1,0,100,3.8,713,78,http://content9.flixster.com/movie/28/50/285091_det.jpg
2758,Plenty,1985,plenty,7.3,7,5,2,71,0,1,1,0,100,3.4,613,54,http://content7.flixster.com/movie/28/40/284021_det.jpg
2759,Dick,1999,1090805-dick,6.3,70,49,21,70,6.6,26,19,7,73,2.7,3840,45,http://content6.flixster.com/movie/25/93/259320_det.jpg
2761,The Iron Giant,1999,iron_giant,8,111,108,3,97,7.7,31,30,1,96,3.3,17836,72,http://content8.flixster.com/movie/10/93/88/10938822_det.jpg
2762,The Sixth Sense,1999,sixth_sense,7.4,126,107,19,84,6.8,28,22,6,78,3.8,100968,87,http://content8.flixster.com/movie/25/38/253818_det.jpg
2763,The Thomas Crown Affair,1999,thomas_crown_affair_the,6.4,88,59,29,67,6.6,25,18,7,72,3.3,15699,71,http://content8.flixster.com/movie/26/71/267198_det.jpg
2764,The Thomas Crown Affair,1999,thomas_crown_affair_the,6.4,88,59,29,67,6.6,25,18,7,72,3.3,15699,71,http://content8.flixster.com/movie/26/71/267198_det.jpg
2765,The Acid House,1998,acid_house,5.8,19,9,10,47,0,2,1,1,50,3.5,2715,68,http://content8.flixster.com/movie/28/89/288918_det.jpg
2766,The Adventures of Sebastian Cole,1998,adventures_of_sebastian_cole,5.7,22,9,13,40,6.6,5,4,1,80,0,0,0,http://content8.flixster.com/movie/31/11/311110_det.jpg
2767,Illuminata,1998,illuminata,5.6,23,9,14,39,5.5,7,3,4,42,3.4,320,64,http://content8.flixster.com/movie/27/56/275614_det.jpg
2768,Stiff Upper Lips,1998,stiff-upper-lips,4.8,7,2,5,28,0,0,0,0,0,0,0,0,http://content7.flixster.com/movie/10/88/75/10887501_det.jpg
2769,The Whole Ten Yards,2004,whole_ten_yards,2.8,116,5,111,4,3.3,31,2,29,6,3,11437,51,http://content8.flixster.com/movie/55/37/07/5537078_det.jpg
2770,Bowfinger,1999,bowfinger,7.1,107,85,22,79,7.3,26,23,3,88,2.8,8721,49,http://content8.flixster.com/movie/55/09/68/5509686_det.jpg
2771,Brokedown Palace,1999,brokedown_palace,4.7,34,10,24,29,6,5,3,2,60,3.2,4980,66,http://content9.flixster.com/movie/25/95/259523_det.jpg
2772,Detroit Rock City,1999,detroit_rock_city,5.4,36,17,19,47,4.6,5,1,4,20,3.5,9815,80,http://content9.flixster.com/movie/11/15/17/11151771_det.jpg
2773,Alice et Martin,1998,alice-et-martin-alice-and-martin,6.3,42,26,16,61,6.6,13,10,3,76,3.4,246,51,http://content7.flixster.com/movie/10/14/06/10140645_det.jpg
2774,Better Than Chocolate,1999,better_than_chocolate,5.8,21,8,13,38,0,4,1,3,25,3.8,3884,78,http://content8.flixster.com/movie/10/89/25/10892522_det.jpg
2775,Gegen die Wand,2004,punk-drunk-love-the-images-of-mick-rock,0,0,0,0,0,0,0,0,0,0,0,0,0,http://content8.flixster.com/movie/10/88/57/10885794_det.jpg
2776,"Marcello Mastroianni: mi ricordo, s√¨, io mi ricordo",1997,marcello-mastroianni-i-remember,7.8,7,7,0,100,0,1,1,0,100,3,175,48,http://content9.flixster.com/movie/11/12/42/11124239_det.jpg
2777,Cobra,1986,1004407-cobra,2.5,14,1,13,7,0,3,1,2,33,2.7,5821,43,http://content7.flixster.com/movie/27/54/275401_det.jpg
2778,Never Talk to Strangers,1995,never_talk_to_strangers,3.6,20,3,17,15,5,5,2,3,40,2.8,1191,41,http://content7.flixster.com/movie/10/91/88/10918861_det.jpg
2779,Heaven Can Wait,1943,1009426-heaven_can_wait,7.8,9,8,1,88,0,0,0,0,0,0,0,0,http://content6.flixster.com/movie/28/70/287004_det.jpg
2780,The Raven,1963,1017222-raven,6.4,9,8,1,88,0,0,0,0,0,0,0,0,http://content6.flixster.com/movie/10/84/02/10840228_det.jpg
2781,The Tingler,1959,tingler,5.9,14,10,4,71,0,0,0,0,0,0,0,0,http://content9.flixster.com/movie/10/93/55/10935575_det.jpg
2782,Pit and the Pendulum,1961,1016369-pit_and_the_pendulum,6.4,14,11,3,78,0,0,0,0,0,0,0,0,http://content6.flixster.com/movie/10/93/87/10938728_det.jpg
2783,The Tomb of Ligeia,1964,tomb_of_ligeia,6.4,6,5,1,83,0,0,0,0,0,0,0,0,http://content8.flixster.com/movie/10/87/58/10875838_det.jpg
2784,The Masque of the Red Death,1964,1013485-masque_of_the_red_death,5.9,12,7,5,58,0,0,0,0,0,0,0,0,http://content7.flixster.com/movie/10/84/01/10840125_det.jpg
2785,Tales of Terror,1962,1021067-terror,6.1,10,6,4,60,0,0,0,0,0,0,0,0,http://content9.flixster.com/movie/10/93/55/10935515_det.jpg
2786,Haunted Honeymoon,1986,haunted_honeymoon,3.5,8,2,6,25,0,0,0,0,0,0,0,0,http://content6.flixster.com/movie/10/89/43/10894380_det.jpg
2787,Cat's Eye,1985,cats_eye,5.5,23,15,8,65,0,3,2,1,66,3.1,5931,52,http://content9.flixster.com/movie/25/76/257699_det.jpg
2788,And Now for Something Completely Different,1971,and_now_for_something_completely_different,6.9,19,17,2,89,0,2,1,1,50,3.8,16003,85,http://content6.flixster.com/movie/10/93/78/10937840_det.jpg
2789,Damien: Omen II,1978,damien_1978,0,0,0,0,0,0,0,0,0,0,0,0,0,http://images.rottentomatoescdn.com/images/defaults/poster_default.gif
2790,Earth: Final Conflict,1997,,\N,\N,\N,\N,\N,\N,\N,\N,\N,\N,\N,\N,\N,\N
2791,Airplane!,1980,airplane,8.3,49,48,1,97,7.8,5,5,0,100,3.6,31137,85,http://content6.flixster.com/movie/10/86/76/10867612_det.jpg
2792,Airplane II: The Sequel,1982,airplane_2_the_sequel,5.2,18,7,11,38,0,1,0,1,0,2.9,10524,52,http://content7.flixster.com/movie/25/57/255793_det.jpg
2793,An American Werewolf in Paris,1997,american_werewolf_in_paris,3.7,25,2,23,8,4.5,6,1,5,16,2.8,10235,38,http://content7.flixster.com/movie/10/85/06/10850689_det.jpg
2794,European Vacation,1985,national_lampoons_european_vacation,4.8,20,8,12,40,0,0,0,0,0,0,0,0,http://content9.flixster.com/movie/25/78/257823_det.jpg
2795,Vacation,1983,national_lampoons_vacation,7.3,34,32,2,94,0,3,3,0,100,3.5,11330,80,http://content6.flixster.com/movie/27/14/271424_det.jpg
2796,Funny Farm,1988,1007990-funny_farm,5.2,17,11,6,64,0,1,1,0,100,2.9,2927,51,http://content9.flixster.com/movie/10/95/43/10954319_det.jpg
2797,Big,1988,big,7.9,52,50,2,96,6.8,5,4,1,80,3.4,33658,73,http://content9.flixster.com/movie/10/83/88/10838839_det.jpg
2798,Problem Child 2,1991,problem_child_2,2.6,12,2,10,16,0,1,0,1,0,0,0,0,http://content7.flixster.com/movie/24/82/39/2482393_det.jpg
2799,Problem Child 2,1991,problem_child_2,2.6,12,2,10,16,0,1,0,1,0,0,0,0,http://content7.flixster.com/movie/24/82/39/2482393_det.jpg
2800,Little Nemo: Adventures in Slumberland,1989,little_nemo_adventures_in_slumberland,0,0,0,0,0,0,0,0,0,0,0,0,0,http://content9.flixster.com/movie/29/40/294019_det.jpg
2801,Oscar and Lucinda,1997,oscar_and_lucinda,6.6,31,20,11,64,7.8,7,6,1,85,0,0,0,http://content7.flixster.com/movie/27/55/275505_det.jpg
2802,Tequila Sunrise,1988,tequila_sunrise,5.1,18,9,9,50,0,3,0,3,0,2.9,3959,44,http://content7.flixster.com/movie/27/06/270697_det.jpg
2803,The Pelican Brief,1993,pelican_brief,5.5,47,25,22,53,5.5,7,3,4,42,3.2,12632,62,http://content8.flixster.com/movie/10/91/79/10917978_det.jpg
2804,A Christmas Story,1983,1004151-christmas_story,8.3,43,38,5,88,0,3,2,1,66,3.7,23109,82,http://content6.flixster.com/movie/10/93/70/10937040_det.jpg
2805,Mickey Blue Eyes,1999,mickey_blue_eyes,5.4,72,32,40,44,5.1,22,8,14,36,2.7,6320,39,http://content7.flixster.com/movie/26/13/261301_det.jpg
2806,Teaching Mrs. Tingle,1999,teaching_mrs_tingle,4,68,13,55,19,4,24,5,19,20,2.5,4339,34,http://content8.flixster.com/movie/26/66/266698_det.jpg
2807,Universal Soldier: The Return,1999,,2.8,51,3,48,5,3.6,17,3,14,17,2.4,4533,35,http://content8.flixster.com/movie/11/14/54/11145414_det.jpg
2808,Universal Soldier,1992,universal_soldier,4.2,23,5,18,21,4.3,7,2,5,28,2.8,9415,48,http://content9.flixster.com/movie/11/14/54/11145415_det.jpg
2809,Love Stinks,1999,love_stinks,3.5,47,9,38,19,3.8,16,3,13,18,3.2,1225,66,http://content6.flixster.com/movie/27/25/272528_det.jpg
2810,Perfect Blue,1998,perfect-blue,6.4,22,14,8,63,0,2,1,1,50,3.9,4350,86,http://content8.flixster.com/movie/28/66/286610_det.jpg
2811,With Friends Like These...,1998,1093923-with_friends_like_these,5.4,14,7,7,50,4.7,5,2,3,40,2.6,46,33,http://content7.flixster.com/movie/10/89/19/10891933_det.jpg
2812,In Too Deep,1999,1092437-in_too_deep,4.9,55,20,35,36,5.8,20,10,10,50,3.6,1315,76,http://content7.flixster.com/movie/27/19/271909_det.jpg
2813,The Source,1999,jack-kerouac-king-of-the-beats,0,0,0,0,0,0,0,0,0,0,0,0,0,http://content7.flixster.com/movie/10/88/47/10884793_det.jpg
2814,The Vampire Bat,1933,vampire_bat,0,4,2,2,50,0,0,0,0,0,0,0,0,http://content6.flixster.com/movie/10/28/56/10285636_det.jpg
2815,Iron Eagle,1986,iron_eagle,3.6,5,2,3,40,0,0,0,0,0,0,0,0,http://content9.flixster.com/movie/25/86/258699_det.jpg
2816,Iron Eagle II,1988,iron_eagle_2,0,1,0,1,0,0,0,0,0,0,0,0,0,http://content8.flixster.com/movie/21/00/21/2100214_det.jpg
2817,Aces: Iron Eagle III,1992,iron_eagle_3_aces,2.2,6,0,6,0,0,1,0,1,0,2.5,1084,27,http://content9.flixster.com/movie/10/88/33/10883351_det.jpg
2818,Iron Eagle IV,1995,iron_eagle_4,0,0,0,0,0,0,0,0,0,0,0,0,0,http://content6.flixster.com/movie/26/25/262504_det.jpg
2819,Three Days of the Condor,1975,three_days_of_the_condor,7,37,32,5,86,0,4,2,2,50,3.8,3200,83,http://content9.flixster.com/movie/26/72/267291_det.jpg
2820,Hamlet,1996,1075422-hamlet,8.2,54,51,3,94,7.2,14,11,3,78,3.8,5816,86,http://content7.flixster.com/movie/10/94/26/10942625_det.jpg
2821,Male and Female,1919,male-or-female2004,0,0,0,0,0,0,0,0,0,0,0,0,0,http://content6.flixster.com/movie/10/84/74/10847448_det.jpg
2822,Medicine Man,1992,1038176-medicine_man,3.9,18,4,14,22,0,2,0,2,0,2.9,3697,51,http://content8.flixster.com/movie/25/62/256214_det.jpg
2823,"Die Spinnen, 1. Teil - Der Goldene See",1919,spiders_part_1_the_the_golden_lake,0,3,3,0,100,0,0,0,0,0,0,0,0,http://content7.flixster.com/movie/10/88/31/10883105_det.jpg
2824,On the Ropes,1999,on_the_ropes,7.6,13,12,1,92,0,3,3,0,100,3.3,155,63,http://content6.flixster.com/movie/30/55/305516_det.jpg
2825,Ring Around the Rosie,2006,ring_around_the_rosie,0,3,0,3,0,0,0,0,0,0,0,0,0,http://content6.flixster.com/movie/10/93/59/10935900_det.jpg
2826,The 13th Warrior,1999,13th_warrior,4.6,86,28,58,32,4.9,18,7,11,38,3.2,24204,66,http://content7.flixster.com/movie/10/87/23/10872325_det.jpg
2827,The Astronaut's Wife,1999,astronauts_wife,4.2,57,9,48,15,4.6,18,5,13,27,2.8,11206,42,http://content9.flixster.com/movie/27/36/273627_det.jpg
2829,The Muse,1999,muse,5.9,76,39,37,51,5.6,23,10,13,43,2.6,1169,29,http://content6.flixster.com/movie/26/39/263996_det.jpg
2830,Bure baruta,1998,cabaret_balkan,7.8,13,11,2,84,0,4,4,0,100,3.8,311,78,http://content9.flixster.com/movie/14/81/25/1481255_det.jpg
2831,A Dog of Flanders,1999,1094164-dog_of_flanders,4.5,23,4,19,17,0,3,0,3,0,3.7,259,76,http://content7.flixster.com/movie/10/88/37/10883709_det.jpg
2832,The Lost Son,1999,1106080-lost_son,0,3,2,1,66,0,0,0,0,0,0,0,0,http://content6.flixster.com/movie/85/73/81/8573816_det.jpg
2833,Lucie Aubrac,1997,lucie_aubrac,7,22,17,5,77,7,7,5,2,71,3.6,169,67,http://content8.flixster.com/movie/10/94/29/10942906_det.jpg
2834,"Martha - Meet Frank, Daniel and Laurence",1998,very_thought_of_you,5.1,8,3,5,37,0,1,0,1,0,3.3,1423,59,http://content7.flixster.com/movie/10/88/40/10884009_det.jpg
2835,Chill Factor,1999,chill_factor,3.3,72,5,67,6,3,23,0,23,0,2.7,2079,36,http://content9.flixster.com/movie/10/89/85/10898575_det.gif
2836,Outside Providence,1999,outside_providence,5.6,74,37,37,50,6.2,24,15,9,62,3.2,1355,60,http://content8.flixster.com/movie/26/89/268914_det.jpg
2837,Bedrooms and Hallways,1998,bedrooms_and_hallways,6.3,13,9,4,69,0,1,1,0,100,3.6,615,70,http://content6.flixster.com/movie/45/37/453700_det.jpg
2839,West Beyrouth (√Ä l'abri les enfants),1998,west_beirut,7.2,15,14,1,93,0,1,1,0,100,4.3,382,92,http://content8.flixster.com/movie/10/88/50/10885030_det.jpg
2840,Stigmata,1999,stigmata,4,88,19,69,21,3.2,24,3,21,12,3.1,12281,65,http://content6.flixster.com/movie/12/87/29/1287292_det.jpg
2841,Stir of Echoes,1999,stir_of_echoes,6.4,103,69,34,66,6.4,25,18,7,72,3.4,14833,69,http://content8.flixster.com/movie/11/12/40/11124030_det.gif
2842,Best Laid Plans,1999,best_laid_plans,5.8,20,9,11,45,0,4,2,2,50,3.1,1229,43,http://content6.flixster.com/movie/28/14/281492_det.jpg
2843,"Crna macka, beli macor",1998,black_cat_white_cat,6.9,18,16,2,88,0,2,2,0,100,4.4,6471,94,http://content7.flixster.com/movie/10/83/83/10838389_det.jpg
2844,The Minus Man,1999,minus_man,5.9,34,20,14,58,6.7,8,6,2,75,3,1065,43,http://content7.flixster.com/movie/27/49/274997_det.jpg
2845,Whiteboyz,1999,whiteboyz,4,15,2,13,13,0,3,0,3,0,2.6,58,27,http://content7.flixster.com/movie/10/87/95/10879541_det.jpg
2846,Koneko monogatari,1986,the-adventures-of-milo-otis,6.6,9,7,2,77,0,0,0,0,0,0,0,0,http://content8.flixster.com/movie/11/15/03/11150394_det.jpg
2847,Only Angels Have Wings,1939,only_angels_have_wings,8.4,11,11,0,100,0,1,1,0,100,3.8,1509,78,http://content7.flixster.com/movie/29/52/295293_det.jpg
2848,Othello,1995,1069707-othello,6.3,38,26,12,68,6.1,11,7,4,63,3.3,2018,66,http://content6.flixster.com/movie/10/92/98/10929892_det.jpg
2849,Queens Logic,1991,queens_logic,5.2,7,3,4,42,0,2,0,2,0,2.9,360,29,http://content8.flixster.com/movie/31/10/311094_det.jpg
2850,Wayne's World,1992,waynes_world,6.8,45,38,7,84,6.4,7,5,2,71,3.4,45784,80,http://content7.flixster.com/movie/59/51/42/5951425_det.jpg
2851,Saturn 3,1980,saturn_3,3.8,7,1,6,14,0,1,0,1,0,0,0,0,http://content9.flixster.com/movie/27/50/275019_det.jpg
2852,A Soldier's Story,1984,soldiers_story,7.2,16,14,2,87,0,2,0,2,0,3.7,1759,80,http://content6.flixster.com/movie/25/74/257496_det.jpg
2853,Communion,1976,alice_sweet_alice,0,3,2,1,66,0,0,0,0,0,0,0,0,http://content9.flixster.com/movie/27/88/278819_det.jpg
2854,The Forgotten,1973,dont_look_in_the_basement,0,4,0,4,0,0,0,0,0,0,0,0,0,http://content6.flixster.com/movie/10/90/56/10905636_det.jpg
2855,The Power of Nightmares: The Rise of the Politics of Fear,2004,power_of_nightmares_the_rise_of_the_politics_of_fear,8.1,7,6,1,85,8,5,4,1,80,4.5,575,96,http://content6.flixster.com/movie/10/89/72/10897244_det.jpg
2856,I Saw What You Did,1965,i-saw-what-you-did,0,1,0,1,0,0,0,0,0,0,0,0,0,http://content6.flixster.com/movie/30/80/308092_det.jpg
2857,Yellow Submarine,1968,beatles_the_yellow_submarine,7.6,36,34,2,94,7.2,8,7,1,87,3.6,7369,82,http://content6.flixster.com/movie/10/93/36/10933636_det.jpg
2858,American Beauty,1999,american_beauty,8,151,134,17,88,7.8,32,29,3,90,3.8,115181,90,http://content9.flixster.com/movie/55/05/64/5505643_det.jpg
2859,Stop Making Sense,1984,stop-making-sense,8.8,29,28,1,96,0,3,3,0,100,4.4,1700,95,http://content9.flixster.com/movie/10/91/02/10910247_det.jpg
2860,Blue Streak,1999,blue_streak,4.8,68,24,44,35,4.4,20,6,14,30,3,13413,65,http://content8.flixster.com/movie/10/86/76/10867638_det.jpg
2861,For Love of the Game,1999,for_love_of_the_game,6.3,55,35,20,63,6,8,4,4,50,3.3,6328,74,http://content9.flixster.com/movie/25/61/256191_det.jpg
2862,Caligola,1979,caligula,2.9,28,6,22,21,0,3,0,3,0,2.8,3230,42,http://content6.flixster.com/movie/28/57/285700_det.jpg
2863,A Hard Day's Night,1964,beatles_a_hard_days_night,8.2,72,72,0,100,7.9,22,22,0,100,3.9,9274,87,http://content8.flixster.com/movie/25/09/250902_det.jpg
2864,American Splendor,2003,american_splendor,8.3,178,167,11,93,8.6,42,42,0,100,3.7,9157,85,http://content9.flixster.com/movie/10/85/16/10851667_det.jpg
2865,Sugar Town,1999,sugar_town,6.2,24,16,8,66,5.9,6,3,3,50,3,177,41,http://content6.flixster.com/movie/31/01/69/3101692_det.jpg
2866,The Buddy Holly Story,1978,buddy_holly_story,7.3,15,15,0,100,0,0,0,0,0,0,0,0,http://content8.flixster.com/movie/25/85/258502_det.jpg
2867,Fright Night,1985,1007910-fright_night,7.3,27,25,2,92,0,3,2,1,66,3.3,7746,70,http://content8.flixster.com/movie/10/91/56/10915658_det.jpg
2868,Fright Night Part 2,1988,fright-night-part-2,4.7,6,2,4,33,0,0,0,0,0,0,0,0,http://content7.flixster.com/movie/10/91/56/10915657_det.jpg
2869,La s√©paration,1994,,\N,\N,\N,\N,\N,\N,\N,\N,\N,\N,\N,\N,\N,\N
2870,Barefoot in the Park,1967,barefoot_in_the_park,6.4,13,11,2,84,0,1,0,1,0,3.7,3074,77,http://content6.flixster.com/movie/10/88/84/10888420_det.jpg
2871,Deliverance,1972,deliverance,8.5,50,47,3,94,5.8,5,2,3,40,3.6,10182,79,http://content7.flixster.com/movie/26/75/267521_det.jpg
2872,Excalibur,1981,excalibur,7.3,25,20,5,80,0,3,1,2,33,3.4,11195,74,http://content9.flixster.com/movie/26/79/267991_det.jpg
2873,Lulu on the Bridge,1998,lulu_on_the_bridge,3.6,8,0,8,0,0,1,0,1,0,0,0,0,http://content7.flixster.com/movie/10/87/69/10876949_det.jpg
2874,The Pajama Game,1957,the-pajama-game,7.4,10,9,1,90,0,0,0,0,0,0,0,0,http://content7.flixster.com/movie/95/84/10/9584109_det.jpg
2875,Sommersby,1993,sommersby,5.9,23,14,9,60,7,6,5,1,83,3.1,2582,55,http://content8.flixster.com/movie/25/92/259218_det.jpg
2876,Thumbelina,1994,1048880-thumbelina,5.2,8,2,6,25,0,2,1,1,50,3.1,9634,64,http://content8.flixster.com/movie/11/14/33/11143398_det.jpg
2877,Tommy,1975,1021648-tommy,7.1,15,13,2,86,0,1,1,0,100,3.4,5178,71,http://content6.flixster.com/movie/25/56/255628_det.jpg
2878,Hell Night,1981,hell_night,4.5,6,3,3,50,0,1,0,1,0,3,927,45,http://content9.flixster.com/movie/27/07/270799_det.jpg
2879,Fei ying gai wak,1991,operation_condor,6.4,32,22,10,68,6.5,13,11,2,84,3.2,3303,65,http://content8.flixster.com/movie/10/87/95/10879542_det.jpg
2880,Long xiong hu di,1987,operation-condor-2-the-armour-of-the-gods,6.6,8,6,2,75,0,0,0,0,0,0,0,0,http://content8.flixster.com/movie/11/15/20/11152098_det.jpg
2881,Double Jeopardy,1999,1093614-double_jeopardy,4.4,83,21,62,25,4.1,21,4,17,19,3.2,12512,68,http://content6.flixster.com/movie/26/97/269724_det.jpg
2882,Jakob the Liar,1999,jakob_the_liar,4.7,71,21,50,29,4.9,22,7,15,31,3.2,3128,63,http://content6.flixster.com/movie/26/15/261596_det.jpg
2883,Mumford,1999,mumford,5.9,76,42,34,55,6.7,21,14,7,66,3.2,1155,62,http://content7.flixster.com/movie/10/86/70/10867013_det.jpg
2884,Dog Park,1998,dog_park,4.5,24,8,16,33,4.6,5,1,4,20,2.7,600,30,http://content7.flixster.com/movie/48/44/46/4844465_det.jpg
2885,Guinevere,1999,1093738-guinevere,6.8,33,28,5,84,7.9,8,8,0,100,3,490,45,http://content9.flixster.com/movie/28/18/281823_det.jpg
2886,The Adventures of Elmo in Grouchland,1999,adventures_of_elmo_in_grouchland,6.7,42,32,10,76,6.3,11,7,4,63,3.2,1136,60,http://content8.flixster.com/movie/25/14/251406_det.jpg
2887,Simon Sez,1999,simon_sez,1.9,18,0,18,0,2.4,5,0,5,0,2.2,603,21,http://content8.flixster.com/movie/26/52/265298_det.jpg
2888,She Drives Me Crazy,2007,,\N,\N,\N,\N,\N,\N,\N,\N,\N,\N,\N,\N,\N,\N
2889,"Mystery, Alaska",1999,mystery_alaska,4.9,78,29,49,37,5.1,26,11,15,42,3.2,4196,66,http://content6.flixster.com/movie/26/75/267504_det.jpg
2890,Three Kings,1999,three_kings,7.8,126,118,8,93,7.5,28,25,3,89,3.3,21498,70,http://content8.flixster.com/movie/26/78/267806_det.jpg
2891,"Happy, Texas",1999,happy_texas,6.7,50,41,9,82,7.4,11,11,0,100,3.1,1535,53,http://content6.flixster.com/movie/10/88/50/10885052_det.jpg
2892,New Rose Hotel,1998,new_rose_hotel,4.2,16,3,13,18,0,2,0,2,0,2.9,682,40,http://content8.flixster.com/movie/10/87/04/10870498_det.jpg
2893,Plunkett & Macleane,1999,,4.7,27,7,20,25,4.4,7,1,6,14,3.3,1388,66,http://content7.flixster.com/movie/27/81/278109_det.jpg
2894,Romance,1999,1092147-romance,5.1,31,14,17,45,5.2,8,4,4,50,3,1725,46,http://content7.flixster.com/movie/28/58/285813_det.jpg
2895,Napoleon and Samantha,1972,napoleon_and_samantha,0,3,2,1,66,0,0,0,0,0,0,0,0,http://content6.flixster.com/movie/10/92/47/10924780_det.jpg
2896,Alvarez Kelly,1966,alvarez_kelly,0,3,2,1,66,0,0,0,0,0,0,0,0,http://content7.flixster.com/movie/10/90/21/10902169_det.jpg
2897,E la nave va,1983,and_the_ship_sails_on,6.8,9,8,1,88,0,2,1,1,50,0,0,0,http://content8.flixster.com/movie/10/88/28/10882818_det.jpg
2898,The Dark Half,1993,dark_half,5.8,17,10,7,58,0,3,0,3,0,3,2007,43,http://content9.flixster.com/movie/27/95/279515_det.jpg
2899,Gulliver's Travels,1939,1009027-gullivers_travels,6.6,10,7,3,70,0,0,0,0,0,0,0,0,http://content6.flixster.com/movie/11/13/27/11132708_det.jpg
2900,Monkey Shines,1988,monkey_shines,5.4,26,13,13,50,5.4,5,2,3,40,2.9,1393,41,http://content8.flixster.com/movie/28/06/280606_det.jpg
2901,Phantasm,1979,phantasm,6.2,35,22,13,62,0,3,3,0,100,3.4,4777,68,http://content9.flixster.com/movie/26/97/269727_det.jpg
2902,American Psycho II: All American Girl,2002,,3.1,9,1,8,11,0,0,0,0,0,0,0,0,http://content6.flixster.com/movie/10/92/96/10929652_det.jpg
2903,Psycho III,1986,psycho_3,5.2,17,10,7,58,0,4,2,2,50,2.6,2593,31,http://content6.flixster.com/movie/10/87/89/10878988_det.jpg
2904,Singin' in the Rain,1952,singin_in_the_rain,9.2,44,44,0,100,8.8,9,9,0,100,3.9,28033,91,http://content7.flixster.com/movie/10/93/77/10937761_det.jpg
2905,Tsubaki Sanj√ªr√¥,1962,sanjuro,8.3,15,15,0,100,0,1,1,0,100,4.2,4523,94,http://content7.flixster.com/movie/39/91/11/3991117_det.jpg
2906,Random Hearts,1999,random_hearts,4,87,13,74,14,4.1,26,4,22,15,2.7,2118,28,http://content9.flixster.com/movie/10/88/83/10888351_det.jpg
2907,Superstar,1999,1093874-superstar,4.5,72,24,48,33,4.1,21,6,15,28,2.9,11034,63,http://content7.flixster.com/movie/10/84/02/10840237_det.jpg
2908,Boys Don't Cry,1999,boys_dont_cry,7.9,73,64,9,87,7.9,22,19,3,86,3.7,16491,85,http://content8.flixster.com/movie/10/89/13/10891334_det.jpg
2910,L'ennui,1998,l_ennui,5.5,13,7,6,53,0,2,1,1,50,3,60,50,http://content7.flixster.com/movie/10/92/41/10924117_det.jpg
2911,El abuelo,1998,,\N,\N,\N,\N,\N,\N,\N,\N,\N,\N,\N,\N,\N,\N
2912,The Limey,1999,limey,7.4,79,72,7,91,7.7,24,23,1,95,3.6,4089,76,http://content9.flixster.com/movie/27/28/272899_det.jpg
2913,The Mating Habits of the Earthbound Human,1999,mating_habits_of_the_earthbound_human,4.3,12,4,8,33,0,1,0,1,0,3.5,709,72,http://content7.flixster.com/movie/10/90/03/10900365_det.jpg
2914,The Haunting of Molly Hartley,2008,haunting_of_molly_hartley,2.9,34,1,33,2,3.8,8,1,7,12,2.6,18564,23,http://content8.flixster.com/movie/10/87/77/10877710_det.jpg
2915,Risky Business,1983,1017641-risky_business,7.4,43,42,1,97,7.7,6,6,0,100,3.2,11638,61,http://content9.flixster.com/movie/26/90/269091_det.jpg
2916,Total Recall,1990,total_recall,7.2,42,34,8,80,6.8,8,6,2,75,3.3,25031,70,http://content9.flixster.com/movie/28/47/284795_det.jpg
2917,Body Heat,1981,1002830-body_heat,8,36,35,1,97,8.4,5,5,0,100,3.5,2581,74,http://content9.flixster.com/movie/26/85/268519_det.jpg
2918,Ferris Bueller's Day Off,1986,ferris_buellers_day_off,7.4,46,37,9,80,0,4,1,3,25,3.8,77618,89,http://content8.flixster.com/movie/45/46/59/4546598_det.jpg
2919,The Year of Living Dangerously,1982,year_of_living_dangerously,7.4,25,22,3,88,0,1,0,1,0,3.5,2161,73,http://content6.flixster.com/movie/10/88/57/10885704_det.jpg
2920,Les enfants du paradis,1945,children-of-paradise,9,21,20,1,95,8.6,5,5,0,100,4.4,2292,94,http://content6.flixster.com/movie/29/61/296100_det.jpg
2921,High Plains Drifter,1973,high_plains_drifter,7.7,23,22,1,95,0,3,2,1,66,3.7,6781,83,http://content9.flixster.com/movie/26/80/268023_det.jpg
2922,Hang 'Em High,1968,hang_em_high,6.5,14,13,1,92,0,1,1,0,100,3.5,5541,71,http://content9.flixster.com/movie/25/66/256603_det.jpg
2923,Handle with Care,1977,citizens_band,0,4,4,0,100,0,0,0,0,0,0,0,0,http://content7.flixster.com/movie/10/95/65/10956529_det.jpg
2924,Jui kuen II,1994,legend_of_drunken_master,7,74,61,13,82,7.1,24,20,4,83,3.6,7905,83,http://content7.flixster.com/movie/10/93/12/10931221_det.jpg
2925,Il conformista,1970,conformist,8.8,40,40,0,100,8.4,9,9,0,100,4.3,2418,92,http://content9.flixster.com/movie/31/35/313515_det.jpg
2926,Hairspray,2007,hairspray,7.7,205,186,19,90,8,41,40,1,97,3.9,382832,84,http://content6.flixster.com/movie/87/30/58/8730580_det.jpg
2927,Brief Encounter,1945,1003094-brief_encounter,8.1,29,25,4,86,0,3,2,1,66,4.2,3485,91,http://content8.flixster.com/movie/10/91/79/10917982_det.jpg
2928,The Razor's Edge,1984,1017238-razors_edge,5.4,15,8,7,53,0,1,0,1,0,3.7,879,77,http://content9.flixster.com/movie/25/71/257127_det.jpg
2929,Trois couleurs: Rouge,1994,1058966-red,8.5,40,40,0,100,8.2,10,10,0,100,4.2,9557,94,http://content7.flixster.com/movie/10/87/54/10875473_det.jpg
2930,Return with Honor,1998,,\N,\N,\N,\N,\N,\N,\N,\N,\N,\N,\N,\N,\N,\N
2931,Dom za vesanje,1988,a-time-of-gypsies-dom-za-vesanje,7.1,5,5,0,100,0,2,2,0,100,4.5,2705,96,http://content8.flixster.com/movie/10/86/20/10862022_det.jpg
2932,Days of Heaven,1978,days_of_heaven,7.9,36,33,3,91,7.3,7,5,2,71,4.2,4575,89,http://content9.flixster.com/movie/10/88/61/10886175_det.jpg
2933,Le feu follet,1963,le-feu-follet-a-time-to-live-and-a-time-to-die-the-fire-within,7.7,10,9,1,90,0,3,3,0,100,4.3,616,90,http://content6.flixster.com/movie/10/92/43/10924388_det.jpg
2934,El amor brujo,1986,el_amor_brujo,0,2,2,0,100,0,0,0,0,0,0,0,0,http://content9.flixster.com/movie/11/14/27/11142735_det.jpg
2935,The Lady Eve,1941,lady_eve,8.6,28,28,0,100,0,4,4,0,100,4.1,2031,89,http://content8.flixster.com/movie/28/70/287010_det.jpg
2936,Sullivan's Travels,1941,sullivans_travels,8.7,29,29,0,100,0,2,2,0,100,4.2,2289,90,http://content7.flixster.com/movie/29/34/293401_det.jpg
2937,The Palm Beach Story,1942,palm_beach_story,8.6,21,21,0,100,0,3,3,0,100,3.9,975,83,http://content8.flixster.com/movie/10/88/25/10882522_det.jpg
2938,Hombre mirando al sudeste,1986,man_facing_southeast,0,4,4,0,100,0,0,0,0,0,0,0,0,http://content8.flixster.com/movie/10/89/08/10890874_det.jpg
2939,Niagara,1953,niagara,6.2,10,8,2,80,0,0,0,0,0,0,0,0,http://content6.flixster.com/movie/10/85/38/10853848_det.jpg
2940,Gilda,1946,gilda,7.7,15,14,1,93,0,0,0,0,0,0,0,0,http://content8.flixster.com/movie/10/90/09/10900998_det.jpg
2941,South Pacific,1958,south_pacific,6.7,8,7,1,87,0,0,0,0,0,0,0,0,http://content9.flixster.com/movie/29/07/290707_det.jpg
2942,Flashdance,1983,flashdance,4.7,34,10,24,29,4.6,5,1,4,20,3.2,16331,63,http://content8.flixster.com/movie/55/36/59/5536594_det.jpg
2943,Indochine,1992,indochine,6.3,17,12,5,70,0,2,1,1,50,3.9,1905,84,http://content8.flixster.com/movie/25/80/258014_det.jpg
2944,The Dirty Dozen,1967,dirty_dozen,7.9,21,20,1,95,0,2,2,0,100,3.8,7219,86,http://content8.flixster.com/movie/10/93/77/10937770_det.jpg
2945,Mike's Murder,1984,mikes_murder,0,4,2,2,50,0,0,0,0,0,0,0,0,http://content8.flixster.com/movie/10/91/93/10919302_det.jpg
2946,Help!,1965,beatles_the_help,7.3,22,20,2,90,0,2,1,1,50,3.8,5947,85,http://content8.flixster.com/movie/10/93/69/10936982_det.jpg
2947,Goldfinger,1964,goldfinger,8.4,48,46,2,95,7.9,6,5,1,83,3.6,22155,83,http://content7.flixster.com/movie/26/38/263829_det.jpg
2948,From Russia with Love,1963,from_russia_with_love,7.9,45,43,2,95,7.8,5,5,0,100,3.6,17619,79,http://content6.flixster.com/movie/10/93/43/10934304_det.jpg
2949,Dr. No,1962,dr_no,7.6,42,41,1,97,0,4,4,0,100,3.5,19811,78,http://content9.flixster.com/movie/25/69/256991_det.jpg
2950,The Blue Lagoon,1980,blue_lagoon,2.7,17,2,15,11,0,4,1,3,25,2.8,7063,55,http://content8.flixster.com/movie/10/92/42/10924290_det.jpg
2951,Per un pugno di dollari,1964,fistful_of_dollars,8.1,35,34,1,97,0,3,3,0,100,3.8,21677,87,http://content6.flixster.com/movie/26/94/269416_det.jpg
2952,Sydney,1996,hard_eight,6.9,32,26,6,81,7.1,11,9,2,81,3.7,3180,81,http://content8.flixster.com/movie/27/33/273322_det.jpg
2953,Home Alone 2: Lost in New York,1992,home_alone_2_lost_in_new_york,3.6,24,5,19,20,0,2,1,1,50,3,41991,62,http://content9.flixster.com/movie/25/40/254003_det.jpg
2954,Penitentiary,1979,penitentiary,0,1,0,1,0,0,0,0,0,0,0,0,0,http://content7.flixster.com/movie/10/85/19/10851985_det.jpg
2955,Penitentiary II,1982,penitentiary_2,0,1,0,1,0,0,0,0,0,0,0,0,0,http://content7.flixster.com/movie/27/74/277425_det.jpg
2956,Someone to Watch Over Me,1987,someone_to_watch_over_me,6.2,17,14,3,82,0,1,0,1,0,3,863,38,http://content9.flixster.com/movie/11/13/30/11133063_det.gif
2958,Naturally Native,1998,naturally-native,0,0,0,0,0,0,0,0,0,0,0,0,0,http://content8.flixster.com/movie/10/89/27/10892702_det.jpg
2959,Fight Club,1999,fight_club,7.3,149,120,29,80,5.9,27,17,10,62,4.2,268913,95,http://content9.flixster.com/movie/10/93/45/10934563_det.jpg
2960,Beefcake,1998,beefcake,5.4,7,4,3,57,0,2,1,1,50,3.4,279,63,http://content8.flixster.com/movie/29/56/295698_det.jpg
2961,The Story of Us,1999,story_of_us,4.5,81,23,58,28,4.1,25,4,21,16,3,5089,57,http://content8.flixster.com/movie/26/82/268222_det.jpg
2962,Fever Pitch,2005,fever_pitch,6.2,172,110,62,63,6,38,19,19,50,3,14004,62,http://content7.flixster.com/movie/24/97/249737_det.jpg
2963,Joe the King,1999,joe_the_king,6,24,15,9,62,5.8,5,1,4,20,3.5,396,67,http://content7.flixster.com/movie/27/87/278717_det.jpg
2964,Julien Donkey-Boy,1999,julien_donkeyboy,4.6,33,8,25,24,5.4,6,3,3,50,3.6,1576,73,http://content7.flixster.com/movie/27/52/275297_det.jpg
2965,The Omega Code,1999,omega_code,3,24,2,22,8,4.2,6,2,4,33,2.6,796,40,http://content6.flixster.com/movie/10/88/66/10886660_det.jpg
2966,The Straight Story,1999,straight_story,8.1,86,82,4,95,8,26,25,1,96,4,7407,89,http://content8.flixster.com/movie/10/92/38/10923814_det.jpg
2967,The Bad Seed,1956,1001572-bad_seed,7.6,15,13,2,86,0,0,0,0,0,0,0,0,http://content7.flixster.com/movie/95/83/60/9583605_det.jpg
2968,Time Bandits,1981,time_bandits,8,36,34,2,94,6.9,5,4,1,80,3.5,9753,74,http://content6.flixster.com/movie/26/30/263020_det.jpg
2969,Un homme et une femme,1966,man_and_a_woman,6.3,12,9,3,75,0,3,1,2,33,4,1548,86,http://content7.flixster.com/movie/28/66/286617_det.jpg
2970,Fitzcarraldo,1982,fitzcarraldo,7.6,22,18,4,81,0,3,2,1,66,4.3,4213,93,http://content9.flixster.com/movie/26/08/260815_det.jpg
2971,All That Jazz,1979,all_that_jazz,7.4,30,26,4,86,0,4,2,2,50,3.9,3397,84,http://content6.flixster.com/movie/26/82/268220_det.jpg
2972,Hong gao liang,1987,red_sorghum,7.6,7,7,0,100,0,1,1,0,100,0,0,0,http://content8.flixster.com/movie/10/89/86/10898682_det.jpg
2973,Crimes and Misdemeanors,1989,crimes_and_misdemeanors,7.9,38,35,3,92,7.3,5,4,1,80,4,6179,90,http://content8.flixster.com/movie/31/07/310710_det.jpg
2974,The Vampire Bat,1933,vampire_bat,0,4,2,2,50,0,0,0,0,0,0,0,0,http://content6.flixster.com/movie/10/28/56/10285636_det.jpg
2975,The Best Man,2005,unhitched,0,1,1,0,100,0,0,0,0,0,0,0,0,http://content8.flixster.com/movie/36/71/69/3671694_det.jpg
2976,Bringing Out the Dead,1999,bringing_out_the_dead,6.7,105,75,30,71,6.6,25,18,7,72,3.2,7444,65,http://content6.flixster.com/movie/28/40/284016_det.jpg
2977,Crazy in Alabama,1999,crazy_in_alabama,4.5,55,17,38,30,4.7,20,6,14,30,3.1,1384,55,http://content8.flixster.com/movie/10/86/90/10869026_det.jpg
2978,Three to Tango,1999,three_to_tango,4.3,64,18,46,28,4.5,18,7,11,38,2.7,3780,46,http://content6.flixster.com/movie/26/20/262016_det.jpg
2979,Body Shots,1999,body_shots,4,28,3,25,10,5.5,6,2,4,33,2.5,624,27,http://content8.flixster.com/movie/27/31/273110_det.jpg
2981,Brother Can You Spare a Dime,1975,brother_can_you_spare_a_dime,0,0,0,0,0,0,0,0,0,0,0,0,0,http://content8.flixster.com/movie/26/32/263206_det.jpg
2982,The Guardian,2006,guardian,5.2,143,54,89,37,5.2,34,11,23,32,3.7,58919,83,http://content8.flixster.com/movie/10/89/81/10898122_det.jpg
2983,The Ipcress File,1965,ipcress_file,7.7,23,23,0,100,0,3,3,0,100,3.8,1386,83,http://content6.flixster.com/movie/10/90/55/10905548_det.jpg
2984,On Any Sunday,1971,on_any_sunday,0,3,2,1,66,0,1,1,0,100,4.4,129,91,http://content8.flixster.com/movie/10/85/75/10857538_det.jpg
2985,RoboCop,1987,1017712-robocop,7.7,42,37,5,88,7.3,7,6,1,85,3.1,18381,71,http://content7.flixster.com/movie/29/03/290309_det.jpg
2986,RoboCop 2,1990,robocop_2,4.5,31,11,20,35,4,5,1,4,20,2.7,9580,38,http://content8.flixster.com/movie/28/41/284122_det.jpg
2987,Who Framed Roger Rabbit,1988,who_framed_roger_rabbit,8.3,42,41,1,97,7.7,8,7,1,87,3.5,33318,75,http://content7.flixster.com/movie/95/59/48/9559485_det.jpg
2988,Melvin and Howard,1980,melvin_and_howard,8.2,16,16,0,100,0,1,1,0,100,3.4,453,61,http://content9.flixster.com/movie/28/52/285295_det.jpg
2989,For Your Eyes Only,1981,for_your_eyes_only,6.2,35,25,10,71,6,5,3,2,60,3.3,10042,64,http://content6.flixster.com/movie/25/84/258424_det.jpg
2990,Licence to Kill,1989,licence_to_kill,5.8,35,25,10,71,5.5,8,4,4,50,3.1,12088,56,http://content8.flixster.com/movie/10/93/36/10933610_det.gif
2991,Live and Let Die,1973,live_and_let_die,5.9,36,23,13,63,4.1,6,1,5,16,3.3,13025,66,http://content8.flixster.com/movie/25/91/259118_det.jpg
2992,Rawhead Rex,1986,rawhead_rex,4.4,5,2,3,40,0,0,0,0,0,0,0,0,http://content9.flixster.com/movie/10/91/76/10917659_det.jpg
2993,Thunderball,1965,thunderball,7,33,30,3,90,6.2,5,4,1,80,3.4,12807,70,http://content9.flixster.com/movie/25/80/258019_det.jpg
2994,City Lights,1931,city_lights,9,37,37,0,100,8.8,8,8,0,100,4.3,7937,94,http://content7.flixster.com/movie/10/19/23/10192349_det.jpg
2995,House on Haunted Hill,1999,1093881-house_on_haunted_hill,4.4,53,13,40,24,3.5,11,2,9,18,2.9,13288,49,http://content9.flixster.com/movie/10/83/95/10839519_det.jpg
2996,Music of the Heart,1999,music_of_the_heart,6.6,75,51,24,68,6.1,19,12,7,63,3.5,3231,68,http://content7.flixster.com/movie/10/93/80/10938041_det.jpg
2997,Being John Malkovich,1999,being_john_malkovich,8,116,107,9,92,7.7,26,24,2,92,3.6,52443,85,http://content6.flixster.com/movie/10/89/21/10892184_det.jpg
2998,Dreaming of Joseph Lees,1999,dreaming_of_joseph_lees,4.8,13,4,9,30,0,4,3,1,75,3.5,62,58,http://content8.flixster.com/movie/10/83/96/10839662_det.jpg
2999,Man of the Century,1999,man_of_the_century,6.6,16,12,4,75,5.7,5,2,3,40,3.7,246,74,http://content7.flixster.com/movie/28/41/284197_det.jpg
3000,Mononoke-hime,1997,princess-mononoke,7.7,83,77,6,92,7.7,24,23,1,95,4.1,44616,94,http://content9.flixster.com/movie/25/42/254295_det.jpg
3001,The Suburbans,1999,suburbans,3,10,0,10,0,0,2,0,2,0,2.5,700,23,http://content9.flixster.com/movie/27/85/278515_det.jpg
3002,Mein liebster Feind - Klaus Kinski,1999,my_best_fiend,7,24,19,5,79,6.8,5,4,1,80,4,1638,90,http://content6.flixster.com/movie/30/23/302320_det.jpg
3003,Train de vie,1998,train_of_life,6.4,18,12,6,66,0,4,2,2,50,4.3,854,93,http://content8.flixster.com/movie/10/89/39/10893906_det.jpg
3004,The Bachelor,1999,1093976-bachelor,3.5,66,6,60,9,3.4,20,1,19,5,2.5,3470,34,http://content8.flixster.com/movie/10/95/40/10954042_det.jpg
3005,The Bone Collector,1999,bone_collector,4.7,84,23,61,27,4.7,23,7,16,30,3.3,26317,68,http://content7.flixster.com/movie/10/88/63/10886301_det.jpg
3006,Inside Man,2006,inside_man,7.3,195,168,27,86,7.5,40,35,5,87,3.7,84980,81,http://content9.flixster.com/movie/10/89/84/10898419_det.jpg
3007,American Movie,1999,american_movie,8.3,46,43,3,93,8.9,7,7,0,100,4,3544,87,http://content6.flixster.com/movie/27/00/270020_det.jpg
3008,Last Night,1998,1094041-last_night,7.2,49,41,8,83,7.1,9,7,2,77,3.8,1691,84,http://content9.flixster.com/movie/18/18/56/1818567_det.jpg
3010,Rosetta,1999,rosetta,7.2,22,19,3,86,8.7,5,5,0,100,3.9,880,82,http://content6.flixster.com/movie/54/93/24/5493240_det.jpg
3011,"They Shoot Horses, Don't They?",1969,they_shoot_horses_dont_they,7.3,23,19,4,82,0,3,3,0,100,3.9,1522,87,http://content9.flixster.com/movie/26/64/266419_det.jpg
3012,Battling Butler,1926,battling_butler,6,5,4,1,80,0,1,0,1,0,3.7,249,75,http://content9.flixster.com/movie/52/46/97/5246979_det.jpg
3013,Bride of Re-Animator,1990,bride_of_reanimator,5.2,15,7,8,46,0,3,1,2,33,3.1,1904,51,http://content7.flixster.com/movie/10/93/47/10934777_det.jpg
3014,Bustin' Loose,1981,bustin_loose,0,4,3,1,75,0,0,0,0,0,0,0,0,http://content9.flixster.com/movie/28/11/281127_det.jpg
3015,Coma,1978,1004502-coma,6.6,21,16,5,76,0,3,1,2,33,3.2,1526,55,http://content8.flixster.com/movie/26/01/260198_det.jpg
3016,Creepshow,1982,creepshow,6,27,18,9,66,0,4,2,2,50,3.3,6768,67,http://content8.flixster.com/movie/27/00/270002_det.jpg
3017,Creepshow 2,1987,creepshow_2,3.7,19,5,14,26,0,4,2,2,50,3,3260,49,http://content9.flixster.com/movie/27/25/272519_det.jpg
3018,Re-Animator,1985,reanimator,7.7,38,35,3,92,0,4,3,1,75,3.6,7434,78,http://content9.flixster.com/movie/10/93/47/10934779_det.jpg
3019,Drugstore Cowboy,1989,drugstore_cowboy,8,27,27,0,100,9,6,6,0,100,3.7,4507,82,http://content7.flixster.com/movie/10/88/51/10885189_det.jpg
3020,Falling Down,1993,falling_down,6.6,44,33,11,75,6.4,8,5,3,62,3.5,19292,79,http://content9.flixster.com/movie/10/88/45/10884595_det.jpg
3021,The Funhouse,1981,funhouse,5.6,12,7,5,58,0,0,0,0,0,0,0,0,http://content9.flixster.com/movie/10/88/31/10883171_det.jpg
3022,The General,1926,1008166-general,8.9,38,35,3,92,0,4,2,2,50,4.4,3785,93,http://content6.flixster.com/movie/10/84/02/10840232_det.jpg
3024,Piranha,1978,1016359-piranha,6.4,22,15,7,68,0,0,0,0,0,0,0,0,http://content9.flixster.com/movie/11/14/65/11146503_det.jpg
3025,Rough Night in Jericho,1967,rough_night_in_jericho,0,3,1,2,33,0,1,0,1,0,3.1,322,34,http://content9.flixster.com/movie/10/90/04/10900455_det.jpg
3026,Slaughterhouse-Five,1972,slaughterhouse_five,7.4,13,10,3,76,0,0,0,0,0,0,0,0,http://content6.flixster.com/movie/11/12/35/11123560_det.jpg
3027,Slaughterhouse-Five,1972,slaughterhouse_five,7.4,13,10,3,76,0,0,0,0,0,0,0,0,http://content6.flixster.com/movie/11/12/35/11123560_det.jpg
3028,The Taming of the Shrew,1967,taming-of-the-shrew1983,0,0,0,0,0,0,0,0,0,0,0,0,0,http://content9.flixster.com/movie/10/85/11/10851111_det.jpg
3029,Nighthawks,1981,1015095-nighthawks,6.2,14,10,4,71,0,2,2,0,100,3.1,1535,52,http://content6.flixster.com/movie/49/60/04/4960044_det.jpg
3030,Y√¥jinb√¥,1961,yojimbo,8.8,34,33,1,97,8,5,4,1,80,4.4,10522,96,http://content8.flixster.com/movie/39/91/10/3991102_det.jpg
3031,Repo! The Genetic Opera,2008,repo_the_genetic_opera,4.5,54,18,36,33,3.6,14,2,12,14,3.7,8433,74,http://content7.flixster.com/movie/10/89/20/10892029_det.jpg
3032,The Omega Man,1971,omega_man,5.6,32,19,13,59,0,4,2,2,50,3.3,5147,56,http://content8.flixster.com/movie/25/61/256198_det.jpg
3033,Spaceballs,1987,spaceballs,6.3,23,15,8,65,0,1,0,1,0,3.5,54973,80,http://content9.flixster.com/movie/55/05/03/5505039_det.jpg
3034,Robin Hood: Prince of Thieves,1991,robin_hood_prince_of_thieves,5.2,27,15,12,55,0,2,1,1,50,3.4,30722,72,http://content6.flixster.com/movie/10/93/73/10937328_det.jpg
3035,Mister Roberts,1955,1014061-mister_roberts,7.5,17,17,0,100,0,0,0,0,0,0,0,0,http://content6.flixster.com/movie/10/84/07/10840784_det.jpg
3036,La guerre du feu,1981,quest_for_fire,7,14,11,3,78,0,1,1,0,100,3.5,2238,71,http://content7.flixster.com/movie/10/87/63/10876345_det.jpg
3037,Little Big Man,1970,little_big_man,7.9,25,24,1,96,0,2,2,0,100,3.8,3720,84,http://content8.flixster.com/movie/10/91/68/10916850_det.jpg
3038,A Face in the Crowd,1957,face_in_the_crowd,7.8,21,19,2,90,0,3,3,0,100,4.2,1221,93,http://content8.flixster.com/movie/10/86/72/10867226_det.jpg
3039,Trading Places,1983,trading_places,7.2,36,32,4,88,6.8,5,4,1,80,3.5,12785,82,http://content6.flixster.com/movie/26/71/267100_det.jpg
3040,Meatballs,1979,meatballs,6.2,28,20,8,71,0,3,2,1,66,3,3676,54,http://content8.flixster.com/movie/55/06/08/5506086_det.jpg
3041,Meatballs Part II,1984,meatballs_2,0,0,0,0,0,0,0,0,0,0,0,0,0,http://content8.flixster.com/movie/92/54/86/9254862_det.jpg
3042,Meatballs III: Summer Job,1986,meatballs_3,0,0,0,0,0,0,0,0,0,0,0,0,0,http://content9.flixster.com/movie/92/37/51/9237511_det.jpg
3043,Meatballs 4,1992,meatballs_4,0,2,0,2,0,0,0,0,0,0,0,0,0,http://content9.flixster.com/movie/41/80/01/4180019_det.jpg
3044,Dead Again,1991,dead_again,7.3,37,31,6,83,7,5,3,2,60,3.6,2979,75,http://content6.flixster.com/movie/28/51/285100_det.jpg
3045,Peter's Friends,1992,peters_friends,6.3,25,19,6,76,0,2,1,1,50,3.6,1706,73,http://content6.flixster.com/movie/34/33/73/3433732_det.jpg
3046,The Incredibly True Adventure of Two Girls in Love,1995,incredibly_true_adventures_of_two_girls_in_love,6.5,9,6,3,66,0,3,1,2,33,3.5,1299,70,http://content7.flixster.com/movie/10/86/36/10863645_det.jpg
3047,Experience Preferred... But Not Essential,1982,,\N,\N,\N,\N,\N,\N,\N,\N,\N,\N,\N,\N,\N,\N
3048,Under the Rainbow,1981,under_the_rainbow,0,4,0,4,0,0,2,0,2,0,3.1,194,46,http://content7.flixster.com/movie/11/12/61/11126121_det.jpg
3049,How I Won the War,1967,how_i_won_the_war,5.7,12,7,5,58,0,4,0,4,0,3.3,537,58,http://content8.flixster.com/movie/20/77/77/2077770_det.jpg
3050,Light It Up,1999,light_it_up,4.9,47,18,29,38,5.3,17,8,9,47,3.6,1219,76,http://content9.flixster.com/movie/43/88/27/4388279_det.jpg
3051,Anywhere But Here,1999,anywhere_but_here,6.4,86,55,31,63,6.7,23,15,8,65,3,4760,52,http://content7.flixster.com/movie/26/62/266217_det.jpg
3052,Dogma,1999,dogma,6.3,126,85,41,67,5.8,28,14,14,50,3.6,61754,84,http://content9.flixster.com/movie/26/81/268119_det.jpg
3053,Joan of Arc,1999,messenger_the_story_of_joan_of_arc,4.5,72,22,50,30,3.4,21,1,20,4,3.1,8110,57,http://content6.flixster.com/movie/10/88/57/10885720_det.jpg
3054,Pok√©mon: The First Movie,1999,pokemon-the-first-movie-mewtwo-vs-mew,3.6,75,11,64,14,3.7,22,3,19,13,2.8,10617,55,http://content7.flixster.com/movie/10/86/71/10867197_det.jpg
3055,Felicia's Journey,1999,felicias_journey,7.4,40,35,5,87,7.8,8,8,0,100,3.4,694,66,http://content8.flixster.com/movie/26/34/263494_det.jpg
3056,Oxygen,1999,oxygen,6.5,10,7,3,70,0,0,0,0,0,0,0,0,http://content6.flixster.com/movie/27/85/278592_det.jpg
3057,Where's Marlowe?,1998,wheres_marlowe,4.4,11,2,9,18,0,3,0,3,0,3,183,46,http://content9.flixster.com/movie/28/37/283707_det.jpg
3058,Planet of the Apes,1968,1016397-planet_of_the_apes,7.4,44,39,5,88,5.5,5,3,2,60,3.4,12844,80,http://content7.flixster.com/movie/11/14/82/11148265_det.jpg
3060,The Commitments,1991,1037024-commitments,7.5,38,34,4,89,6.5,9,7,2,77,3.7,4765,88,http://content7.flixster.com/movie/27/88/278801_det.jpg
3061,Holiday Inn,1942,holiday_inn,7.1,20,20,0,100,0,3,3,0,100,4,3215,87,http://content9.flixster.com/movie/34/35/98/3435987_det.jpg
3062,The Longest Day,1962,longest_day,7.5,12,11,1,91,0,0,0,0,0,0,0,0,http://content6.flixster.com/movie/10/93/55/10935544_det.jpg
3063,Poison Ivy,1992,1039642-poison_ivy,5,26,11,15,42,4.2,6,1,5,16,2.7,5842,40,http://content9.flixster.com/movie/97/12/79/9712795_det.jpg
3064,Poison Ivy: The New Seduction,1997,poison_ivy_the_new_seduction,0,3,0,3,0,0,0,0,0,0,0,0,0,http://content7.flixster.com/movie/27/01/270113_det.jpg
3065,Nothing to Lose,1997,1077642-nothing_to_lose,5.1,23,6,17,26,5.7,5,1,4,20,3.1,5245,67,http://content7.flixster.com/movie/10/45/21/10452197_det.jpg
3066,Tora! Tora! Tora!,1970,tora_tora_tora,6.3,17,12,5,70,0,2,1,1,50,3.6,3254,79,http://content7.flixster.com/movie/25/34/253497_det.jpg
3067,Mujeres al borde de un ataque de nervios,1988,women_on_the_verge_of_a_nervous_breakdown,7.6,26,23,3,88,0,4,4,0,100,4,6254,88,http://content9.flixster.com/movie/10/87/03/10870371_det.jpg
3068,The Verdict,1982,verdict,7.8,24,23,1,95,0,3,2,1,66,3.8,2332,85,http://content8.flixster.com/movie/10/92/11/10921162_det.jpg
3069,The Effect of Gamma Rays on Man-in-the-Moon Marigolds,1972,the-effect-of-gamma-rays-on-maninthemoon-marigolds,0,0,0,0,0,0,0,0,0,0,0,0,0,http://content9.flixster.com/movie/90/32/00/9032007_det.jpg
3070,The Adventures of Buckaroo Banzai Across the 8th Dimension,1984,adventures_of_buckaroo_banzai,6.4,34,23,11,67,0,3,2,1,66,3.4,3969,69,http://content6.flixster.com/movie/10/90/58/10905812_det.jpg
3071,Stand and Deliver,1988,stand_and_deliver,6,14,9,5,64,0,1,0,1,0,3.6,2645,78,http://content8.flixster.com/movie/25/52/255202_det.jpg
3072,Moonstruck,1987,moonstruck,7.7,36,33,3,91,7.3,6,5,1,83,3.4,7943,77,http://content8.flixster.com/movie/10/85/77/10857754_det.jpg
3073,The Sandpiper,1965,the-sandpiper2005,0,0,0,0,0,0,0,0,0,0,0,0,0,http://content6.flixster.com/movie/10/84/56/10845660_det.jpg
3074,Jeremiah Johnson,1972,jeremiah_johnson,7.1,14,13,1,92,0,2,2,0,100,3.9,3595,85,http://content9.flixster.com/movie/25/42/254207_det.jpg
3075,Repulsion,1965,repulsion,8.8,44,44,0,100,8.3,6,6,0,100,4,4466,87,http://content8.flixster.com/movie/28/63/286318_det.jpg
3076,Irma la Douce,1963,irma_la_douce,7.4,13,11,2,84,0,2,1,1,50,3.7,1630,76,http://content9.flixster.com/movie/28/67/286707_det.jpg
3077,42: Forty Two Up,1998,42_up,7.8,31,28,3,90,7.8,8,7,1,87,4,803,88,http://content8.flixster.com/movie/30/54/305414_det.jpg
3078,Liberty Heights,1999,liberty_heights,7.3,45,39,6,86,7.8,11,11,0,100,3.4,1048,71,http://content7.flixster.com/movie/10/89/17/10891709_det.jpg
3079,Mansfield Park,1999,1093843-mansfield_park,6.9,66,50,16,75,6.3,18,10,8,55,3.6,6288,77,http://content9.flixster.com/movie/25/40/254095_det.jpg
3081,Sleepy Hollow,1999,sleepy_hollow,6.3,124,84,40,67,6.2,30,20,10,66,3.5,93949,79,http://content9.flixster.com/movie/26/69/266927_det.jpg
3082,The World Is Not Enough,1999,morir_o_no,0,1,0,1,0,0,0,0,0,0,0,0,0,http://content7.flixster.com/movie/10/84/81/10848193_det.jpg
3083,Todo sobre mi madre,1999,all_about_my_mother,8,80,78,2,97,8,23,22,1,95,4.2,16912,93,http://content7.flixster.com/movie/10/95/09/10950921_det.jpg
3085,La morte vivante,1982,living_dead_girl,0,2,1,1,50,0,0,0,0,0,0,0,0,http://content9.flixster.com/movie/30/18/301823_det.jpg
3086,Babes in Toyland,1934,march_of_the_wooden_soldiers,8.4,12,12,0,100,0,2,2,0,100,3.6,865,78,http://content7.flixster.com/movie/29/10/291017_det.jpg
3087,Scrooged,1988,scrooged,5.8,38,24,14,63,3.8,6,1,5,16,3.3,11201,68,http://content7.flixster.com/movie/26/58/265829_det.jpg
3088,Last Chance Harvey,2008,last_chance_harvey,6.2,146,102,44,69,6.1,27,19,8,70,3.2,14302,52,http://content7.flixster.com/movie/10/88/88/10888825_det.jpg
3089,Ladri di biciclette,1948,bicycle_thief,8.8,47,45,2,95,8.8,7,7,0,100,4.3,8603,94,http://content8.flixster.com/movie/10/44/04/10440426_det.jpg
3090,Matewan,1987,matewan,8.3,17,17,0,100,0,0,0,0,0,0,0,0,http://content9.flixster.com/movie/25/59/255991_det.jpg
3091,Kagemusha,1980,kagemusha,7.5,19,16,3,84,0,2,1,1,50,4.2,4005,91,http://content6.flixster.com/movie/10/93/41/10934152_det.jpg
3092,Ch√ªshingura,1962,chushingura,0,1,0,1,0,0,0,0,0,0,0,0,0,http://content9.flixster.com/movie/31/05/310511_det.jpg
3093,McCabe & Mrs. Miller,1971,mccabe_and_mrs_miller,8.4,35,31,4,88,6.3,5,3,2,60,4,2372,85,http://content7.flixster.com/movie/26/96/269601_det.jpg
3094,Maurice,1987,maurice,7,10,9,1,90,0,1,1,0,100,3.9,2148,82,http://content8.flixster.com/movie/10/93/47/10934714_det.jpg
3095,The Grapes of Wrath,1940,grapes_of_wrath,8.9,36,36,0,100,8,5,5,0,100,3.8,4868,85,http://content9.flixster.com/movie/10/85/60/10856083_det.jpg
3096,My Man Godfrey,1936,1014536-my_man_godfrey,8.4,26,26,0,100,8,6,6,0,100,4.1,1791,90,http://content7.flixster.com/movie/31/11/311193_det.jpg
3097,The Shop Around the Corner,1940,shop_around_the_corner,8.4,20,20,0,100,0,4,4,0,100,4.1,3559,89,http://content9.flixster.com/movie/29/15/291523_det.jpg
3098,The Natural,1984,natural,7,31,25,6,80,5.8,5,2,3,40,3.7,6978,86,http://content6.flixster.com/movie/10/86/72/10867252_det.jpg
3099,Shampoo,1975,shampoo,6.1,28,17,11,60,5,5,1,4,20,3.2,1397,52,http://content6.flixster.com/movie/27/21/272120_det.jpg
3100,A River Runs Through It,1992,river_runs_through_it,6.8,38,31,7,81,7.4,9,8,1,88,3.5,13036,79,http://content7.flixster.com/movie/25/60/256009_det.jpg
3101,Fatal Attraction,1987,1007141-fatal_attraction,6.8,42,34,8,80,6.7,7,5,2,71,3.2,8130,67,http://content7.flixster.com/movie/10/84/99/10849901_det.jpg
3102,Jagged Edge,1985,jagged_edge,6.7,26,22,4,84,6.2,5,3,2,60,3.2,969,54,http://content7.flixster.com/movie/27/65/276525_det.jpg
3103,Stanley & Iris,1989,stanley_and_iris,4,14,4,10,28,0,4,1,3,25,3.1,683,44,http://content6.flixster.com/movie/10/86/38/10863876_det.jpg
3104,Midnight Run,1988,midnight_run,7.7,26,25,1,96,0,2,1,1,50,3.6,5155,82,http://content7.flixster.com/movie/28/22/282293_det.jpg
3105,Awakenings,1990,1032970-awakenings,6.7,28,25,3,89,0,1,1,0,100,3.6,10377,85,http://content6.flixster.com/movie/10/64/14/10641424_det.jpg
3106,Come See the Paradise,1990,come_see_the_paradise,5.5,9,6,3,66,0,2,1,1,50,3.5,180,61,http://content7.flixster.com/movie/10/79/86/10798665_det.jpg
3107,Backdraft,1991,backdraft,6,39,28,11,71,4.4,7,3,4,42,3.3,17142,73,http://content9.flixster.com/movie/56/82/34/5682347_det.jpg
3108,The Fisher King,1991,fisher_king,7,50,43,7,86,6.8,8,6,2,75,3.6,8960,83,http://content6.flixster.com/movie/26/82/268204_det.jpg
3109,Frozen River,2008,frozen_river,7.3,125,109,16,87,7.9,26,24,2,92,3.2,9338,71,http://content6.flixster.com/movie/10/93/37/10933756_det.jpg
3110,North Country,2005,north_country,6.7,166,114,52,68,6.8,38,26,12,68,3.5,14739,72,http://content8.flixster.com/movie/25/03/250394_det.jpg
3111,Places in the Heart,1984,places_in_the_heart,8,20,20,0,100,0,3,3,0,100,3.7,1290,80,http://content6.flixster.com/movie/25/75/257520_det.jpg
3112,"'night, Mother",1986,night_mother,0,1,1,0,100,0,0,0,0,0,0,0,0,http://content6.flixster.com/movie/10/89/02/10890284_det.jpg
3113,End of Days,1999,end_of_days,3.7,98,11,87,11,3.3,24,1,23,4,2.8,14087,41,http://content8.flixster.com/movie/10/84/59/10845938_det.jpg
3114,Toy Story,1995,toy_story,9,73,73,0,100,8.5,17,17,0,100,3.7,102338,81,http://content7.flixster.com/movie/10/93/63/10936393_det.jpg
3115,Flawless,2007,10008754-flawless,5.7,90,50,40,55,6,17,12,5,70,3.3,5982,56,http://content6.flixster.com/movie/10/87/72/10877212_det.jpg
3116,Miss Julie,1999,1093854-miss_julie,5.6,21,8,13,38,5.2,6,1,5,16,3.2,300,57,http://content8.flixster.com/movie/28/02/280226_det.jpg
3117,Ride with the Devil,1999,1084873-ride_with_the_devil,6.2,64,40,24,62,5.9,18,10,8,55,3.3,1734,62,http://content9.flixster.com/movie/27/19/271907_det.jpg
3118,Tumbleweeds,1999,1093901-tumbleweeds,7,64,54,10,84,7.1,22,19,3,86,3.5,368,66,http://content8.flixster.com/movie/26/53/265306_det.jpg
3119,Reazione a catena,1971,bay_of_blood,7.5,9,8,1,88,0,0,0,0,0,0,0,0,http://content9.flixster.com/movie/48/61/08/4861087_det.jpg
3120,The Distinguished Gentleman,1992,the-distinguished-gentleman,4,14,2,12,14,0,2,0,2,0,2.8,1961,40,http://content7.flixster.com/movie/27/21/272129_det.jpg
3121,The Hitch-Hiker,1953,1057462-hitchhiker,7.6,5,5,0,100,0,0,0,0,0,0,0,0,http://content9.flixster.com/movie/21/98/15/2198159_det.jpg
3122,Santa Fe Trail,1940,santa_fe_trail,0,3,3,0,100,0,0,0,0,0,0,0,0,http://content6.flixster.com/movie/10/85/12/10851292_det.jpg
3124,Agnes Browne,1999,agnes_browne,5.3,26,10,16,38,5.8,6,2,4,33,3.5,307,70,http://content6.flixster.com/movie/27/63/276300_det.jpg
3125,The End of the Affair,1999,1093671-end_of_the_affair,6.6,66,44,22,66,6.5,16,9,7,56,3.6,3227,73,http://content8.flixster.com/movie/10/92/66/10926630_det.jpg
3126,The End of the Affair,1999,1093671-end_of_the_affair,6.6,66,44,22,66,6.5,16,9,7,56,3.6,3227,73,http://content8.flixster.com/movie/10/92/66/10926630_det.jpg
3127,Holy Smoke,1999,holy_smoke,5.6,73,32,41,43,5.4,22,8,14,36,3,2300,46,http://content7.flixster.com/movie/27/30/273009_det.jpg
3128,A Map of the World,1999,map_of_the_world,6.4,54,35,19,64,6.6,17,12,5,70,3.2,587,51,http://content8.flixster.com/movie/46/25/30/4625302_det.jpg
3129,Sweet and Lowdown,1999,sweet_and_lowdown,6.8,59,46,13,77,6.5,16,11,5,68,3.6,3877,76,http://content8.flixster.com/movie/26/07/260798_det.jpg
3130,The Bonfire of the Vanities,1990,bonfire_of_the_vanities,3.8,30,7,23,23,0,2,0,2,0,2.6,3216,28,http://content9.flixster.com/movie/27/57/275799_det.jpg
3131,Broadway Damage,1997,broadway_damage,3.5,7,2,5,28,0,1,0,1,0,3,241,43,http://content6.flixster.com/movie/30/54/305428_det.jpg
3132,Daddy Long Legs,1955,1033622-daddy_long_legs,0,1,1,0,100,0,0,0,0,0,0,0,0,http://content7.flixster.com/movie/32/04/95/3204957_det.jpg
3133,Go West,1940,1008437-go_west,6.5,9,8,1,88,0,0,0,0,0,0,0,0,http://content6.flixster.com/movie/10/81/62/10816296_det.jpg
3134,La grande illusion,1937,grand_illusion,9.2,34,33,1,97,0,4,4,0,100,4.3,2864,93,http://content6.flixster.com/movie/10/91/76/10917672_det.gif
3135,The Great Santini,1979,great_santini,7.8,17,16,1,94,0,1,1,0,100,3.6,592,74,http://content8.flixster.com/movie/25/79/257906_det.jpg
3136,The James Dean Story,1957,james_dean_story,0,1,1,0,100,0,0,0,0,0,0,0,0,http://content9.flixster.com/movie/30/79/307911_det.jpg
3137,The Sea Wolves,1980,,\N,\N,\N,\N,\N,\N,\N,\N,\N,\N,\N,\N,\N,\N
3138,Stealing Home,1988,stealing_home,3.4,9,2,7,22,0,1,0,1,0,3.5,936,71,http://content6.flixster.com/movie/25/97/259716_det.jpg
3139,Tarzan the Fearless,1933,tarzan_the_fearless,0,1,1,0,100,0,0,0,0,0,0,0,0,http://content9.flixster.com/movie/10/93/13/10931347_det.jpg
3140,Three Ages,1923,three_ages,7.4,7,7,0,100,0,0,0,0,0,0,0,0,http://content8.flixster.com/movie/10/90/66/10906690_det.jpg
3141,The Two Jakes,1990,two_jakes,5.4,16,10,6,62,0,2,2,0,100,2.9,1401,37,http://content7.flixster.com/movie/10/89/74/10897421_det.jpg
3142,U2: Rattle and Hum,1988,u2_rattle_and_hum,5.7,12,8,4,66,0,0,0,0,0,0,0,0,http://content7.flixster.com/movie/10/88/04/10880465_det.jpg
3143,Hell in the Pacific,1968,1009456-hell_in_the_pacific,6.8,10,8,2,80,0,0,0,0,0,0,0,0,http://content7.flixster.com/movie/10/87/88/10878873_det.jpg
3144,The Glass Bottom Boat,1966,glass_bottom_boat,5.6,6,3,3,50,0,0,0,0,0,0,0,0,http://content7.flixster.com/movie/10/92/18/10921889_det.jpg
3145,Cradle Will Rock,1999,cradle_will_rock,6.2,66,42,24,63,5.9,14,10,4,71,3.4,1693,65,http://content9.flixster.com/movie/27/32/273223_det.jpg
3146,Deuce Bigalow: Male Gigolo,1999,deuce_bigalow_male_gigolo,4,73,17,56,23,3.2,18,1,17,5,2.9,18036,55,http://content6.flixster.com/movie/27/05/270504_det.jpg
3147,The Green Mile,1999,green_mile,6.8,128,99,29,77,6.2,32,23,9,71,4.1,124792,93,http://content7.flixster.com/movie/26/73/267305_det.jpg
3148,The Cider House Rules,1999,cider_house_rules,6.6,109,77,32,70,6.5,25,17,8,68,3.4,9660,75,http://content6.flixster.com/movie/10/84/64/10846404_det.jpg
3149,Diamonds,1999,1093655-diamonds,4,34,9,25,26,3.8,10,3,7,30,2.7,365,32,http://content9.flixster.com/movie/26/59/265995_det.jpg
3150,Punisher: War Zone,2008,punisher_war_zone,4.2,96,25,71,26,3.7,21,1,20,4,3,29393,47,http://content6.flixster.com/movie/10/88/11/10881196_det.jpg
3151,The Bat Whispers,1930,bat_whispers,0,4,2,2,50,0,1,0,1,0,3.4,96,67,http://content7.flixster.com/movie/96/33/40/9633405_det.jpg
3152,The Last Picture Show,1971,last_picture_show,8.6,33,33,0,100,8.5,5,5,0,100,4,3677,88,http://content7.flixster.com/movie/10/88/15/10881585_det.jpg
3153,The 7th Voyage of Sinbad,1958,,7.5,14,14,0,100,0,1,1,0,100,3.5,2006,68,http://content9.flixster.com/movie/11/11/99/11119931_det.jpg
3154,Blood on the Sun,1945,1002628-blood_on_the_sun,0,3,3,0,100,0,0,0,0,0,0,0,0,http://content7.flixster.com/movie/86/22/94/8622949_det.jpg
3155,Anna and the King,1999,1093611-anna_and_the_king,5.9,97,49,48,50,5.3,28,10,18,35,3.2,10877,63,http://content6.flixster.com/movie/25/76/257616_det.jpg
3156,Bicentennial Man,1999,bicentennial_man,4.8,93,35,58,37,4.6,23,6,17,26,3,22610,58,http://content7.flixster.com/movie/25/65/256509_det.jpg
3157,Stuart Little 2,2002,stuart_little_2,6.9,114,95,19,83,6.9,29,26,3,89,2.7,10893,44,http://content7.flixster.com/movie/25/70/257017_det.jpg
3158,Jing Ke ci Qin Wang,1998,emperor_and_the_assassin,7.4,34,29,5,85,7.2,5,3,2,60,3.7,1522,76,http://content8.flixster.com/movie/27/33/273398_det.jpg
3159,Fantasia/2000,1999,fantasia_2000,7,78,64,14,82,5.9,22,14,8,63,3.3,9364,67,http://content9.flixster.com/movie/10/88/07/10880751_det.jpg
3160,Magnolia,1999,magnolia,7.5,138,114,24,82,6.8,32,25,7,78,3.7,39673,88,http://content9.flixster.com/movie/10/93/46/10934667_det.jpg
3161,Onegin,1999,1093905-onegin,5.5,20,8,12,40,0,4,1,3,25,3.6,1473,69,http://content7.flixster.com/movie/29/24/292405_det.jpg
3162,Simpatico,1999,simpatico,4.6,59,14,45,23,4.3,18,3,15,16,2.4,294,18,http://content6.flixster.com/movie/28/06/280608_det.jpg
3163,Topsy-Turvy,1999,topsyturvy,7.8,83,74,9,89,7.9,19,18,1,94,3.6,1113,73,http://content9.flixster.com/movie/10/93/39/10933955_det.jpg
3165,3-4 x j√ªgatsu,1990,1088532-boiling_point,6.8,7,6,1,85,0,1,1,0,100,3.5,702,66,http://content7.flixster.com/movie/34/85/50/3485505_det.jpg
3166,Brenda Starr,1989,brenda_starr,0,0,0,0,0,0,0,0,0,0,0,0,0,http://content8.flixster.com/movie/10/89/14/10891446_det.jpg
3167,Carnal Knowledge,1971,carnal_knowledge,7.7,26,23,3,88,0,4,3,1,75,3.5,1350,70,http://content6.flixster.com/movie/27/16/271600_det.jpg
3168,Easy Rider,1969,easy_rider,7.9,37,32,5,86,0,4,2,2,50,3.7,13558,81,http://content6.flixster.com/movie/26/82/268212_det.jpg
3169,The Falcon and the Snowman,1985,falcon_and_the_snowman,7.3,15,13,2,86,0,1,1,0,100,3.3,1167,62,http://content8.flixster.com/movie/27/70/277018_det.jpg
3171,Room at the Top,1959,room_at_the_top,8.3,10,10,0,100,0,0,0,0,0,0,0,0,http://content6.flixster.com/movie/29/54/295420_det.jpg
3172,Ulisse,1954,1022299-ulysses,0,2,2,0,100,0,0,0,0,0,0,0,0,http://content9.flixster.com/movie/10/86/16/10861667_det.jpg
3173,Any Given Sunday,1999,any_given_sunday,5.5,118,58,60,49,5.5,30,16,14,53,3.3,21068,70,http://content7.flixster.com/movie/10/93/45/10934589_det.jpg
3174,Man on the Moon,1999,1093579-man_on_the_moon,6.2,117,73,44,62,5.3,31,16,15,51,3.3,15027,74,http://content8.flixster.com/movie/10/87/18/10871826_det.jpg
3175,Galaxy Quest,1999,galaxy_quest,7.2,111,99,12,89,6.9,27,22,5,81,3,19804,67,http://content7.flixster.com/movie/10/91/52/10915261_det.jpg
3176,The Talented Mr. Ripley,1999,talented_mr_ripley,7.3,125,103,22,82,6.9,31,24,7,77,3.3,18951,75,http://content9.flixster.com/movie/26/92/269207_det.jpg
3177,Next Friday,2000,next_friday,3.9,62,13,49,20,4.1,21,5,16,23,3.2,25065,77,http://content6.flixster.com/movie/10/93/46/10934636_det.jpg
3178,The Hurricane,1937,1010242-hurricane,0,1,1,0,100,0,0,0,0,0,0,0,0,http://content9.flixster.com/movie/10/93/94/10939403_det.jpg
3179,Angela's Ashes,1999,angelas_ashes,5.7,84,44,40,52,5.3,26,10,16,38,3.6,4588,79,http://content6.flixster.com/movie/10/92/31/10923132_det.jpg
3180,Play It to the Bone,1999,play_it_to_the_bone,4,78,9,69,11,3.9,24,4,20,16,2.7,1727,29,http://content9.flixster.com/movie/28/04/280419_det.jpg
3181,Titus,1999,titus,6.5,74,50,24,67,6,21,12,9,57,3.7,4498,83,http://content7.flixster.com/movie/26/90/269029_det.jpg
3182,"Mr. Death: The Rise and Fall of Fred A. Leuchter, Jr.",1999,mr_death_the_rise_and_fall_of_fred_a_leuchter_jr,8.4,38,38,0,100,9.2,5,5,0,100,3.8,935,85,http://content8.flixster.com/movie/10/87/50/10875046_det.jpg
3183,The Third Miracle,1999,third_miracle,6.2,33,22,11,66,7.6,5,5,0,100,3.2,499,54,http://content6.flixster.com/movie/10/93/92/10939236_det.jpg
3184,Scarface,1983,1018324-scarface,7.5,50,44,6,88,8,5,4,1,80,4.1,121090,93,http://content6.flixster.com/movie/49/68/81/4968812_det.jpg
3185,Snow Falling on Cedars,1999,snow_falling_on_cedars,5.2,88,35,53,39,4.6,26,7,19,26,3.4,2061,67,http://content7.flixster.com/movie/10/88/46/10884605_det.jpg
3186,"Girl, Interrupted",1999,girl_interrupted,5.7,111,59,52,53,5.1,30,12,18,40,3.5,36814,83,http://content9.flixster.com/movie/26/77/267719_det.jpg
3188,The Life and Times of Hank Greenberg,1998,life_and_times_of_hank_greenberg,7.4,45,43,2,95,7.4,9,8,1,88,3.5,218,69,http://content7.flixster.com/movie/10/92/74/10927493_det.jpg
3189,My Dog Skip,2000,my_dog_skip,6.7,80,58,22,72,6.6,24,17,7,70,3.1,5324,63,http://content6.flixster.com/movie/10/87/65/10876528_det.jpg
3190,Supernova,2000,1084878-supernova,3.2,60,6,54,10,3.2,18,3,15,16,2.4,3150,21,http://content8.flixster.com/movie/27/80/278018_det.jpg
3191,The Quarry,1998,1099316-quarry,4.5,5,1,4,20,0,0,0,0,0,0,0,0,http://content8.flixster.com/movie/28/99/289906_det.jpg
3192,Theeviravaathi: The Terrorist,1998,,\N,\N,\N,\N,\N,\N,\N,\N,\N,\N,\N,\N,\N,\N
3193,Heavenly Creatures,1994,heavenly_creatures,8.3,41,39,2,95,7.8,9,9,0,100,3.7,8208,82,http://content9.flixster.com/movie/10/90/75/10907555_det.jpg
3194,The Way We Were,1973,way_we_were,6,19,12,7,63,0,3,1,2,33,3.7,5344,82,http://content6.flixster.com/movie/10/92/29/10922996_det.jpg
3195,Tess of the Storm Country,1922,tess_of_the_storm_country,0,0,0,0,0,0,0,0,0,0,0,0,0,http://content6.flixster.com/movie/10/98/31/10983156_det.jpg
3196,Stalag 17,1953,stalag_17,8.3,28,27,1,96,8.1,6,6,0,100,4.2,3492,92,http://content7.flixster.com/movie/10/89/31/10893141_det.jpg
3197,The Presidio,1988,presidio,4.8,13,6,7,46,0,1,0,1,0,3,1838,39,http://content6.flixster.com/movie/10/48/22/10482256_det.jpg
3198,Papillon,1973,papillon,7.7,13,12,1,92,0,2,1,1,50,0,0,0,http://content7.flixster.com/movie/26/84/268497_det.jpg
3199,Pal Joey,1957,pal_joey,6.5,7,5,2,71,0,0,0,0,0,0,0,0,http://content7.flixster.com/movie/29/35/293525_det.jpg
3200,The Last Detail,1973,last_detail,7.8,24,22,2,91,0,3,3,0,100,3.9,1988,85,http://content7.flixster.com/movie/27/29/272901_det.jpg
3201,Five Easy Pieces,1970,five_easy_pieces,8.2,30,25,5,83,6.5,5,3,2,60,3.9,4148,85,http://content6.flixster.com/movie/27/03/270308_det.jpg
3202,Auch Zwerge haben klein angefangen,1970,even_dwarfs_started_small,7.9,8,8,0,100,0,2,2,0,100,3.8,1310,76,http://content7.flixster.com/movie/30/57/305713_det.jpg
3203,Dead Calm,1989,dead_calm,7.5,21,20,1,95,0,1,1,0,100,3.1,4726,57,http://content6.flixster.com/movie/27/02/270216_det.jpg
3204,The Boys from Brazil,1978,1002993-boys_from_brazil,6.2,26,17,9,65,0,2,0,2,0,3.5,1963,68,http://content7.flixster.com/movie/10/90/11/10901117_det.jpg
3205,La maschera del demonio,1960,1055755-black_sunday,7.2,15,12,3,80,0,1,0,1,0,3.8,1726,79,http://content9.flixster.com/movie/10/91/73/10917315_det.jpg
3206,Against All Odds,1984,against_all_odds,5.6,9,6,3,66,0,1,1,0,100,3,1230,46,http://content8.flixster.com/movie/27/42/274206_det.jpg
3207,The Snows of Kilimanjaro,1952,snows_of_kilimanjaro,0,4,4,0,100,0,0,0,0,0,0,0,0,http://content6.flixster.com/movie/30/77/307700_det.jpg
3208,Loaded Weapon 1,1993,national_lampoons_loaded_weapon_1,3.5,22,3,19,13,0,4,0,4,0,2.8,4689,50,http://content6.flixster.com/movie/10/88/28/10882800_det.jpg
3209,The Loves of Carmen,1948,loves_of_carmen,0,1,0,1,0,0,0,0,0,0,0,0,0,http://content6.flixster.com/movie/29/90/299012_det.jpg
3210,Fast Times at Ridgemont High,1982,fast_times_at_ridgemont_high,6.7,44,35,9,79,3.9,6,2,4,33,3.5,26337,76,http://content6.flixster.com/movie/10/86/85/10868584_det.jpg
3211,Evil Angels,1988,cry_in_the_dark,6.8,20,18,2,90,0,1,1,0,100,3.3,1554,63,http://content6.flixster.com/movie/26/47/264712_det.jpg
3213,Batman: Mask of the Phantasm,1993,batman_mask_of_the_phantasm,6.9,23,20,3,86,0,3,1,2,33,3.4,14817,73,http://content8.flixster.com/movie/11/15/29/11152982_det.jpg
3214,American Flyers,1985,american_flyers,5.5,20,12,8,60,0,3,0,3,0,3.2,1640,57,http://content6.flixster.com/movie/10/94/48/10944864_det.gif
3215,Voyage of the Damned,1976,voyage_of_the_damned,5.2,5,4,1,80,0,0,0,0,0,0,0,0,http://content7.flixster.com/movie/11/15/07/11150721_det.jpg
3216,Vampiros lesbos,1971,vampyros_lesbos,5.6,6,3,3,50,0,1,0,1,0,3,1298,45,http://content7.flixster.com/movie/10/91/34/10913489_det.jpg
3217,A Star Is Born,1937,1019828-star_is_born,7.3,11,11,0,100,0,0,0,0,0,0,0,0,http://content7.flixster.com/movie/10/88/77/10887749_det.jpg
3218,Poison,1991,1037447-poison,7,12,10,2,83,0,1,1,0,100,3.5,529,65,http://content9.flixster.com/movie/10/90/23/10902367_det.jpg
3219,Pacific Heights,1990,pacific_heights,5.2,22,10,12,45,0,2,0,2,0,3.1,1624,51,http://content7.flixster.com/movie/27/28/272897_det.jpg
3220,Night Tide,1961,night-tide,0,0,0,0,0,0,0,0,0,0,0,0,0,http://content8.flixster.com/movie/41/87/24/4187242_det.jpg
3221,The Draughtsman's Contract,1982,draughtsmans_contract,8,17,17,0,100,0,2,2,0,100,3.9,1191,84,http://content9.flixster.com/movie/27/67/276703_det.jpg
3222,U-Carmen e-Khayelitsha,2005,ucarmen-ekhayelitsha,7.4,20,19,1,95,7.8,7,7,0,100,3.2,1204,50,http://content7.flixster.com/movie/33/19/82/3319829_det.jpg
3223,A Zed & Two Noughts,1985,zed_and_two_noughts,6.7,19,15,4,78,0,1,1,0,100,4,1255,86,http://content6.flixster.com/movie/10/07/60/10076032_det.jpg
3224,Suna no onna,1964,woman_in_the_dunes,8.7,14,14,0,100,0,1,1,0,100,4.3,1517,92,http://content7.flixster.com/movie/11/13/64/11136469_det.gif
3225,Down to You,2000,down_to_you,3.2,58,2,56,3,2.8,16,0,16,0,2.7,6516,51,http://content7.flixster.com/movie/25/95/259521_det.jpg
3226,Hellhounds on My Trail: The Afterlife of Robert Johnson,2000,hellhounds_on_my_trail_the_afterlife,0,0,0,0,0,0,0,0,0,0,0,0,0,http://content7.flixster.com/movie/10/98/38/10983861_det.jpg
3230,The Odessa File,1974,1015389-odessa_file,5.7,14,9,5,64,0,2,0,2,0,3.4,663,64,http://content9.flixster.com/movie/10/90/55/10905547_det.jpg
3231,The Saphead,1920,saphead,0,0,0,0,0,0,0,0,0,0,0,0,0,http://content7.flixster.com/movie/10/87/92/10879209_det.jpg
3232,Seven Chances,1925,seven-chances,8.8,12,12,0,100,0,0,0,0,0,0,0,0,http://content9.flixster.com/movie/52/46/94/5246943_det.jpg
3235,Where the Buffalo Roam,1980,where_the_buffalo_roam,4.7,12,3,9,25,0,1,0,1,0,3.6,5671,75,http://content8.flixster.com/movie/10/92/50/10925030_det.jpg
3237,Falkens √∂ga,1998,kestrels_eye,6.6,7,5,2,71,0,1,1,0,100,3.2,281,38,http://content7.flixster.com/movie/31/01/310193_det.jpg
3238,Eye of the Beholder,1999,1094646-eye_of_the_beholder,3.4,86,8,78,9,3.1,20,1,19,5,2.7,2529,34,http://content9.flixster.com/movie/27/36/273619_det.jpg
3239,Isn't She Great,2000,isnt_she_great,4,60,15,45,25,3.7,22,5,17,22,2.9,563,41,http://content7.flixster.com/movie/28/13/281397_det.jpg
3240,The Big Tease,1999,big_tease,5.7,39,22,17,56,5.7,15,9,6,60,3.2,496,56,http://content8.flixster.com/movie/27/70/277014_det.jpg
3241,Ph√∂rpa,1999,cup,6.9,33,28,5,84,7,7,6,1,85,4,324,85,http://content6.flixster.com/movie/10/84/45/10844552_det.jpg
3242,Santitos,1999,santitos1999,6.3,7,4,3,57,0,1,1,0,100,3.3,199,58,http://content6.flixster.com/movie/28/47/284720_det.jpg
3243,Encino Man,1992,encino_man,3.1,29,4,25,13,2.6,6,0,6,0,2.9,9527,58,http://content6.flixster.com/movie/25/85/258524_det.jpg
3244,The Goodbye Girl,1977,1008623-goodbye_girl,6.5,15,12,3,80,0,1,1,0,100,3.8,1711,84,http://content7.flixster.com/movie/25/58/255805_det.jpg
3245,Soy Cuba,1964,i_am_cuba,8.6,31,31,0,100,8.9,7,7,0,100,4.2,1082,91,http://content8.flixster.com/movie/29/69/296918_det.jpg
3246,Malcolm X,1992,1042135-malcolm_x,7.4,51,46,5,90,6.6,9,6,3,66,3.8,11524,90,http://content7.flixster.com/movie/11/12/29/11122981_det.jpg
3247,Sister Act,1992,sister_act,5.6,18,12,6,66,0,2,1,1,50,3.1,27888,66,http://content7.flixster.com/movie/25/51/255121_det.jpg
3248,Sister Act 2: Back in the Habit,1993,sister_act_2_back_in_the_habit,3,28,2,26,7,3.5,8,1,7,12,3,21141,66,http://content7.flixster.com/movie/25/46/254617_det.jpg
3249,The Hand That Rocks the Cradle,1992,hand_that_rocks_the_cradle,5.6,32,18,14,56,5.2,6,3,3,50,3.1,4973,60,http://content8.flixster.com/movie/10/36/12/10361218_det.jpg
3250,Alive,1993,1042538-alive,6.4,21,15,6,71,0,3,1,2,33,3.3,5360,68,http://content6.flixster.com/movie/26/87/268704_det.jpg
3251,Agnes of God,1985,agnes_of_god,5.5,17,9,8,52,0,1,0,1,0,3.2,1316,55,http://content6.flixster.com/movie/26/30/263012_det.jpg
3252,Scent of a Woman,1992,1042193-scent_of_a_woman,7.2,32,30,2,93,0,3,3,0,100,3.7,23625,90,http://content9.flixster.com/movie/55/05/23/5505231_det.jpg
3253,Wayne's World,1992,waynes_world,6.8,45,38,7,84,6.4,7,5,2,71,3.4,45784,80,http://content7.flixster.com/movie/59/51/42/5951425_det.jpg
3254,Wayne's World 2,1993,waynes_world_2,5.8,42,25,17,59,7.1,7,6,1,85,3.1,24416,64,http://content8.flixster.com/movie/26/29/262922_det.jpg
3255,A League of Their Own,1992,for_their_own_good,0,0,0,0,0,0,0,0,0,0,0,0,0,http://content7.flixster.com/movie/10/88/69/10886901_det.jpg
3256,Patriot Games,1992,patriot_games,6,28,21,7,75,3.8,5,0,5,0,3.4,13313,70,http://content8.flixster.com/movie/28/35/283594_det.jpg
3257,The Bodyguard,1992,1042108-bodyguard,4.8,24,9,15,37,0,2,1,1,50,2.9,15937,61,http://content9.flixster.com/movie/31/29/312995_det.jpg
3258,Death Becomes Her,1992,death-becomes-them-the-musical,0,0,0,0,0,0,0,0,0,0,0,0,0,http://content8.flixster.com/movie/10/91/34/10913462_det.jpg
3259,Far and Away,1992,far_and_away,5.2,21,10,11,47,0,2,0,2,0,3.1,11238,61,http://content9.flixster.com/movie/25/65/256503_det.jpg
3260,Howards End,1992,howards_end,8.2,34,31,3,91,9.8,5,5,0,100,3.7,3467,80,http://content8.flixster.com/movie/10/93/46/10934662_det.jpg
3261,Singles,1992,1040379-singles,6.9,40,32,8,80,7.5,8,6,2,75,3.4,4630,70,http://content6.flixster.com/movie/25/53/255312_det.jpg
3262,Twin Peaks: Fire Walk with Me,1992,twin-peaks-fire-walk-with-me,6.2,50,31,19,62,4.4,5,2,3,40,3.6,10347,79,http://content9.flixster.com/movie/10/87/63/10876351_det.jpg
3263,White Men Can't Jump,1992,white_men_cant_jump,6.3,37,29,8,78,6,7,5,2,71,3,9040,61,http://content6.flixster.com/movie/27/31/273108_det.jpg
3264,Buffy the Vampire Slayer,1992,buffy_the_vampire_slayer,4.1,34,11,23,32,3.9,6,2,4,33,2.8,18735,44,http://content6.flixster.com/movie/11/12/50/11125008_det.jpg
3265,Lat sau san taam,1992,,\N,\N,\N,\N,\N,\N,\N,\N,\N,\N,\N,\N,\N,\N
3266,C'est arriv√© pr√®s de chez vous,1992,man_bites_dog,7.3,14,12,2,85,0,1,1,0,100,4.1,6544,90,http://content7.flixster.com/movie/10/61/24/10612469_det.jpg
3267,El mariachi,1992,el_mariachi,7,25,23,2,92,7.6,5,5,0,100,3.5,11481,73,http://content7.flixster.com/movie/27/23/272313_det.jpg
3268,Stop! Or My Mom Will Shoot,1992,stop_or_my_mom_will_shoot,2.5,23,1,22,4,0,4,0,4,0,2.2,5278,26,http://content7.flixster.com/movie/26/18/261817_det.jpg
3269,Forever Young,1992,1041862-forever_young,5.3,16,8,8,50,0,1,0,1,0,3.1,9230,55,http://content6.flixster.com/movie/26/09/260916_det.jpg
3270,The Cutting Edge,1992,1038990-cutting_edge,6.1,12,7,5,58,0,3,2,1,66,3.3,6209,76,http://content7.flixster.com/movie/10/91/34/10913417_det.jpg
3271,Of Mice and Men,1992,1040322-of_mice_and_men,7.9,25,24,1,96,8.9,6,6,0,100,3.5,6505,77,http://content9.flixster.com/movie/26/07/260727_det.jpg
3272,Bad Lieutenant,1992,bad_lieutenant,6.9,38,29,9,76,6.7,10,7,3,70,3.5,4087,73,http://content9.flixster.com/movie/27/04/270407_det.jpg
3273,Scream 3,2000,scream_3,5.2,94,36,58,38,5.1,23,9,14,39,2.8,28349,49,http://content8.flixster.com/movie/55/05/97/5505978_det.jpg
3274,Single White Female,1992,single_white_female,5.3,39,23,16,58,4.9,8,4,4,50,2.9,3934,49,http://content8.flixster.com/movie/55/04/84/5504846_det.jpg
3275,The Boondock Saints,1999,boondock_saints,4,21,4,17,19,0,1,0,1,0,4.2,104281,93,http://content9.flixster.com/movie/10/93/80/10938019_det.jpg
3276,Gun Shy,2000,gun_shy,4.5,42,10,32,23,3.8,10,2,8,20,2.9,1203,40,http://content9.flixster.com/movie/27/48/274803_det.jpg
3278,Gendernauts - Eine Reise durch die Geschlechter,1999,gendernauts,0,2,1,1,50,0,0,0,0,0,0,0,0,http://content9.flixster.com/movie/10/84/27/10842799_det.jpg
3280,Gone Baby Gone,2007,gone_baby_gone,7.7,164,154,10,93,7.4,36,33,3,91,3.8,95109,84,http://content9.flixster.com/movie/92/42/85/9242855_det.jpg
3281,The Brandon Teena Story,1998,brandon_teena_story,6.2,12,8,4,66,0,2,2,0,100,3.7,649,70,http://content6.flixster.com/movie/10/93/42/10934264_det.gif
3282,Different for Girls,1996,different_for_girls,5.9,24,12,12,50,6.7,10,7,3,70,3.5,391,65,http://content6.flixster.com/movie/27/34/273416_det.jpg
3283,Minnie and Moskowitz,1971,minnie_and_moskowitz,7.3,10,8,2,80,0,2,1,1,50,0,0,0,http://content8.flixster.com/movie/26/47/264722_det.jpg
3284,They Might Be Giants,1971,they-might-be-giants,7.1,9,7,2,77,0,0,0,0,0,0,0,0,http://content7.flixster.com/movie/11/13/31/11133169_det.jpg
3285,The Beach,2000,beach,4.4,116,22,94,18,3.9,31,4,27,12,2.9,21479,59,http://content6.flixster.com/movie/10/88/39/10883940_det.jpg
3286,Snow Day,2000,snow_day,4.2,62,16,46,25,4,20,5,15,25,2.5,4272,33,http://content6.flixster.com/movie/10/88/66/10886640_det.jpg
3287,The Tigger Movie,2000,the-tigger-movie,5.9,70,43,27,61,5.7,19,10,9,52,3.2,5413,63,http://content9.flixster.com/movie/11/12/43/11124383_det.jpg
3289,Yi ge dou bu neng shao,1999,not_one_less,7.6,42,40,2,95,7.8,10,10,0,100,4,1451,88,http://content7.flixster.com/movie/10/88/23/10882301_det.jpg
3292,The Big Combo,1955,big_combo,7,12,11,1,91,0,3,2,1,66,3.5,764,69,http://content9.flixster.com/movie/31/13/311327_det.jpg
3293,Conceiving Ada,1997,conceiving-ada,6.6,11,9,2,81,0,1,1,0,100,3.2,57,50,http://content8.flixster.com/movie/10/85/11/10851146_det.jpg
3294,Eaten Alive,1977,1006438-eaten_alive,4.4,10,1,9,10,0,0,0,0,0,0,0,0,http://content7.flixster.com/movie/28/00/280013_det.jpg
3295,Raining Stones,1993,raining_stones,8,11,11,0,100,0,4,4,0,100,3.9,560,88,http://content8.flixster.com/movie/10/89/82/10898202_det.jpg
3296,"To Sir, with Love",1967,to_sir_with_love,7.1,23,21,2,91,0,4,3,1,75,3.8,4209,85,http://content7.flixster.com/movie/28/60/286025_det.jpg
3298,Boiler Room,2000,1095081-boiler_room,6.4,97,65,32,67,6.7,22,17,5,77,3.4,7689,75,http://content7.flixster.com/movie/10/87/05/10870529_det.jpg
3300,Pitch Black,2000,pitch_black,5.6,100,55,45,55,4.9,26,10,16,38,3.4,39767,79,http://content6.flixster.com/movie/28/86/288600_det.jpg
3301,The Whole Nine Yards,2000,whole_nine_yards,5.2,93,42,51,45,5,25,10,15,40,3.2,16066,67,http://content7.flixster.com/movie/10/92/74/10927469_det.jpg
3302,Beautiful People,1999,beautiful_people,6.7,24,19,5,79,7.6,6,6,0,100,3.9,289,82,http://content9.flixster.com/movie/49/17/74/4917743_det.jpg
3303,Black Tar Heroin: The Dark End of the Street,2000,black_tar_heroin_the_dark_end_of_the_street,0,0,0,0,0,0,0,0,0,0,0,0,0,http://content6.flixster.com/movie/10/91/78/10917832_det.jpg
3304,Blue Collar Comedy Tour: The Movie,2003,blue_collar_comedy_tour_the_movie,6.8,13,12,1,92,7,8,8,0,100,3.6,6829,82,http://content6.flixster.com/movie/10/89/21/10892104_det.jpg
3305,Bluebeard,1944,1002732-bluebeard,7.6,7,7,0,100,0,0,0,0,0,0,0,0,http://content6.flixster.com/movie/29/21/52/2921520_det.jpg
3306,Monty Python's Flying Circus,1969,,\N,\N,\N,\N,\N,\N,\N,\N,\N,\N,\N,\N,\N,\N
3307,City Lights,1931,city_lights,9,37,37,0,100,8.8,8,8,0,100,4.3,7937,94,http://content7.flixster.com/movie/10/19/23/10192349_det.jpg
3308,The Flamingo Kid,1984,flamingo_kid,6.8,17,15,2,88,0,4,4,0,100,2.8,700,39,http://content8.flixster.com/movie/26/63/266310_det.jpg
3309,A Dog's Life,1918,a-dogs-life,0,0,0,0,0,0,0,0,0,0,0,0,0,http://content7.flixster.com/movie/10/89/24/10892493_det.jpg
3310,The Karate Kid,1984,karate_kid,6.9,41,37,4,90,6.9,5,4,1,80,3.3,20688,71,http://content7.flixster.com/movie/11/12/21/11122169_det.jpg
3311,The Man from Laramie,1955,man_from_laramie,7.6,6,6,0,100,0,0,0,0,0,0,0,0,http://content7.flixster.com/movie/11/14/00/11140029_det.jpg
3313,Class Reunion,1982,national_lampoons_class_reunion,2.4,6,0,6,0,0,0,0,0,0,0,0,0,http://content7.flixster.com/movie/31/09/310993_det.jpg
3314,The Big Trees,1952,big_trees,0,1,0,1,0,0,0,0,0,0,0,0,0,http://content9.flixster.com/movie/86/21/51/8621515_det.gif
3315,Happy Go Lovely,1951,,0,0,0,0,0,0,0,0,0,0,0,0,0,http://content7.flixster.com/movie/10/88/14/10881405_det.jpg
3316,Reindeer Games,2000,reindeer_games,4.2,86,21,65,24,4.4,26,8,18,30,2.5,4918,33,http://content6.flixster.com/movie/28/31/283124_det.jpg
3317,Wonder Boys,2000,wonder_boys,7.2,122,99,23,81,7.1,28,23,5,82,3.5,7544,79,http://content8.flixster.com/movie/26/88/268894_det.jpg
3318,Deterrence,1999,deterrence,5.3,38,17,21,44,5.3,12,5,7,41,3.2,258,54,http://content9.flixster.com/movie/27/91/279111_det.jpg
3319,Judy Berlin,1999,judy-berlin,7.1,29,23,6,79,7.8,5,4,1,80,3.4,156,73,http://content9.flixster.com/movie/30/59/305995_det.jpg
3320,Mifunes sidste sang,1999,mifune,6.7,30,22,8,73,8,6,6,0,100,3.8,534,84,http://content6.flixster.com/movie/27/90/279008_det.jpg
3322,3 Strikes,2000,3_strikes,2.3,29,0,29,0,2.4,11,0,11,0,3.1,1088,60,http://content6.flixster.com/movie/27/52/275204_det.jpg
3323,Chain of Fools,2000,1138933-chain_of_fools,0,0,0,0,0,0,0,0,0,0,0,0,0,http://content7.flixster.com/movie/10/91/52/10915289_det.jpg
3324,Drowning Mona,2000,drowning_mona,4.4,75,22,53,29,4.2,23,7,16,30,2.7,2361,40,http://content7.flixster.com/movie/10/86/78/10867893_det.jpg
3325,The Next Best Thing,2000,next_best_thing,3.6,91,17,74,18,3.3,27,3,24,11,2.6,3665,36,http://content8.flixster.com/movie/28/99/73/2899738_det.png
3326,What Planet Are You From?,2000,1095351-1095351-what_planet_are_you_from,5,77,32,45,41,4.1,23,7,16,30,2.5,1064,25,http://content9.flixster.com/movie/11/15/03/11150323_det.jpg
3327,Beyond the Mat,1999,beyond_the_mat,6.7,65,53,12,81,6.2,18,13,5,72,3.6,1609,79,http://content9.flixster.com/movie/10/93/79/10937939_det.jpg
3328,Ghost Dog: The Way of the Samurai,1999,ghost_dog_the_way_of_the_samurai,7,91,74,17,81,6.2,25,16,9,64,3.7,11931,82,http://content6.flixster.com/movie/26/89/268912_det.jpg
3329,The Year My Voice Broke,1987,year_my_voice_broke,7.1,15,14,1,93,0,4,4,0,100,4.1,242,89,http://content6.flixster.com/movie/10/92/21/10922156_det.jpg
3330,Splendor in the Grass,1961,splendor_in_the_grass,7.2,13,11,2,84,0,0,0,0,0,0,0,0,http://content9.flixster.com/movie/10/87/95/10879531_det.jpg
3331,My Tutor,1983,my_tutor,0,0,0,0,0,0,0,0,0,0,0,0,0,http://content7.flixster.com/movie/10/93/05/10930553_det.gif
3332,The Legend of Lobo,1962,legend_of_lobo,0,1,0,1,0,0,0,0,0,0,0,0,0,http://content6.flixster.com/movie/10/95/82/10958284_det.jpg
3333,The Killing of Sister George,1968,killing_of_sister_george,6.5,12,9,3,75,0,1,0,1,0,4,248,85,http://content7.flixster.com/movie/65/90/60/6590609_det.jpg
3334,Key Largo,1948,key_largo,8.1,26,25,1,96,0,3,2,1,66,0,0,0,http://content7.flixster.com/movie/10/88/31/10883165_det.jpg
3335,Jailbait,2004,10007131-jaibait,4.3,18,3,15,16,3.9,7,1,6,14,3.7,257,62,http://content7.flixster.com/movie/67/00/55/6700557_det.jpg
3336,It Happened Here,1965,it-happened-here1965,6.9,6,4,2,66,0,1,1,0,100,3.4,278,63,http://content6.flixster.com/movie/10/90/04/10900484_det.jpg
3337,I'll Never Forget What's'isname,1967,ill-never-forget-whatsisname,0,1,1,0,100,0,0,0,0,0,0,0,0,http://content6.flixster.com/movie/92/75/70/9275708_det.jpg
3338,For All Mankind,1989,for_all_mankind,8.1,14,13,1,92,0,1,1,0,100,4.1,579,91,http://content9.flixster.com/movie/29/57/295727_det.jpg
3339,Cross of Iron,1977,cross_of_iron,6.3,14,11,3,78,0,1,0,1,0,0,0,0,http://content6.flixster.com/movie/10/87/31/10873144_det.jpg
3340,Bride of the Monster,1955,bride_of_the_monster,3.8,8,3,5,37,0,0,0,0,0,0,0,0,http://content9.flixster.com/movie/11/15/29/11152971_det.jpg
3341,Born Yesterday,1950,1002930-born_yesterday,8.1,20,19,1,95,0,2,1,1,50,3.9,1132,86,http://content6.flixster.com/movie/29/39/293996_det.jpg
3342,Birdy,1984,,7.4,25,22,3,88,0,3,2,1,66,3.8,2454,82,http://content7.flixster.com/movie/28/14/281493_det.jpg
3343,Et Dieu... cr√©a la femme,1956,1000914-and_god_created_woman,6.2,11,8,3,72,0,1,0,1,0,3,1435,52,http://content6.flixster.com/movie/26/27/262712_det.jpg
3344,Blood Feast,1963,1002611-blood_feast,4.2,11,4,7,36,0,0,0,0,0,0,0,0,http://content7.flixster.com/movie/10/87/64/10876401_det.jpg
3345,"Charlie, the Lonesome Cougar",1967,charlie_the_lonesome_cougar,0,1,1,0,100,0,0,0,0,0,0,0,0,http://content7.flixster.com/movie/31/13/311329_det.jpg
3347,Never Cry Wolf,1983,never_cry_wolf,7.7,17,17,0,100,0,4,4,0,100,3.7,962,80,http://content8.flixster.com/movie/26/61/266110_det.jpg
3348,The Night Visitor,1971,1015084-night_visitor,0,4,1,3,25,0,1,0,1,0,3,54,50,http://content9.flixster.com/movie/10/88/59/10885903_det.jpg
3349,The Perils of Pauline,1947,1016152-perils_of_pauline,0,0,0,0,0,0,0,0,0,0,0,0,0,http://content8.flixster.com/movie/30/52/305214_det.jpg
3350,A Raisin in the Sun,1961,1017123-raisin_in_the_sun,8.1,12,12,0,100,0,1,1,0,100,3.8,1378,83,http://content6.flixster.com/movie/29/28/292812_det.jpg
3351,Two Thousand Maniacs!,1964,two_thousand_maniacs,4.5,13,4,9,30,0,0,0,0,0,0,0,0,http://content9.flixster.com/movie/28/79/287995_det.jpg
3352,Brown's Requiem,1998,browns-requiem,6,6,3,3,50,0,0,0,0,0,0,0,0,http://content6.flixster.com/movie/48/60/85/4860852_det.jpg
3353,The Closer You Get,2000,american_women,5.4,19,6,13,31,0,3,1,2,33,3.1,100,56,http://content8.flixster.com/movie/10/89/35/10893526_det.jpg
3354,Mission to Mars,2000,the-last-mission,0,0,0,0,0,0,0,0,0,0,0,0,0,http://content9.flixster.com/movie/10/84/68/10846879_det.jpg
3355,The Ninth Gate,1999,ninth_gate,4.9,85,35,50,41,4,24,6,18,25,3.2,23993,60,http://content8.flixster.com/movie/26/73/267302_det.jpg
3357,Est - Ouest,1999,eastwest,6.6,29,20,9,68,6.3,5,2,3,40,4,588,85,http://content6.flixster.com/movie/10/88/96/10889616_det.jpg
3358,Defending Your Life,1991,defending_your_life,7.6,27,26,1,96,0,3,3,0,100,3.6,2592,76,http://content8.flixster.com/movie/25/53/255394_det.jpg
3359,Breaking Away,1979,breaking_away,8.2,33,31,2,93,8.3,5,5,0,100,3.9,2650,84,http://content8.flixster.com/movie/10/91/67/10916770_det.jpg
3360,Hoosiers,1986,hoosiers,7.4,42,37,5,88,7.4,9,8,1,88,3.7,10169,87,http://content6.flixster.com/movie/21/66/57/2166576_det.jpg
3361,Bull Durham,1988,bull_durham,7.9,45,44,1,97,7.9,7,7,0,100,3.4,8264,78,http://content9.flixster.com/movie/10/89/23/10892343_det.gif
3362,Dog Day Afternoon,1975,dog_day_afternoon,8.5,35,34,1,97,6.9,6,5,1,83,4,18531,91,http://content8.flixster.com/movie/10/93/70/10937066_det.jpg
3363,American Graffiti,1973,american_graffiti,8.3,32,31,1,96,0,4,4,0,100,3.6,12630,78,http://content9.flixster.com/movie/10/93/41/10934175_det.jpg
3364,The Asphalt Jungle,1950,asphalt_jungle,8.4,25,24,1,96,0,0,0,0,0,0,0,0,http://content8.flixster.com/movie/83/01/68/8301686_det.jpg
3365,The Searchers,1956,searchers,8.8,41,40,1,97,8.3,5,5,0,100,4,8713,87,http://content6.flixster.com/movie/29/09/290904_det.jpg
3367,The Devil's Brigade,1968,devils_brigade,0,4,3,1,75,0,1,0,1,0,3.5,612,71,http://content9.flixster.com/movie/10/88/34/10883463_det.jpg
3368,The Big Country,1958,big_country,6.8,9,9,0,100,0,0,0,0,0,0,0,0,http://content9.flixster.com/movie/29/19/291919_det.jpg
3369,M√©lodie en sous-sol,1963,any_number_can_win,0,3,2,1,66,0,0,0,0,0,0,0,0,http://content6.flixster.com/movie/10/93/72/10937280_det.jpg
3370,The Betrayal - Nerakhoon,2008,nerakhoon,7.6,29,27,2,93,7.7,12,12,0,100,3.6,219,72,http://content9.flixster.com/movie/10/86/28/10862831_det.jpg
3371,Bound for Glory,1976,bound_for_glory,7.3,16,14,2,87,0,1,1,0,100,3.6,461,74,http://content9.flixster.com/movie/21/00/17/2100179_det.jpg
3372,The Bridge at Remagen,1969,1003086-bridge_at_remagen,0,3,0,3,0,0,0,0,0,0,0,0,0,http://content8.flixster.com/movie/25/82/258202_det.jpg
3373,Buck and the Preacher,1972,buck_and_the_preacher,0,0,0,0,0,0,0,0,0,0,0,0,0,http://content8.flixster.com/movie/26/41/264110_det.jpg
3374,Daughters of the Dust,1991,daughters_of_the_dust,7.2,8,7,1,87,0,2,2,0,100,3.9,285,78,http://content8.flixster.com/movie/10/90/51/10905102_det.jpg
3375,Destination Moon,1950,destination_moon,4.7,9,5,4,55,0,0,0,0,0,0,0,0,http://content6.flixster.com/movie/29/68/296816_det.jpg
3376,La nuit fantastique,1942,,\N,\N,\N,\N,\N,\N,\N,\N,\N,\N,\N,\N,\N,\N
3377,Hangmen Also Die!,1943,hangmen_also_die,0,3,3,0,100,0,0,0,0,0,0,0,0,http://content7.flixster.com/movie/10/84/08/10840877_det.jpg
3378,Der Unhold,1996,1089805-ogre,7,9,8,1,88,0,2,2,0,100,3.8,262,79,http://content6.flixster.com/movie/10/89/20/10892024_det.jpg
3379,The Beach,2000,beach,4.4,116,22,94,18,3.9,31,4,27,12,2.9,21479,59,http://content6.flixster.com/movie/10/88/39/10883940_det.jpg
3380,Railroaded!,1947,railroaded,0,4,3,1,75,0,0,0,0,0,0,0,0,http://content9.flixster.com/movie/30/13/301315_det.jpg
3384,The Taking of Pelham One Two Three,1974,taking_of_pelham_one_two_three,8.2,32,32,0,100,7.9,5,5,0,100,3.9,2926,86,http://content9.flixster.com/movie/10/88/88/10888815_det.jpg
3385,Volunteers,1985,volunteers,4.6,8,4,4,50,0,0,0,0,0,0,0,0,http://content9.flixster.com/movie/10/86/82/10868235_det.jpg
3386,JFK,1991,1037756-jfk,7.5,52,43,9,82,7.1,9,7,2,77,3.7,15334,84,http://content7.flixster.com/movie/10/93/59/10935981_det.jpg
3387,Who's Harry Crumb?,1989,whos_harry_crumb,3.6,10,3,7,30,0,0,0,0,0,0,0,0,http://content9.flixster.com/movie/26/19/261927_det.jpg
3388,Harry and the Hendersons,1987,harry_and_the_hendersons,4.8,17,7,10,41,0,0,0,0,0,0,0,0,http://content7.flixster.com/movie/10/91/89/10918985_det.jpg
3389,Let's Get Harry,1986,lets_get_harry,0,0,0,0,0,0,0,0,0,0,0,0,0,http://content7.flixster.com/movie/10/95/82/10958297_det.jpg
3390,Shanghai Surprise,1986,shanghai_surprise,2.3,7,1,6,14,0,0,0,0,0,0,0,0,http://content8.flixster.com/movie/26/48/264826_det.jpg
3391,Who's That Girl,1987,whos-that-girl,3.2,13,3,10,23,0,1,1,0,100,0,0,0,http://content8.flixster.com/movie/10/90/05/10900530_det.jpg
3392,She-Devil,1989,shedevil,4.5,17,7,10,41,0,1,1,0,100,2.6,2831,44,http://content8.flixster.com/movie/10/88/97/10889762_det.jpg
3393,Date with an Angel,1987,date_with_an_angel,3.4,7,1,6,14,0,2,0,2,0,3.1,926,59,http://content8.flixster.com/movie/10/90/70/10907050_det.jpg
3394,Blind Date,1987,1002571-blind_date,4.1,22,5,17,22,0,3,1,2,33,2.9,2983,44,http://content9.flixster.com/movie/26/21/262123_det.jpg
3395,Nadine,1987,nadine,5,10,4,6,40,0,1,0,1,0,2.8,404,21,http://content9.flixster.com/movie/26/36/263603_det.jpg
3396,The Muppet Movie,1979,muppet_movie,7.8,37,33,4,89,0,3,2,1,66,3.5,8541,79,http://content8.flixster.com/movie/10/88/15/10881570_det.jpg
3397,The Great Muppet Caper,1981,great_muppet_caper,6,17,12,5,70,0,3,1,2,33,3.3,4174,72,http://content9.flixster.com/movie/10/88/15/10881575_det.jpg
3398,The Muppets Take Manhattan,1984,muppets_take_manhattan,6.7,19,15,4,78,0,3,3,0,100,3.3,5077,70,http://content7.flixster.com/movie/25/11/251125_det.jpg
3399,Sesame Street Presents: Follow that Bird,1985,sesame_street_presents_follow_that_bird,6.1,11,10,1,90,0,1,1,0,100,3.4,1485,64,http://content8.flixster.com/movie/10/92/47/10924766_det.jpg
3400,We're Back! A Dinosaur's Story,1993,were_back_a_dinosaurs_story,4,11,3,8,27,0,4,1,3,25,3.1,2567,54,http://content6.flixster.com/movie/51/02/510276_det.jpg
3401,Baby: Secret of the Lost Legend,1985,baby_secret_of_the_lost_legend,3.5,9,1,8,11,0,1,0,1,0,2.8,986,37,http://content6.flixster.com/movie/26/25/262524_det.jpg
3402,Turtle Diary,1985,turtle_diary,7.7,6,6,0,100,0,1,1,0,100,3.7,57,69,http://content6.flixster.com/movie/10/85/28/10852872_det.jpg
3403,Raise the Titanic,1980,raise_the_titanic,5.2,5,3,2,60,0,1,0,1,0,3,2514,44,http://content8.flixster.com/movie/10/85/47/10854762_det.jpg
3404,Titanic,1997,titanic,7.4,97,80,17,82,6.6,29,21,8,72,3.3,464576,68,http://content8.flixster.com/movie/16/90/53/1690530_det.jpg
3405,A Night to Remember,1958,1015079-night_to_remember,8.7,9,9,0,100,0,0,0,0,0,0,0,0,http://content8.flixster.com/movie/29/46/294610_det.jpg
3406,Captain Horatio Hornblower R.N.,1951,captain_horatio_hornblower,7.3,7,7,0,100,0,0,0,0,0,0,0,0,http://content6.flixster.com/movie/11/13/40/11134000_det.jpg
3407,Les convoyeurs attendent,1999,carriers_are_waiting,7.4,7,7,0,100,0,1,1,0,100,3.8,198,71,http://content9.flixster.com/movie/10/62/12/10621299_det.jpg
3408,Erin Brockovich,2000,erin_brockovich,7.3,137,114,23,83,7.3,34,30,4,88,3.5,33256,76,http://content7.flixster.com/movie/55/36/21/5536217_det.jpg
3409,Final Destination,2000,final_destination,4.6,85,26,59,30,4.4,22,7,15,31,3.4,55113,75,http://content6.flixster.com/movie/26/87/268708_det.jpg
3410,Soft Fruit,1999,soft_fruit,6.2,14,9,5,64,5.1,6,3,3,50,3.9,118,83,http://content6.flixster.com/movie/10/87/50/10875016_det.jpg
3412,L'ours,1988,the-bear,7.2,11,10,1,90,0,2,1,1,50,3.6,2107,76,http://content8.flixster.com/movie/25/72/257218_det.jpg
3413,Deep Impact,1998,deep_impact,5.7,51,24,27,47,5.9,6,2,4,33,2.9,28624,51,http://content8.flixster.com/movie/10/88/98/10889858_det.jpg
3414,Love Is a Many-Splendored Thing,1955,,\N,\N,\N,\N,\N,\N,\N,\N,\N,\N,\N,\N,\N,\N
3415,Zerkalo,1975,1036046-mirror,9.2,6,6,0,100,0,1,1,0,100,4.4,2940,93,http://content9.flixster.com/movie/10/87/92/10879271_det.jpg
3417,The Crimson Pirate,1952,crimson_pirate,7.8,9,9,0,100,0,0,0,0,0,0,0,0,http://content9.flixster.com/movie/10/91/91/10919123_det.jpg
3418,Thelma & Louise,1991,thelma_and_louise,7.9,44,40,4,90,8.2,9,9,0,100,3.3,16458,75,http://content6.flixster.com/movie/27/67/276712_det.jpg
3419,Something for Everyone,1970,something_for_everyone,0,2,1,1,50,0,0,0,0,0,0,0,0,http://content8.flixster.com/movie/10/95/99/10959962_det.jpg
3420,...And Justice for All.,1979,and_justice_for_all,6.9,19,18,1,94,0,2,2,0,100,3.5,3756,76,http://content6.flixster.com/movie/27/15/271520_det.jpg
3421,Animal House,1978,national_lampoons_animal_house,7.7,40,36,4,90,7.1,5,4,1,80,3.7,25149,88,http://content9.flixster.com/movie/11/15/27/11152731_det.jpg
3422,She's Gotta Have It,1986,shes_gotta_have_it,7,27,25,2,92,0,3,2,1,66,3.4,1428,66,http://content6.flixster.com/movie/10/89/77/10897760_det.jpg
3423,School Daze,1988,school_daze,5.7,19,11,8,57,0,4,1,3,25,3.8,2379,80,http://content8.flixster.com/movie/26/91/269126_det.jpg
3424,Do the Right Thing,1989,do_the_right_thing,8.8,51,49,2,96,7.9,7,6,1,85,3.8,28566,86,http://content6.flixster.com/movie/27/20/272012_det.jpg
3425,Mo' Better Blues,1990,mo_better_blues,6,32,23,9,71,4.5,8,3,5,37,0,0,0,http://content9.flixster.com/movie/27/20/272003_det.jpg
3426,Jungle Fever,1991,fever_1991,6.7,7,4,3,57,0,1,1,0,100,3,220,36,http://content9.flixster.com/movie/10/89/04/10890499_det.jpg
3427,Coogan's Bluff,1968,coogans_bluff,6.8,10,10,0,100,0,1,1,0,100,3.2,1501,48,http://content8.flixster.com/movie/27/41/274110_det.jpg
3428,Resurrecting the Champ,2007,resurrecting_the_champ,6,116,69,47,59,5.5,30,15,15,50,3.4,18572,62,http://content8.flixster.com/movie/10/89/16/10891638_det.jpg
3429,Creature Comforts,1989,creature_comforts,7.6,12,11,1,91,0,0,0,0,0,0,0,0,http://content9.flixster.com/movie/29/97/299795_det.jpg
3430,Death Wish,1974,death_wish,6,23,16,7,69,0,3,1,2,33,3.3,4245,68,http://content9.flixster.com/movie/26/99/269991_det.jpg
3431,Death Wish,1974,death_wish,6,23,16,7,69,0,3,1,2,33,3.3,4245,68,http://content9.flixster.com/movie/26/99/269991_det.jpg
3432,Death Wish 3,1985,death_wish_3,2.2,14,0,14,0,0,3,0,3,0,3.1,2045,54,http://content9.flixster.com/movie/48/06/480679_det.jpg
3433,Death Wish 4: The Crackdown,1987,death_wish_4_the_crackdown,3.8,6,1,5,16,0,0,0,0,0,0,0,0,http://content9.flixster.com/movie/10/88/14/10881499_det.jpg
3434,Death Wish V: The Face of Death,1994,,\N,\N,\N,\N,\N,\N,\N,\N,\N,\N,\N,\N,\N,\N
3435,Double Indemnity,1944,double_indemnity,8.7,43,42,1,97,7.3,5,4,1,80,4.2,8526,93,http://content8.flixster.com/movie/10/93/42/10934290_det.jpg
3436,Dying Young,1991,dying_young,4.5,16,5,11,31,0,2,0,2,0,3.2,5112,66,http://content9.flixster.com/movie/10/84/53/10845363_det.jpg
3437,Cool as Ice,1991,cool_as_ice,2.2,13,1,12,7,0,2,0,2,0,0,0,0,http://content9.flixster.com/movie/44/40/30/4440307_det.jpg
3438,Teenage Mutant Ninja Turtles,1990,teenage_mutant_ninja_turtles_the_movie,4.9,37,17,20,45,5.8,7,4,3,57,3.3,21473,76,http://content7.flixster.com/movie/25/56/255697_det.jpg
3439,Teenage Mutant Ninja Turtles II: The Secret of the Ooze,1991,teenage_mutant_ninja_turtles_2_the_secret_of_the_ooze,4.6,27,10,17,37,5.1,8,4,4,50,3.1,14179,68,http://content7.flixster.com/movie/25/79/257901_det.jpg
3440,Teenage Mutant Ninja Turtles III,1993,teenage_mutant_ninja_turtles_iii,3.8,21,6,15,28,0,4,2,2,50,2.7,11304,42,http://content8.flixster.com/movie/25/98/259894_det.jpg
3441,Red Dawn,1984,1017321-red_dawn,4.8,16,8,8,50,0,0,0,0,0,0,0,0,http://content9.flixster.com/movie/10/95/32/10953275_det.jpg
3442,Band of the Hand,1986,band_of_the_hand,3.5,7,1,6,14,0,1,0,1,0,3.2,921,49,http://content9.flixster.com/movie/10/89/24/10892407_det.jpg
3443,Born American,1986,born_american,0,1,0,1,0,0,0,0,0,0,0,0,0,http://content8.flixster.com/movie/28/19/281998_det.jpg
3444,Bloodsport,1988,bloodsport,4.3,18,6,12,33,0,0,0,0,0,0,0,0,http://content8.flixster.com/movie/10/86/79/10867946_det.jpg
3445,Eyes of Laura Mars,1978,eyes_of_laura_mars,5.2,17,8,9,47,0,1,0,1,0,3.1,982,44,http://content6.flixster.com/movie/27/71/277116_det.jpg
3446,Funny Bones,1995,funny_bones,6.5,17,11,6,64,0,2,1,1,50,3.4,706,72,http://content7.flixster.com/movie/10/91/92/10919245_det.jpg
3447,The Good Earth,1937,good_earth,7.4,13,12,1,92,0,3,2,1,66,3.7,367,76,http://content8.flixster.com/movie/34/99/38/3499386_det.jpg
3448,"Good Morning, Vietnam",1987,good_morning_vietnam,7.3,31,28,3,90,0,1,1,0,100,3.5,13673,78,http://content9.flixster.com/movie/26/89/268995_det.jpg
3449,The Good Mother,1988,good_mother,5.5,6,4,2,66,0,1,0,1,0,3.1,241,35,http://content8.flixster.com/movie/89/13/34/8913342_det.jpg
3450,Grumpy Old Men,1993,grumpy_old_men,5.9,36,24,12,66,7,6,5,1,83,3.2,10489,66,http://content6.flixster.com/movie/25/60/256020_det.jpg
3451,Guess Who's Coming to Dinner,1967,guess_whos_coming_to_dinner,6,24,15,9,62,0,4,3,1,75,3.7,6951,84,http://content8.flixster.com/movie/29/13/291314_det.jpg
3452,Romeo Must Die,2000,romeo_must_die,4.9,89,29,60,32,5.6,20,10,10,50,3.1,16660,67,http://content9.flixster.com/movie/26/98/269803_det.jpg
3453,Here on Earth,2000,here_on_earth,3.8,67,12,55,17,3.3,23,2,21,8,3.1,3503,63,http://content9.flixster.com/movie/25/93/259303_det.jpg
3454,Whatever It Takes,2000,1095414-whatever_it_takes,3.5,64,10,54,15,3.6,22,3,19,13,2.9,8374,52,http://content6.flixster.com/movie/55/12/40/5512408_det.jpg
3455,Buddy Boy,1999,buddy_boy,6.2,7,5,2,71,0,2,1,1,50,3.1,563,53,http://content7.flixster.com/movie/28/00/280029_det.jpg
3456,Rang-e khoda,1999,color_of_paradise,7.6,31,27,4,87,8.9,5,5,0,100,4.3,1466,94,http://content9.flixster.com/movie/10/85/73/10857383_det.jpg
3457,Waking the Dead,2000,waking_the_dead,5.9,54,28,26,51,5.5,12,4,8,33,3.7,1126,77,http://content6.flixster.com/movie/11/14/66/11146668_det.jpg
3458,Blood and Sand,1922,1002597-blood_and_sand,7,8,8,0,100,0,0,0,0,0,0,0,0,http://content7.flixster.com/movie/10/88/44/10884449_det.jpg
3459,Gothic,1986,gothic,5.9,11,6,5,54,0,0,0,0,0,0,0,0,http://content8.flixster.com/movie/10/88/01/10880194_det.jpg
3461,Lord of the Flies,1990,1028568-lord_of_the_flies,6.4,18,11,7,61,0,1,0,1,0,3.1,6608,54,http://content6.flixster.com/movie/10/91/65/10916588_det.jpg
3462,Modern Times,1936,modern_times,8.9,47,47,0,100,8.2,11,11,0,100,4.2,9563,95,http://content7.flixster.com/movie/29/01/290109_det.jpg
3463,Last Resort,2000,1105075-last_resort,7.3,70,66,4,94,7.5,23,23,0,100,3.7,459,77,http://content6.flixster.com/movie/28/21/86/2821864_det.jpg
3464,Solar Crisis,1990,solar_crisis,0,4,0,4,0,0,0,0,0,0,0,0,0,http://content8.flixster.com/movie/10/96/48/10964826_det.jpg
3465,That's Life!,1986,thats_life,5.7,13,6,7,46,0,1,0,1,0,3.5,371,64,http://content7.flixster.com/movie/26/68/266821_det.jpg
3466,Heart and Souls,1993,heart_and_souls,5.4,22,12,10,54,0,2,1,1,50,3.4,3529,72,http://content9.flixster.com/movie/25/54/255407_det.jpg
3467,Hud,1963,1010174-hud,7.2,24,19,5,79,0,3,1,2,33,3.9,2075,87,http://content8.flixster.com/movie/29/30/293094_det.jpg
3468,The Hustler,1961,hustler,8.6,33,32,1,96,7.6,6,5,1,83,3.9,6593,90,http://content8.flixster.com/movie/28/60/286094_det.jpg
3469,Inherit the Wind,1960,1010555-inherit_the_wind,7.8,21,19,2,90,0,1,0,1,0,4,3071,88,http://content9.flixster.com/movie/25/43/254323_det.jpg
3470,Dersu Uzala,1975,dersu_uzala,7.5,12,9,3,75,0,1,0,1,0,4.3,2637,94,http://content7.flixster.com/movie/25/20/252005_det.jpg
3471,Close Encounters of the Third Kind,1977,close_encounters_of_the_third_kind,8.6,39,37,2,94,9,5,5,0,100,3.6,21572,79,http://content7.flixster.com/movie/10/94/47/10944789_det.jpg
3472,The City of the Dead,1960,horror_hotel,0,4,2,2,50,0,0,0,0,0,0,0,0,http://content9.flixster.com/movie/26/61/266127_det.jpg
3473,Jonas qui aura 25 ans en l'an 2000,1976,jonah_who_will_be_25_in_the_year_2000,0,2,2,0,100,0,0,0,0,0,0,0,0,http://content9.flixster.com/movie/10/96/40/10964083_det.jpg
3474,Retroactive,1997,retroactive,4.4,5,2,3,40,0,0,0,0,0,0,0,0,http://content7.flixster.com/movie/28/19/281997_det.jpg
3475,A Place in the Sun,1951,place_in_the_sun,6.8,20,15,5,75,0,2,0,2,0,3.9,2248,86,http://content6.flixster.com/movie/29/41/294120_det.jpg
3476,Jacob's Ladder,1990,jacobs_ladder,6.6,45,32,13,71,5,7,3,4,42,3.7,15733,82,http://content8.flixster.com/movie/10/03/98/10039878_det.jpg
3477,Empire Records,1995,empire_records,4.3,21,5,16,23,0,3,1,2,33,3.5,27733,83,http://content9.flixster.com/movie/26/22/262223_det.jpg
3478,La Bamba,1987,la_bamba,6.8,20,19,1,95,0,1,1,0,100,3.2,5593,74,http://content6.flixster.com/movie/25/74/257400_det.jpg
3479,Ladyhawke,1985,ladyhawke,5.5,19,12,7,63,0,0,0,0,0,0,0,0,http://content7.flixster.com/movie/25/53/255317_det.jpg
3480,Lucas,1986,lucas,6.2,14,9,5,64,0,2,2,0,100,3.3,2546,66,http://content8.flixster.com/movie/25/88/258830_det.jpg
3481,High Fidelity,2000,1095420-high_fidelity,7.6,145,133,12,91,7.2,38,33,5,86,3.7,41116,88,http://content6.flixster.com/movie/10/89/19/10891984_det.jpg
3483,The Road to El Dorado,2000,road_to_el_dorado,5.5,101,49,52,48,5.1,26,10,16,38,3.1,9172,64,http://content9.flixster.com/movie/13/23/31/1323319_det.jpg
3484,The Skulls,2000,skulls,3.1,84,7,77,8,3,28,2,26,7,2.8,6706,48,http://content6.flixster.com/movie/25/79/257928_det.jpg
3485,Macchie solari,1975,1001362-autopsy,0,2,1,1,50,0,0,0,0,0,0,0,0,http://content8.flixster.com/movie/10/87/21/10872174_det.jpg
3486,Devil Girl from Mars,1954,devil_girl_from_mars,0,0,0,0,0,0,0,0,0,0,0,0,0,http://content8.flixster.com/movie/30/76/307622_det.jpg
3487,The Road to El Dorado,2000,road_to_el_dorado,5.5,101,49,52,48,5.1,26,10,16,38,3.1,9172,64,http://content9.flixster.com/movie/13/23/31/1323319_det.jpg
3489,Hook,1991,hook,4.3,37,9,28,24,4.6,6,2,4,33,3.3,59655,72,http://content8.flixster.com/movie/25/46/254606_det.jpg
3490,Horror Express,1972,horror-express,6,5,2,3,40,0,0,0,0,0,0,0,0,http://content9.flixster.com/movie/28/23/282323_det.jpg
3491,My Chauffeur,1986,my_chauffeur,0,1,0,1,0,0,0,0,0,0,0,0,0,http://content7.flixster.com/movie/10/88/24/10882473_det.jpg
3492,The Son of the Sheik,1926,son_of_the_sheik,6.8,6,4,2,66,0,0,0,0,0,0,0,0,http://content6.flixster.com/movie/10/92/69/10926908_det.jpg
3494,True Grit,1969,true_grit,7.6,15,14,1,93,0,1,1,0,100,3.8,4651,83,http://content6.flixster.com/movie/25/11/251196_det.jpg
3495,Roadside Prophets,1992,roadside_prophets,6.7,6,5,1,83,0,0,0,0,0,0,0,0,http://content9.flixster.com/movie/22/20/06/2220067_det.jpg
3496,Madame Sousatzka,1988,madame_sousatzka,6.2,16,12,4,75,0,4,4,0,100,3.5,120,57,http://content8.flixster.com/movie/10/32/51/10325146_det.jpg
3497,Max Dugan Returns,1983,,6,7,5,2,71,0,1,0,1,0,3.3,492,56,http://content7.flixster.com/movie/25/77/257721_det.jpg
3498,Midnight Express,1978,midnight_express,7.7,20,19,1,95,0,0,0,0,0,0,0,0,http://content6.flixster.com/movie/27/16/271608_det.jpg
3499,Misery,1990,misery,7.3,51,46,5,90,6.4,7,5,2,71,3.6,18885,83,http://content7.flixster.com/movie/10/89/53/10895393_det.jpg
3500,Mr. Saturday Night,1992,crystal_hunt,0,0,0,0,0,0,0,0,0,0,0,0,0,http://content9.flixster.com/movie/10/85/42/10854259_det.jpg
3501,Murphy's Romance,1985,murphys_romance,6.6,14,12,2,85,0,1,1,0,100,3.4,940,71,http://content9.flixster.com/movie/25/48/254823_det.jpg
3502,My Life Without Me,2003,love-my-life,0,0,0,0,0,0,0,0,0,0,0,0,0,http://content8.flixster.com/movie/10/84/10/10841046_det.jpg
3503,Solyaris,1972,solyaris,8.3,39,38,1,97,8.2,8,8,0,100,4.1,7425,89,http://content9.flixster.com/movie/10/86/81/10868183_det.jpg
3504,Network,1976,network,8.1,41,37,4,90,7.4,5,4,1,80,4.1,8716,93,http://content9.flixster.com/movie/97/15/21/9715211_det.jpg
3505,No Way Out,1987,1015218-no_way_out,7.1,27,27,0,100,8,6,6,0,100,3.3,4406,65,http://content6.flixster.com/movie/27/05/270512_det.jpg
3506,North Dallas Forty,1979,north_dallas_forty,6.6,20,17,3,85,0,4,4,0,100,3.4,594,69,http://content9.flixster.com/movie/27/09/270991_det.jpg
3507,The Odd Couple,1968,1015380-odd_couple,8.2,31,31,0,100,0,4,4,0,100,0,0,0,http://content6.flixster.com/movie/11/14/28/11142856_det.jpg
3508,The Outlaw Josey Wales,1976,outlaw_josey_wales,8,31,30,1,96,0,3,2,1,66,0,0,0,http://content8.flixster.com/movie/10/88/06/10880638_det.jpg
3509,Black and White,1999,1090027-black_and_white,4.3,8,2,6,25,0,0,0,0,0,0,0,0,http://content6.flixster.com/movie/10/84/84/10848488_det.jpg
3510,Frequency,2000,frequency,6.5,122,85,37,69,6.4,27,20,7,74,3.4,17214,78,http://content7.flixster.com/movie/25/73/257309_det.jpg
3511,Ready to Rumble,2000,ready_to_rumble,4,64,16,48,25,4.3,15,4,11,26,2.6,3493,49,http://content6.flixster.com/movie/10/84/58/10845868_det.jpg
3512,Return to Me,2000,return_to_me,6.1,97,59,38,60,5.5,26,14,12,53,3.3,8306,76,http://content9.flixster.com/movie/10/88/87/10888787_det.jpg
3513,Rules of Engagement,2000,rules_of_engagement,5,93,34,59,36,5,24,9,15,37,3.2,7074,60,http://content9.flixster.com/movie/10/84/02/10840227_det.jpg
3514,Joe Gould's Secret,2000,joe_goulds_secret,6.6,31,20,11,64,7.3,7,5,2,71,3.4,281,59,http://content9.flixster.com/movie/28/01/280123_det.jpg
3515,"Me, Myself & Irene",2000,me_myself_and_irene,5.4,95,46,49,48,4.7,24,9,15,37,3.1,39953,60,http://content8.flixster.com/movie/10/91/55/10915566_det.jpg
3516,Bell Book and Candle,1958,bell_book_and_candle,5.8,9,6,3,66,0,0,0,0,0,0,0,0,http://content9.flixster.com/movie/29/13/291391_det.jpg
3518,The End of Violence,1997,end_of_violence,4.8,33,9,24,27,4.6,10,1,9,10,3,659,43,http://content7.flixster.com/movie/10/92/27/10922717_det.gif
3519,Force 10 from Navarone,1978,force_10_from_navarone,6.1,11,7,4,63,0,1,0,1,0,3.3,2137,56,http://content9.flixster.com/movie/10/91/60/10916071_det.jpg
3520,How to Stuff a Wild Bikini,1965,how_to_stuff_a_wild_bikini,0,2,0,2,0,0,0,0,0,0,0,0,0,http://content8.flixster.com/movie/30/07/300722_det.jpg
3521,Mystery Train,1989,1028711-mystery_train,7.2,25,21,4,84,0,1,1,0,100,3.9,3307,87,http://content9.flixster.com/movie/27/12/271227_det.jpg
3522,Sacco e Vanzetti,1971,1018051-sacco_and_vanzetti,5.9,6,3,3,50,0,4,2,2,50,4,58,94,http://content9.flixster.com/movie/10/88/87/10888759_det.jpg
3523,Taffin,1988,taffin,0,2,0,2,0,0,0,0,0,0,0,0,0,http://content9.flixster.com/movie/10/25/47/10254743_det.jpg
3524,King Arthur,2004,1133964-king_arthur,4.9,183,57,126,31,5.2,38,12,26,31,3.2,57867,63,http://content6.flixster.com/movie/10/92/97/10929712_det.jpg
3525,Bachelor Party,1984,1001526-bachelor_party,5.4,20,11,9,55,0,1,1,0,100,3,5525,53,http://content6.flixster.com/movie/27/15/271508_det.jpg
3526,Parenthood,1989,parenthood,7.2,39,36,3,92,7.9,7,7,0,100,3.2,6310,68,http://content6.flixster.com/movie/65/01/650116_det.jpg
3527,Predator,1987,predator,6.8,37,28,9,75,0,4,2,2,50,3.5,52908,83,http://content8.flixster.com/movie/10/93/20/10932042_det.jpg
3528,The Prince of Tides,1991,prince_of_tides,6.4,19,14,5,73,0,2,1,1,50,3.3,2156,68,http://content8.flixster.com/movie/27/05/270502_det.jpg
3529,The Postman Always Rings Twice,1981,1016592-postman_always_rings_twice,6.3,10,7,3,70,0,1,0,1,0,3.3,2610,61,http://content9.flixster.com/movie/27/08/270815_det.jpg
3530,Smoking/No Smoking,1993,,\N,\N,\N,\N,\N,\N,\N,\N,\N,\N,\N,\N,\N,\N
3531,All the Vermeers in New York,1990,all_the_vermeers_in_new_york,7.2,5,5,0,100,0,1,1,0,100,3,232,49,http://content7.flixster.com/movie/28/96/289605_det.jpg
3533,Yukinoj√¥ henge,1963,actors_revenge,7.5,9,8,1,88,0,2,2,0,100,4.2,181,88,http://content7.flixster.com/movie/10/09/63/10096321_det.jpg
3534,28 Days Later...,2002,28_days_later,7.3,200,177,23,88,7.1,39,34,5,87,3.6,107149,82,http://content9.flixster.com/movie/55/37/32/5537323_det.jpg
3535,American Psycho,2000,american_psycho,6.3,122,81,41,66,5.8,28,16,12,57,3.6,57904,83,http://content8.flixster.com/movie/10/92/96/10929654_det.jpg
3536,Keeping the Faith,2000,keeping_the_faith,6.2,114,78,36,68,5.8,25,14,11,56,3,9636,55,http://content8.flixster.com/movie/25/69/256998_det.jpg
3537,Where the Money Is,2000,where_the_money_is,5.3,74,34,40,45,5.6,19,10,9,52,3,517,36,http://content7.flixster.com/movie/26/66/266625_det.jpg
3538,East Is East,1999,east_is_east,7.2,30,24,6,80,7.1,6,5,1,83,3.6,2798,75,http://content9.flixster.com/movie/10/88/95/10889599_det.jpg
3539,The Filth and the Fury,2000,filth_and_the_fury,7.8,37,35,2,94,8.6,6,6,0,100,4,362,82,http://content9.flixster.com/movie/10/85/38/10853819_det.jpg
3540,Passion of Mind,2000,passion_of_mind,3.9,33,5,28,15,3.8,7,0,7,0,3.1,711,45,http://content9.flixster.com/movie/10/87/84/10878467_det.jpg
3541,Third World Cop,1999,third_world_cop,4.6,12,2,10,16,0,4,0,4,0,3.8,477,77,http://content8.flixster.com/movie/10/92/05/10920530_det.jpg
3542,Coming Apart,1969,coming_apart,0,4,2,2,50,0,0,0,0,0,0,0,0,http://content8.flixster.com/movie/10/84/83/10848318_det.jpg
3543,Diner,1982,diner,8.2,25,24,1,96,0,2,2,0,100,3.6,2408,75,http://content7.flixster.com/movie/27/04/270417_det.jpg
3544,Shakes the Clown,1991,shakes_the_clown,4.4,19,7,12,36,0,2,0,2,0,0,0,0,http://content9.flixster.com/movie/21/00/16/2100167_det.jpg
3545,Cabaret,1972,cabaret,8.3,32,31,1,96,6.6,5,4,1,80,3.8,7394,86,http://content9.flixster.com/movie/10/44/03/10440327_det.jpg
3546,What Ever Happened to Baby Jane?,1962,what-ever-happened-to-baby-jane,7.6,37,33,4,89,0,3,2,1,66,3.9,7128,89,http://content8.flixster.com/movie/10/93/55/10935590_det.jpg
3547,Prick Up Your Ears,1987,prick_up_your_ears,7.6,15,15,0,100,0,1,1,0,100,3.7,1024,76,http://content8.flixster.com/movie/27/99/279918_det.jpg
3548,Auntie Mame,1958,auntie_mame,8,13,12,1,92,0,0,0,0,0,0,0,0,http://content6.flixster.com/movie/10/89/40/10894024_det.jpg
3549,Guys and Dolls,1955,guys_and_dolls,6.9,15,12,3,80,0,0,0,0,0,0,0,0,http://content6.flixster.com/movie/10/88/89/10888980_det.jpg
3550,Hunger,2008,1200841-hunger,7.7,109,98,11,89,7.5,24,21,3,87,3.5,21784,75,http://content6.flixster.com/movie/10/87/22/10872208_det.jpg
3551,Marathon Man,1976,marathon_man,7.2,34,27,7,79,0,1,1,0,100,3.6,4534,81,http://content8.flixster.com/movie/11/11/99/11119966_det.jpg
3552,Caddyshack,1980,caddyshack,6.5,44,33,11,75,0,4,1,3,25,3.6,26005,86,http://content7.flixster.com/movie/55/04/75/5504753_det.jpg
3553,Gossip,2000,gossip,4.4,65,18,47,27,3.8,19,4,15,21,2.9,3212,45,http://content8.flixster.com/movie/27/89/278918_det.jpg
3554,Love & Basketball,2000,love_and_basketball,6.7,86,70,16,81,6.7,29,24,5,82,3.9,41056,93,http://content9.flixster.com/movie/10/92/57/10925795_det.jpg
3555,U-571,2000,u571,6.2,94,64,30,68,5.9,26,16,10,61,3.1,8932,60,http://content7.flixster.com/movie/25/64/256405_det.jpg
3556,The Virgin Suicides,1999,virgin_suicides,7,90,70,20,77,7.5,17,16,1,94,3.5,29052,80,http://content7.flixster.com/movie/10/88/86/10888641_det.jpg
3557,Jennifer Eight,1992,jennifer_8,5.2,16,7,9,43,0,2,0,2,0,2.9,1225,39,http://content7.flixster.com/movie/27/57/275705_det.jpg
3559,Limelight,1952,limelight,7.7,13,13,0,100,0,0,0,0,0,0,0,0,http://content7.flixster.com/movie/25/32/253213_det.jpg
3560,Ai no borei,1978,empire-of-passion-ai-no-borei,0,2,1,1,50,0,0,0,0,0,0,0,0,http://content6.flixster.com/movie/10/86/07/10860792_det.jpg
3562,Committed,2000,1096844-committed,5.4,38,17,21,44,5.2,10,5,5,50,2.7,930,32,http://content6.flixster.com/movie/28/01/280104_det.jpg
3563,The Crow: Salvation,2000,crow_salvation,4.6,9,2,7,22,0,1,1,0,100,2.9,8151,53,http://content9.flixster.com/movie/10/93/21/10932155_det.jpg
3564,The Flintstones in Viva Rock Vegas,2000,flintstones_in_viva_rock_vegas,4,70,17,53,24,4.5,20,6,14,30,2.3,3581,30,http://content9.flixster.com/movie/10/88/64/10886455_det.jpg
3565,Where the Heart Is,2000,1096832-where_the_heart_is,4.6,94,32,62,34,3.9,27,5,22,18,3.5,12595,78,http://content9.flixster.com/movie/25/56/255615_det.jpg
3566,The Big Kahuna,1999,big_kahuna,6.4,76,56,20,73,6.4,22,15,7,68,3.3,1772,65,http://content7.flixster.com/movie/28/12/281217_det.jpg
3567,Bossa Nova,2000,bossa_nova,6.6,28,21,7,75,0,4,2,2,50,3.2,470,54,http://content8.flixster.com/movie/10/87/67/10876714_det.jpg
3568,Goat on Fire and Smiling Fish,1999,smiling_fish_and_goat_on_fire,5.8,14,7,7,50,0,4,2,2,50,3.2,55,50,http://content9.flixster.com/movie/10/85/24/10852459_det.jpg
3569,Idioterne,1998,,\N,\N,\N,\N,\N,\N,\N,\N,\N,\N,\N,\N,\N,\N
3570,The Last September,1999,last_september,5.5,23,9,14,39,7.1,5,4,1,80,3,278,39,http://content7.flixster.com/movie/10/88/53/10885357_det.jpg
3571,Timecode,2000,timecode,6.3,80,54,26,67,6.4,21,14,7,66,3,896,50,http://content9.flixster.com/movie/27/77/277711_det.jpg
3572,Carnosaur,1993,carnosaur,3.2,9,1,8,11,0,0,0,0,0,0,0,0,http://content6.flixster.com/movie/28/41/284112_det.jpg
3573,Carnosaur 2,1995,carnosaur_2,0,2,0,2,0,0,0,0,0,0,0,0,0,http://content9.flixster.com/movie/28/51/285127_det.jpg
3574,Carnosaur 3: Primal Species,1996,carnosaur_3_primal_species,0,2,0,2,0,0,0,0,0,0,0,0,0,http://content9.flixster.com/movie/28/34/283419_det.jpg
3575,Defying Gravity,1997,1091727-defying_gravity,5.9,6,4,2,66,0,3,2,1,66,3.5,284,57,http://content8.flixster.com/movie/29/88/298822_det.jpg
3576,Cach√©,2005,1153493-cache,7.8,128,113,15,88,8.2,31,29,2,93,3.5,16387,71,http://content8.flixster.com/movie/31/17/311798_det.jpg
3577,Two Moon Junction,1988,two_moon_junction,3.2,6,0,6,0,0,1,0,1,0,3.1,1343,54,http://content9.flixster.com/movie/26/93/269395_det.jpg
3578,Gladiator,2000,gladiator,7,159,123,36,77,6.4,36,26,10,72,3.8,248672,85,http://content8.flixster.com/movie/10/80/17/10801794_det.jpg
3580,Up at the Villa,2000,up_at_the_villa,5.3,58,27,31,46,4.9,19,7,12,36,3,371,34,http://content8.flixster.com/movie/10/91/59/10915958_det.jpg
3581,Human Traffic,1999,human_traffic,6.1,28,17,11,60,5.5,7,2,5,28,4,6954,88,http://content9.flixster.com/movie/27/09/270927_det.jpg
3583,1-2-3-4 ou Les Collants noirs,1960,black-tights-1234-ou-les-collants-noirs,0,0,0,0,0,0,0,0,0,0,0,0,0,http://images.rottentomatoescdn.com/images/defaults/poster_default.gif
3584,√Ä bout de souffle,1960,breathless,8.6,48,46,2,95,8.1,12,11,1,91,4.2,10327,90,http://content7.flixster.com/movie/28/61/286193_det.jpg
3585,The Great Locomotive Chase,1956,great_locomotive_chase,0,2,1,1,50,0,0,0,0,0,0,0,0,http://content6.flixster.com/movie/30/84/308404_det.jpg
3586,The Idolmaker,1980,idolmaker,6.4,7,6,1,85,0,1,1,0,100,3.7,186,80,http://content9.flixster.com/movie/25/92/259227_det.jpg
3587,From Dusk Till Dawn,1996,from_dusk_till_dawn,6,43,27,16,62,4.9,10,5,5,50,3.4,36073,75,http://content9.flixster.com/movie/62/82/01/6282011_det.jpg
3588,The King of Marvin Gardens,1972,king_of_marvin_gardens,6.4,17,12,5,70,0,4,2,2,50,3.3,626,55,http://content9.flixster.com/movie/10/87/60/10876071_det.jpg
3589,"Die Nibelungen, Teil 1 - Siegfried",1966,die-nibelungen-teil-1-siegfried-whom-the-gods-wish-to-destroy,0,0,0,0,0,0,0,0,0,0,0,0,0,http://content7.flixster.com/movie/37/95/92/3795925_det.jpg
3590,The Lord's of Flatbush,1974,lords_of_flatbush,5.6,11,7,4,63,0,3,0,3,0,3.1,800,43,http://content8.flixster.com/movie/26/01/260194_det.jpg
3591,Mr. Mom,1983,mr_mom,5.9,17,13,4,76,0,1,0,1,0,3,3176,54,http://content6.flixster.com/movie/25/77/257712_det.jpg
3592,Les ma√Ætres du temps,1982,time-masters-les-maitres-du-temps,0,1,0,1,0,0,0,0,0,0,0,0,0,http://content8.flixster.com/movie/31/39/35/3139358_det.jpg
3593,Battlefield Earth: A Saga of the Year 3000,2000,battlefield_earth,2.3,122,3,119,2,2.4,29,1,28,3,1.6,6896,14,http://content6.flixster.com/movie/26/03/260312_det.jpg
3594,Center Stage,2000,center_stage,5,79,33,46,41,5.2,21,9,12,42,3.5,28939,79,http://content7.flixster.com/movie/25/47/254713_det.jpg
3595,Held Up,1999,held_up,3.3,30,5,25,16,3,8,1,7,12,2.9,580,48,http://content9.flixster.com/movie/26/54/265495_det.jpg
3596,Screwed,2000,1097242-screwed,3.5,30,4,26,13,2.7,5,1,4,20,2.9,1198,48,http://content8.flixster.com/movie/10/85/28/10852890_det.jpg
3597,Whipped,2000,whipped,3.2,68,9,59,13,2.9,23,3,20,13,2.4,782,32,http://content9.flixster.com/movie/27/58/275895_det.jpg
3598,Hamlet,1996,1075422-hamlet,8.2,54,51,3,94,7.2,14,11,3,78,3.8,5816,86,http://content7.flixster.com/movie/10/94/26/10942625_det.jpg
3599,Anchors Aweigh,1945,anchors_aweigh,7.2,5,3,2,60,0,0,0,0,0,0,0,0,http://content6.flixster.com/movie/29/32/293292_det.jpg
3600,Blue Hawaii,1961,blue_hawaii,4.3,6,1,5,16,0,0,0,0,0,0,0,0,http://content8.flixster.com/movie/10/90/24/10902462_det.jpg
3601,The Castaway Cowboy,1974,castaway_cowboy,0,2,1,1,50,0,0,0,0,0,0,0,0,http://content9.flixster.com/movie/10/95/64/10956431_det.jpg
3602,G.I. Blues,1960,gi_blues,4.7,5,0,5,0,0,0,0,0,0,0,0,0,http://content9.flixster.com/movie/25/95/259591_det.jpg
3603,The Gay Deceivers,1969,gay_deceivers,0,3,0,3,0,0,0,0,0,0,0,0,0,http://content8.flixster.com/movie/10/92/30/10923006_det.jpg
3604,Gypsy,1962,1009076-gypsy,6.4,11,8,3,72,0,0,0,0,0,0,0,0,http://content6.flixster.com/movie/28/63/286316_det.jpg
3605,King Creole,1958,king_creole,6.7,12,12,0,100,0,0,0,0,0,0,0,0,http://content9.flixster.com/movie/12/82/47/1282475_det.jpg
3606,On the Town,1949,1015542-on_the_town,8,16,15,1,93,0,0,0,0,0,0,0,0,http://content8.flixster.com/movie/29/28/292898_det.jpg
3607,One Little Indian,1973,one_little_indian,0,0,0,0,0,0,0,0,0,0,0,0,0,http://content7.flixster.com/movie/31/06/310697_det.jpg
3608,Pee-wee's Big Adventure,1985,peewees_big_adventure,7.4,35,32,3,91,0,4,1,3,25,3,14034,66,http://content7.flixster.com/movie/10/95/41/10954117_det.jpg
3609,Regret to Inform,1998,regret-to-inform,7.7,16,15,1,93,0,3,3,0,100,3.7,139,55,http://content8.flixster.com/movie/30/55/305530_det.jpg
3610,Roustabout,1964,roustabout,5.7,8,5,3,62,0,0,0,0,0,0,0,0,http://content6.flixster.com/movie/10/87/81/10878172_det.jpg
3612,The Slipper and the Rose: The Story of Cinderella,1976,slipper_and_the_rose,0,1,1,0,100,0,0,0,0,0,0,0,0,http://content9.flixster.com/movie/25/11/251107_det.jpg
3613,Things Change,1988,things_change,6.9,11,9,2,81,0,1,1,0,100,3.5,240,70,http://content7.flixster.com/movie/10/91/35/10913521_det.jpg
3614,Honeymoon in Vegas,1992,honeymoon_in_vegas,6,26,17,9,65,0,2,1,1,50,2.7,3153,35,http://content6.flixster.com/movie/10/89/43/10894388_det.jpg
3615,Dinosaur,2000,1097046-dinosaur,6.2,120,78,42,65,6,30,20,10,66,3,9615,48,http://content6.flixster.com/movie/10/92/08/10920812_det.jpg
3616,Loser,2000,1098734-loser,4.2,94,23,71,24,4.5,26,9,17,34,2.6,5745,37,http://content7.flixster.com/movie/26/34/263425_det.jpg
3617,Road Trip,2000,1097259-road_trip,5.9,89,52,37,58,5.9,21,14,7,66,3.3,57286,68,http://content6.flixster.com/movie/55/32/86/5532868_det.jpg
3618,Small Time Crooks,2000,small_time_crooks,6.4,98,65,33,66,6.2,22,13,9,59,3.2,3828,54,http://content7.flixster.com/movie/26/24/262409_det.jpg
3619,The Hollywood Knights,1980,hollywood_knights,0,4,1,3,25,0,0,0,0,0,0,0,0,http://content7.flixster.com/movie/26/83/268397_det.jpg
3620,The Myth of Fingerprints,1997,myth_of_fingerprints,6,19,12,7,63,0,3,1,2,33,3.2,418,54,http://content7.flixster.com/movie/10/87/44/10874409_det.jpg
3621,Possession,2009,10009228-possession,0,2,0,2,0,0,1,0,1,0,2.9,4231,34,http://content7.flixster.com/movie/10/86/81/10868161_det.jpg
3622,The Twelve Chairs,1970,1022170-twelve_chairs,6.5,13,12,1,92,0,0,0,0,0,0,0,0,http://content9.flixster.com/movie/25/34/253415_det.jpg
3623,Mission: Impossible,1996,mission_impossible,5.8,45,26,19,57,5.2,18,9,9,50,3.3,46104,70,http://content9.flixster.com/movie/25/73/257307_det.jpg
3624,Shanghai Noon,2000,shanghai_noon,6.6,130,102,28,78,5.9,28,18,10,64,3.2,29911,67,http://content9.flixster.com/movie/25/72/257299_det.jpg
3625,Better Living Through Circuitry,1999,better_living_through_circuitry,6.4,16,13,3,81,0,4,3,1,75,0,0,0,http://content8.flixster.com/movie/10/98/71/10987174_det.jpg
3626,8 ¬Ω Women,1999,8_12_women,4.9,35,14,21,40,5.2,7,2,5,28,3.1,1362,51,http://content8.flixster.com/movie/10/11/35/10113598_det.jpg
3627,Carnival of Souls,1962,1003612-carnival_of_souls,7.2,31,25,6,80,0,4,3,1,75,3.5,2508,71,http://content7.flixster.com/movie/28/79/287909_det.jpg
3628,Flying Tigers,1942,1007615-flying_tigers,5.9,8,5,3,62,0,0,0,0,0,0,0,0,http://content9.flixster.com/movie/94/58/43/9458431_det.jpg
3629,The Gold Rush,1925,the-gold-rush,8.8,30,30,0,100,0,4,4,0,100,4.1,4794,91,http://content9.flixster.com/movie/30/62/306295_det.jpg
3630,Lisa e il diavolo,1974,,\N,\N,\N,\N,\N,\N,\N,\N,\N,\N,\N,\N,\N,\N
3631,It's in the Water,1997,its_in_the_water,0,3,1,2,33,0,0,0,0,0,0,0,0,http://content9.flixster.com/movie/29/42/294291_det.jpg
3632,Monsieur Verdoux,1947,monsieur_verdoux,8,24,23,1,95,6.8,5,4,1,80,4,1388,88,http://content8.flixster.com/movie/29/02/290214_det.jpg
3633,On Her Majesty's Secret Service,1969,on_her_majestys_secret_service,6.6,37,30,7,81,6.2,5,3,2,60,3.2,8953,62,http://content9.flixster.com/movie/10/91/96/10919627_det.jpg
3634,Seven Days in May,1964,seven_days_in_may,7.8,18,18,0,100,0,3,3,0,100,3.9,754,86,http://content6.flixster.com/movie/10/87/45/10874540_det.jpg
3635,The Spy Who Loved Me,1977,spy_who_loved_me,6.7,37,29,8,78,5.2,5,2,3,40,3.4,10473,71,http://content6.flixster.com/movie/10/88/65/10886552_det.jpg
3636,Ceux qui m'aiment prendront le train,1998,those_who_love_me_can_take_the_train,5.7,17,10,7,58,0,2,2,0,100,3.6,478,68,http://content9.flixster.com/movie/10/91/42/10914203_det.jpg
3637,Sans toit ni loi,1985,vagabond,8.6,11,11,0,100,0,1,1,0,100,4,549,82,http://content8.flixster.com/movie/90/48/82/9048822_det.jpg
3638,Moonraker,1979,1014217-moonraker,5.7,36,23,13,63,7.6,6,6,0,100,3,10343,48,http://content7.flixster.com/movie/26/08/260897_det.jpg
3639,The Man with the Golden Gun,1974,man_with_the_golden_gun,5.1,33,17,16,51,3.6,5,0,5,0,3.3,11297,63,http://content7.flixster.com/movie/25/89/258921_det.jpg
3640,King of New York,1990,king_of_new_york,6,23,16,7,69,6.2,5,3,2,60,3.7,5329,77,http://content9.flixster.com/movie/10/92/96/10929695_det.jpg
3641,A Woman of Paris: A Drama of Fate,1923,,0,3,3,0,100,0,0,0,0,0,0,0,0,http://content8.flixster.com/movie/52/47/00/5247006_det.jpg
3642,In Old California,1942,in_old_california,0,0,0,0,0,0,0,0,0,0,0,0,0,http://content6.flixster.com/movie/30/42/304216_det.jpg
3643,The Fighting Seabees,1944,fighting_seabees,6.8,5,5,0,100,0,0,0,0,0,0,0,0,http://content7.flixster.com/movie/29/41/294101_det.jpg
3644,Dark Command,1940,dark_command,0,4,4,0,100,0,0,0,0,0,0,0,0,http://content9.flixster.com/movie/27/42/65/2742651_det.jpg
3645,Cl√©o de 5 √† 7,1962,cleo_de_5_a_7,8.6,21,20,1,95,0,2,1,1,50,4,1372,88,http://content8.flixster.com/movie/30/04/300406_det.jpg
3646,Big Momma's House,2000,big_mommas_house,4.4,80,24,56,30,4.2,26,9,17,34,3.2,47401,68,http://content7.flixster.com/movie/55/05/60/5505609_det.jpg
3648,The Abominable Snowman,1957,the-abominable-snowman,0,0,0,0,0,0,0,0,0,0,0,0,0,http://content8.flixster.com/movie/28/92/289206_det.jpg
3649,American Gigolo,1980,american_gigolo,6.4,15,11,4,73,0,1,1,0,100,3.1,2098,49,http://content7.flixster.com/movie/28/49/284929_det.jpg
3650,Angustia,1987,anguish,0,3,1,2,33,0,0,0,0,0,0,0,0,http://content8.flixster.com/movie/30/41/47/3041470_det.jpg
3651,La novia ensangrentada,1972,blood_spattered_bride,7.2,6,6,0,100,0,0,0,0,0,0,0,0,http://content7.flixster.com/movie/10/89/03/10890317_det.jpg
3652,Paura nella citt√† dei morti viventi,1980,city_of_the_living_dead,4.9,10,5,5,50,0,0,0,0,0,0,0,0,http://content8.flixster.com/movie/10/88/57/10885706_det.jpg
3653,The Endless Summer,1966,endless_summer,7.2,15,15,0,100,0,3,3,0,100,4.1,1286,88,http://content7.flixster.com/movie/28/97/40/2897409_det.jpg
3654,The Guns of Navarone,1961,guns_of_navarone,8,20,19,1,95,0,0,0,0,0,0,0,0,http://content7.flixster.com/movie/25/57/255725_det.jpg
3655,La grande bouffe,1973,grande_bouffe,0,3,2,1,66,0,1,0,1,0,4,1017,85,http://content7.flixster.com/movie/10/87/44/10874489_det.jpg
3656,Lured,1947,lured,0,3,3,0,100,0,0,0,0,0,0,0,0,http://content7.flixster.com/movie/30/11/301129_det.jpg
3658,Quatermass and the Pit,1967,quatermass_and_the_pit,7.2,8,6,2,75,0,2,0,2,0,3.7,842,75,http://content8.flixster.com/movie/10/88/20/10882086_det.jpg
3659,Quatermass 2,1957,quatermass_ii,6.3,8,6,2,75,0,1,0,1,0,0,0,0,http://content7.flixster.com/movie/31/00/310017_det.jpg
3660,Puppetmaster,1989,puppet_master,3.4,5,1,4,20,0,0,0,0,0,0,0,0,http://content9.flixster.com/movie/10/93/87/10938743_det.jpg
3661,Puppet Master II,1991,puppet_master_2_his_unholy_creations,4.4,5,1,4,20,0,0,0,0,0,0,0,0,http://content7.flixster.com/movie/10/94/36/10943685_det.jpg
3662,Puppet Master III: Toulon's Revenge,1991,puppet_master_3_toulons_revenge,0,2,1,1,50,0,0,0,0,0,0,0,0,http://content7.flixster.com/movie/11/15/27/11152777_det.jpg
3663,Puppet Master 4,1993,puppet-master-iv,3.6,5,0,5,0,0,0,0,0,0,0,0,0,http://content8.flixster.com/movie/10/93/87/10938738_det.jpg
3664,Puppet Master 5: The Final Chapter,1994,puppet_master_5_the_final_chapter,0,2,0,2,0,0,0,0,0,0,0,0,0,http://content8.flixster.com/movie/11/15/27/11152778_det.jpg
3665,Curse of the Puppet Master,1998,curse_of_the_puppet_master,0,2,0,2,0,0,0,0,0,0,0,0,0,http://content6.flixster.com/movie/10/93/87/10938744_det.jpg
3666,Retro Puppet Master,1999,puppet_master_the_legacy,0,0,0,0,0,0,0,0,0,0,0,0,0,http://content9.flixster.com/movie/10/93/87/10938735_det.jpg
3667,Rent-a-Cop,1987,rentacop,3.8,11,2,9,18,0,1,0,1,0,2.3,601,19,http://content9.flixster.com/movie/10/91/99/10919991_det.jpg
3668,Romeo + Juliet,1996,1102360-romeo_and_juliet,0,0,0,0,0,0,0,0,0,0,0,0,0,http://content6.flixster.com/movie/10/85/38/10853892_det.jpg
3669,Stay Tuned,1992,stay_tuned,4.8,12,6,6,50,0,0,0,0,0,0,0,0,http://content8.flixster.com/movie/26/19/261994_det.jpg
3670,Story of G.I. Joe,1945,1095636-story_of_gi_joe,5.9,10,7,3,70,0,2,0,2,0,3.5,303,71,http://content9.flixster.com/movie/29/43/294323_det.jpg
3671,Blazing Saddles,1974,blazing_saddles,8.1,45,40,5,88,7.5,5,4,1,80,3.9,41980,89,http://content6.flixster.com/movie/98/44/27/9844276_det.jpg
3672,Benji the Hunted,1987,benji_the_hunted,5.6,7,4,3,57,0,0,0,0,0,0,0,0,http://content9.flixster.com/movie/11/13/64/11136435_det.jpg
3673,Benji the Hunted,1987,benji_the_hunted,5.6,7,4,3,57,0,0,0,0,0,0,0,0,http://content9.flixster.com/movie/11/13/64/11136435_det.jpg
3674,For the Love of Benji,1977,for_the_love_of_benji,0,0,0,0,0,0,0,0,0,0,0,0,0,http://content9.flixster.com/movie/25/35/253507_det.jpg
3675,White Christmas,1954,1023543-white_christmas,6.4,30,23,7,76,0,3,1,2,33,0,0,0,http://content9.flixster.com/movie/29/04/290499_det.jpg
3676,Eraserhead,1976,eraserhead,7.9,40,36,4,90,6.5,5,4,1,80,3.9,15996,83,http://content6.flixster.com/movie/28/60/286000_det.jpg
3677,The Boys of Baraka,2005,boys_of_baraka,6.8,42,31,11,73,6.8,13,10,3,76,4,627,84,http://content9.flixster.com/movie/72/91/87/7291875_det.jpg
3678,The Man with the Golden Arm,1955,man_with_the_golden_arm,6.9,17,14,3,82,0,3,1,2,33,3.8,961,84,http://content9.flixster.com/movie/10/84/60/10846095_det.jpg
3679,The Decline of Western Civilization Part III,1998,decline_of_western_civilization_iii,7.6,7,7,0,100,0,2,2,0,100,4,242,78,http://content7.flixster.com/movie/35/53/91/3553913_det.jpg
3680,The Decline of Western Civilization Part II: The Metal Years,1988,decline_of_western_civilization_pt_2_the_the_metal_years,6.4,5,4,1,80,0,2,1,1,50,3.9,762,80,http://content6.flixster.com/movie/35/53/88/3553880_det.jpg
3681,Per qualche dollaro in pi√π,1965,for_a_few_dollars_more,7.8,24,22,2,91,0,2,1,1,50,3.9,15319,91,http://content8.flixster.com/movie/15/95/75/1595754_det.jpg
3682,Magnum Force,1973,magnum_force,6.6,20,16,4,80,0,0,0,0,0,0,0,0,http://content7.flixster.com/movie/27/20/272097_det.jpg
3683,Blood Simple.,1984,blood_simple,8.1,77,73,4,94,7.9,12,11,1,91,3.9,11335,86,http://content7.flixster.com/movie/26/92/269209_det.jpg
3684,The Fabulous Baker Boys,1989,fabulous_baker_boys,7.4,23,22,1,95,8.2,5,5,0,100,3.2,2272,59,http://content6.flixster.com/movie/27/34/273428_det.jpg
3685,Prizzi's Honor,1985,prizzis_honor,7,32,28,4,87,0,3,2,1,66,3.3,2048,61,http://content8.flixster.com/movie/28/46/284602_det.jpg
3686,Flatliners,1990,flatliners,5.3,23,12,11,52,0,2,1,1,50,3.2,10417,61,http://content7.flixster.com/movie/10/48/41/10484189_det.jpg
3687,Gandahar,1988,gandahar-light-years,0,0,0,0,0,0,0,0,0,0,0,0,0,http://content9.flixster.com/movie/11/15/33/11153359_det.jpg
3688,Porky's,1982,1016561-porkys,4.5,22,7,15,31,0,1,0,1,0,3.1,8737,58,http://content8.flixster.com/movie/27/20/272018_det.jpg
3689,Porky's II: The Next Day,1983,porkys_ii_the_next_day,3.6,9,1,8,11,0,0,0,0,0,0,0,0,http://content8.flixster.com/movie/25/05/07/2505078_det.jpg
3690,Porky's Revenge,1985,porkys_revenge,3.7,11,3,8,27,0,0,0,0,0,0,0,0,http://content8.flixster.com/movie/25/05/06/2505066_det.jpg
3691,Private School,1983,1016805-private_school,0,1,0,1,0,0,0,0,0,0,0,0,0,http://content8.flixster.com/movie/10/92/42/10924218_det.jpg
3692,Class of Nuke 'Em High,1986,class_of_nuke_em_high,4.2,5,1,4,20,0,0,0,0,0,0,0,0,http://content8.flixster.com/movie/10/89/54/10895446_det.jpg
3693,The Toxic Avenger,1984,toxic_avenger,5.4,16,10,6,62,0,3,3,0,100,3.1,5107,60,http://content8.flixster.com/movie/10/93/48/10934830_det.jpg
3694,The Toxic Avenger Part II,1989,the-toxic-avenger-part-ii,2.7,8,0,8,0,0,0,0,0,0,0,0,0,http://content8.flixster.com/movie/10/93/48/10934826_det.jpg
3695,The Toxic Avenger Part III: The Last Temptation of Toxie,1989,toxic_avenger_the_pt_3_the_last_temptation_of_toxie,0,1,0,1,0,0,0,0,0,0,0,0,0,http://content7.flixster.com/movie/10/93/48/10934829_det.jpg
3696,Night of the Creeps,1986,night_of_the_creeps,6.7,11,8,3,72,0,0,0,0,0,0,0,0,http://content7.flixster.com/movie/20/77/76/2077765_det.jpg
3697,Predator,1987,predator,6.8,37,28,9,75,0,4,2,2,50,3.5,52908,83,http://content8.flixster.com/movie/10/93/20/10932042_det.jpg
3698,The Running Man,1987,running_man,5.5,32,20,12,62,5,5,2,3,40,3.2,13632,59,http://content9.flixster.com/movie/28/51/285191_det.jpg
3699,Starman,1984,starman,6.5,23,18,5,78,0,4,2,2,50,3.2,5773,61,http://content9.flixster.com/movie/25/72/257295_det.jpg
3700,The Brother from Another Planet,1984,brother_from_another_planet,7.1,24,22,2,91,0,4,2,2,50,3.5,941,74,http://content9.flixster.com/movie/27/55/275599_det.jpg
3701,Alien Nation,1989,,\N,\N,\N,\N,\N,\N,\N,\N,\N,\N,\N,\N,\N,\N
3702,Mad Max,1979,mad_max,7.7,38,36,2,94,6.4,5,4,1,80,3.4,17975,69,http://content6.flixster.com/movie/28/29/282992_det.jpg
3703,Mad Max 2,1981,road_warrior,8.3,36,36,0,100,7.8,6,6,0,100,3.5,18318,76,http://content6.flixster.com/movie/10/86/48/10864824_det.jpg
3704,Mad Max Beyond Thunderdome,1985,mad_max_beyond_thunderdome,6.3,37,30,7,81,6.7,7,6,1,85,3.1,11185,50,http://content7.flixster.com/movie/10/88/83/10888321_det.jpg
3705,Bird on a Wire,1990,bird_on_a_wire,4.4,20,6,14,30,0,2,0,2,0,2.8,6723,43,http://content9.flixster.com/movie/10/88/55/10885575_det.jpg
3706,Angel Heart,1987,1000959-angel_heart,7.1,20,15,5,75,0,2,2,0,100,3.6,7026,79,http://content7.flixster.com/movie/26/91/269121_det.jpg
3707,Nine 1/2 Weeks,1986,9_12_weeks,5.5,21,13,8,61,0,1,1,0,100,3,6256,57,http://content8.flixster.com/movie/10/89/60/10896014_det.jpg
3708,Firestarter,1984,firestarter,5,21,8,13,38,0,1,0,1,0,3.1,7166,57,http://content6.flixster.com/movie/10/84/11/10841196_det.jpg
3709,Sleepwalking,2008,sleepwalking,4.2,57,10,47,17,4.3,22,4,18,18,3,8038,45,http://content7.flixster.com/movie/10/84/04/10840437_det.jpg
3710,Action Jackson,1988,action_jackson,3.2,10,1,9,10,0,1,0,1,0,2.6,2187,30,http://content9.flixster.com/movie/27/99/279991_det.jpg
3711,Sarafina!,1992,sarafina,5.1,8,4,4,50,0,1,0,1,0,3.8,1077,83,http://content7.flixster.com/movie/25/82/258217_det.jpg
3712,Soapdish,1991,soapdish,6,33,24,9,72,5.8,8,5,3,62,3.1,2023,56,http://content7.flixster.com/movie/25/90/259001_det.jpg
3713,The Long Walk Home,1990,1031744-long_walk_home,6.7,12,10,2,83,0,2,2,0,100,3.6,831,78,http://content9.flixster.com/movie/10/87/02/10870247_det.jpg
3714,Clara's Heart,1988,claras_heart,5.2,8,3,5,37,0,1,0,1,0,3.5,408,69,http://content8.flixster.com/movie/62/25/93/6225934_det.jpg
3715,Burglar,1987,1003276-burglar,4,11,3,8,27,0,1,0,1,0,2.7,844,43,http://content7.flixster.com/movie/28/05/280509_det.jpg
3716,Fatal Beauty,1987,fatal_beauty,3.5,12,3,9,25,0,4,1,3,25,2.8,1052,40,http://content9.flixster.com/movie/27/71/277199_det.jpg
3717,Gone in Sixty Seconds,2000,1097865-gone_in_60_seconds,4.4,133,32,101,24,4,35,8,27,22,3.5,92563,79,http://content8.flixster.com/movie/10/86/23/10862358_det.jpg
3718,American Pimp,1999,1097930-american_pimp,6,21,11,10,52,0,4,1,3,25,3.5,767,67,http://content6.flixster.com/movie/11/13/87/11138724_det.jpg
3719,Love's Labour's Lost,2000,loves_labours_lost,5.6,61,30,31,49,4.7,17,6,11,35,3.1,949,46,http://content7.flixster.com/movie/11/12/99/11129937_det.jpg
3720,Sunshine,2007,ignite_2007,0,0,0,0,0,0,0,0,0,0,0,0,0,http://content6.flixster.com/movie/10/84/17/10841740_det.jpg
3721,Trixie,2000,trixie,4.2,48,13,35,27,3.4,14,2,12,14,2.8,268,30,http://content6.flixster.com/movie/28/43/284308_det.jpg
3722,The Last American Virgin,1982,last_american_virgin,5.8,9,6,3,66,0,1,0,1,0,3.3,3330,60,http://content6.flixster.com/movie/10/88/86/10888644_det.jpg
3723,Hamlet,1996,1075422-hamlet,8.2,54,51,3,94,7.2,14,11,3,78,3.8,5816,86,http://content7.flixster.com/movie/10/94/26/10942625_det.jpg
3724,Coming Home,1978,1004559-coming_home,7.4,21,17,4,80,0,4,2,2,50,3.7,1137,79,http://content8.flixster.com/movie/27/07/270726_det.jpg
3725,American Pop,1981,american_pop,5.6,16,9,7,56,0,0,0,0,0,0,0,0,http://content9.flixster.com/movie/27/46/274695_det.jpg
3726,Assault on Precinct 13,2005,assault_on_precinct_13,5.9,160,96,64,60,6,36,23,13,63,3.1,12635,54,http://content7.flixster.com/movie/26/88/268805_det.jpg
3727,Near Dark,1987,1014793-near_dark,7.4,41,37,4,90,6.9,6,5,1,83,3.5,5751,73,http://content7.flixster.com/movie/11/15/07/11150793_det.jpg
3728,One False Move,1992,one_false_move,8.5,26,26,0,100,0,2,2,0,100,3.5,963,67,http://content6.flixster.com/movie/27/38/273816_det.jpg
3729,Shaft,1971,1018699-shaft,7.4,31,28,3,90,0,2,1,1,50,3.3,2211,66,http://content9.flixster.com/movie/27/22/272211_det.jpg
3730,The Conversation,1974,conversation,8.6,43,42,1,97,0,4,4,0,100,4,7644,89,http://content7.flixster.com/movie/10/88/81/10888101_det.jpg
3731,Cutter's Way,1981,cutters_way,7.3,5,5,0,100,0,0,0,0,0,0,0,0,http://content9.flixster.com/movie/27/99/279923_det.jpg
3732,Balls of Fury,2007,balls_of_fury,4.2,127,29,98,22,4.5,24,8,16,33,2.8,85682,36,http://content6.flixster.com/movie/10/92/34/10923416_det.jpg
3733,The Paper Chase,1973,paper_chase,7.3,24,21,3,87,0,4,3,1,75,3.5,842,72,http://content8.flixster.com/movie/10/95/43/10954302_det.jpg
3734,Prince of the City,1981,prince_of_the_city,7.3,16,15,1,93,0,1,1,0,100,3.9,431,82,http://content9.flixster.com/movie/85/74/17/8574179_det.jpg
3735,Serpico,1973,serpico,8,37,34,3,91,0,4,4,0,100,3.8,14881,85,http://content9.flixster.com/movie/26/96/269611_det.jpg
3736,Ace in the Hole,1951,1107426-ace_in_the_hole,7.9,22,19,3,86,0,4,2,2,50,4.2,1846,92,http://content9.flixster.com/movie/10/93/42/10934203_det.jpg
3737,Lonely Are the Brave,1962,lonely_are_the_brave,8.4,10,9,1,90,0,0,0,0,0,0,0,0,http://content9.flixster.com/movie/95/16/47/9516475_det.jpg
3738,The Sugarland Express,1974,sugarland_express,7.2,25,23,2,92,0,2,1,1,50,3.3,1677,60,http://content8.flixster.com/movie/10/86/79/10867930_det.jpg
3739,Trouble in Paradise,1932,1118325-trouble_in_paradise,8.4,22,20,2,90,7.6,8,7,1,87,4.2,1059,91,http://content8.flixster.com/movie/10/88/14/10881454_det.jpg
3740,Big Trouble in Little China,1986,his-big-white-self,0,0,0,0,0,0,0,0,0,0,0,0,0,http://content9.flixster.com/movie/83/00/99/8300999_det.jpg
3741,Badlands,1973,1001577-badlands,8.7,38,37,1,97,0,4,4,0,100,0,0,0,http://content7.flixster.com/movie/25/92/259225_det.jpg
3742,Bronenosets Potyomkin,1925,battleship_potemkin,9,30,30,0,100,0,3,3,0,100,4,4546,85,http://content8.flixster.com/movie/28/81/288126_det.jpg
3743,Boys and Girls,2000,boys_and_girls,3.8,61,7,54,11,3.9,20,3,17,15,2.8,3763,51,http://content9.flixster.com/movie/25/81/258191_det.jpg
3744,Shaft,1971,1018699-shaft,7.4,31,28,3,90,0,2,1,1,50,3.3,2211,66,http://content9.flixster.com/movie/27/22/272211_det.jpg
3745,Titan A.E.,2000,titan_ae,5.7,97,49,48,50,5.9,27,15,12,55,3.2,13747,59,http://content9.flixster.com/movie/25/69/256999_det.jpg
3746,La lengua de las mariposas,1999,la-lengua-de-las-mariposas-butterfly-butterfly-tongues,7.3,24,23,1,95,7.8,5,5,0,100,4.1,1520,89,http://content9.flixster.com/movie/27/07/270707_det.jpg
3747,Jesus' Son,1999,jesus_son,7.3,43,35,8,81,7.6,9,7,2,77,3.8,1524,83,http://content8.flixster.com/movie/10/88/36/10883650_det.jpg
3748,Match Point,2005,match_point,7.2,205,158,47,77,7.9,40,36,4,90,3.4,41276,78,http://content7.flixster.com/movie/10/89/54/10895469_det.jpg
3749,"Le temps retrouv√©, d'apr√®s l'oeuvre de Marcel Proust",1999,time_regained,7,25,17,8,68,0,3,3,0,100,3.6,451,71,http://content8.flixster.com/movie/29/88/298818_det.jpg
3751,Chicken Run,2000,chicken_run,8,139,134,5,96,7.9,31,31,0,100,3,41786,53,http://content9.flixster.com/movie/10/86/71/10867195_det.jpg
3752,"Me, Myself & Irene",2000,me_myself_and_irene,5.4,95,46,49,48,4.7,24,9,15,37,3.1,39953,60,http://content8.flixster.com/movie/10/91/55/10915566_det.jpg
3753,The Patriot,2000,1098149-patriot,6.1,131,81,50,61,5.2,30,14,16,46,3.6,80249,80,http://content6.flixster.com/movie/10/89/47/10894796_det.jpg
3754,The Adventures of Rocky & Bullwinkle,2000,adventures_of_rocky_and_bullwinkle,4.8,92,39,53,42,5.2,26,13,13,50,2.2,4613,24,http://content6.flixster.com/movie/26/34/263400_det.jpg
3755,The Perfect Storm,2000,big-boats-busy-harbors,0,0,0,0,0,0,0,0,0,0,0,0,0,http://content6.flixster.com/movie/10/85/75/10857584_det.jpg
3756,The Golden Bowl,2000,golden_bowl,5.3,85,45,40,52,5.6,27,15,12,55,3,832,38,http://content8.flixster.com/movie/27/14/271410_det.jpg
3757,Asylum,2008,10009261-asylum,0,2,0,2,0,0,1,0,1,0,2.2,1071,17,http://content8.flixster.com/movie/10/85/28/10852822_det.jpg
3758,Communion,1976,alice_sweet_alice,0,3,2,1,66,0,0,0,0,0,0,0,0,http://content9.flixster.com/movie/27/88/278819_det.jpg
3759,Fun & Fancy Free,1947,fun_and_fancy_free,5.9,6,4,2,66,0,2,1,1,50,3.4,1979,62,http://content9.flixster.com/movie/10/92/18/10921807_det.jpg
3760,The Kentucky Fried Movie,1977,kentucky_fried_movie,6.6,26,20,6,76,0,3,2,1,66,3.5,2991,67,http://content8.flixster.com/movie/26/77/267794_det.jpg
3761,Bound by Honor,1993,blood_in_blood_out,5.4,10,5,5,50,0,3,1,2,33,4.1,9658,92,http://content9.flixster.com/movie/10/89/03/10890315_det.jpg
3763,F/X2,1991,fx2_the_deadly_art_of_illusion,4.6,12,3,9,25,0,2,0,2,0,2.8,1000,37,http://content9.flixster.com/movie/10/91/76/10917691_det.jpg
3764,F/X2,1991,fx2_the_deadly_art_of_illusion,4.6,12,3,9,25,0,2,0,2,0,2.8,1000,37,http://content9.flixster.com/movie/10/91/76/10917691_det.jpg
3765,The Hot Spot,1990,hottest-mailcom,0,0,0,0,0,0,0,0,0,0,0,0,0,http://content8.flixster.com/movie/10/88/62/10886262_det.jpg
3766,Missing in Action 2: The Beginning,1985,missing_in_action_2_the_beginning,0,0,0,0,0,0,0,0,0,0,0,0,0,http://content6.flixster.com/movie/26/09/04/2609048_det.jpg
3767,Missing in Action 2: The Beginning,1985,missing_in_action_2_the_beginning,0,0,0,0,0,0,0,0,0,0,0,0,0,http://content6.flixster.com/movie/26/09/04/2609048_det.jpg
3768,Braddock: Missing in Action III,1988,braddock_missing_in_action_3,0,0,0,0,0,0,0,0,0,0,0,0,0,http://content6.flixster.com/movie/62/57/87/6257876_det.jpg
3769,Thunderbolt and Lightfoot,1974,thunderbolt_and_lightfoot,6.6,22,19,3,86,0,3,2,1,66,3.5,1983,69,http://content7.flixster.com/movie/11/14/55/11145573_det.jpg
3770,Dreamscape,1984,dreamscape,6.4,27,21,6,77,0,3,1,2,33,3.1,2088,48,http://content6.flixster.com/movie/26/76/267600_det.jpg
3771,The Golden Voyage of Sinbad,1974,golden_voyage_of_sinbad,5.4,7,4,3,57,0,0,0,0,0,0,0,0,http://content6.flixster.com/movie/11/11/99/11119928_det.jpg
3772,Il rosso segno della follia,1970,,0,4,2,2,50,0,0,0,0,0,0,0,0,http://content9.flixster.com/movie/10/89/43/10894391_det.jpg
3773,House Party,1990,house_party,6.8,22,21,1,95,7.5,6,6,0,100,2.9,3949,74,http://content6.flixster.com/movie/10/85/22/10852288_det.jpg
3774,House Party 2,1991,house_party_2,4.4,12,3,9,25,0,2,0,2,0,2.8,2457,59,http://content6.flixster.com/movie/27/32/273200_det.jpg
3775,Make Mine Music,1946,make_mine_music,6.3,9,6,3,66,0,3,1,2,33,3.1,777,46,http://content6.flixster.com/movie/10/87/88/10878876_det.jpg
3776,Melody Time,1948,melody_time,7.3,8,7,1,87,0,2,2,0,100,3.2,896,48,http://content8.flixster.com/movie/25/17/251726_det.jpg
3777,Nekromantik,1987,nekromantik_1987,4.7,6,3,3,50,0,0,0,0,0,0,0,0,http://content9.flixster.com/movie/16/90/59/1690599_det.jpg
3779,Project Moon Base,1953,project-moonbase,0,1,0,1,0,0,0,0,0,0,0,0,0,http://content9.flixster.com/movie/10/84/81/10848107_det.jpg
3780,Rocketship X-M,1950,rocketship_xm,0,1,1,0,100,0,0,0,0,0,0,0,0,http://content7.flixster.com/movie/30/40/304001_det.jpg
3781,Shaft in Africa,1973,shaft_in_africa,4.9,7,3,4,42,0,0,0,0,0,0,0,0,http://content9.flixster.com/movie/10/87/58/10875831_det.jpg
3782,Shaft's Big Score!,1972,shafts_big_score,5.6,10,7,3,70,0,1,1,0,100,0,0,0,http://content9.flixster.com/movie/28/10/281091_det.jpg
3783,Croupier,1998,croupier,7.7,53,52,1,98,7.7,13,13,0,100,3.6,2486,76,http://content9.flixster.com/movie/28/68/286811_det.jpg
3784,The Karate Kid,1984,karate_kid,6.9,41,37,4,90,6.9,5,4,1,80,3.3,20688,71,http://content7.flixster.com/movie/11/12/21/11122169_det.jpg
3785,Scary Movie,2000,scary_movie,5.5,109,58,51,53,5.1,28,14,14,50,3,178002,50,http://content7.flixster.com/movie/10/87/99/10879941_det.jpg
3786,But I'm a Cheerleader,1999,but_im_a_cheerleader,4.7,46,15,31,32,4.1,12,3,9,25,3.4,7077,74,http://content8.flixster.com/movie/27/53/275310_det.jpg
3787,Xizao,1999,shower,7.3,29,25,4,86,6.6,5,3,2,60,3.9,957,89,http://content6.flixster.com/movie/26/13/261324_det.jpg
3788,Blowup,1966,1002673-blowup,8,35,30,5,85,7.5,5,4,1,80,4,7433,86,http://content8.flixster.com/movie/10/89/43/10894346_det.jpg
3789,The Pawnbroker,1964,pawnbroker,8.4,6,6,0,100,0,0,0,0,0,0,0,0,http://content9.flixster.com/movie/29/35/293527_det.jpg
3790,Groove,2000,groove,6.1,50,28,22,56,5.5,14,6,8,42,3.8,1177,79,http://content6.flixster.com/movie/27/43/274396_det.jpg
3791,Footloose,1984,1007657-footloose,5.6,32,18,14,56,0,4,3,1,75,3.3,28933,73,http://content9.flixster.com/movie/55/12/35/5512351_det.jpg
3792,Duel in the Sun,1946,duel_in_the_sun,6.5,14,12,2,85,0,0,0,0,0,0,0,0,http://content7.flixster.com/movie/99/14/88/9914881_det.jpg
3793,X-Men,2000,xmen,7,152,124,28,81,5.8,32,19,13,59,3.7,133573,83,http://content7.flixster.com/movie/10/92/95/10929501_det.jpg
3794,Chuck & Buck,2000,chuck_and_buck,7,85,72,13,84,7,31,26,5,83,3.2,907,59,http://content8.flixster.com/movie/27/96/279694_det.jpg
3795,The Five Senses,1999,five_senses,6.7,31,23,8,74,6.3,7,4,3,57,3.6,461,76,http://content8.flixster.com/movie/10/92/09/10920970_det.jpg
3796,The Wisdom of Crocodiles,1998,immortality,5.3,19,9,10,47,6.3,5,4,1,80,3.2,1130,51,http://content7.flixster.com/movie/27/68/276829_det.jpg
3797,The In Crowd,2000,1098652-in_crowd,2.7,52,1,51,1,2.4,14,0,14,0,2.6,925,41,http://content9.flixster.com/movie/26/32/263295_det.jpg
3798,What Lies Beneath,2000,what_lies_beneath,5.5,122,55,67,45,5.1,30,13,17,43,3.1,17841,61,http://content6.flixster.com/movie/34/35/84/3435848_det.jpg
3799,Pok√©mon: The Movie 2000,2000,pokemon_the_movie_2000,3.8,63,10,53,15,4,18,4,14,22,2.7,8481,51,http://content8.flixster.com/movie/10/92/75/10927590_det.jpg
3800,Les amants criminels,1999,criminal_lovers,6.1,14,9,5,64,0,2,1,1,50,3.4,502,63,http://content8.flixster.com/movie/10/88/93/10889302_det.jpg
3801,Anatomy of a Murder,1959,anatomy-of-a-murder,8.5,35,35,0,100,0,4,4,0,100,4,3171,89,http://content8.flixster.com/movie/11/14/87/11148722_det.jpg
3802,Freejack,1992,freejack,4.1,12,2,10,16,0,1,0,1,0,2.6,3020,27,http://content6.flixster.com/movie/27/97/279724_det.jpg
3803,Greaser's Palace,1972,greasers_palace,4,5,2,3,40,0,1,0,1,0,3.7,274,72,http://content8.flixster.com/movie/39/56/48/3956482_det.jpg
3804,Some Like It Hot,1959,some_like_it_hot,8.9,40,39,1,97,0,4,4,0,100,4.1,23119,93,http://content9.flixster.com/movie/10/55/31/10553171_det.jpg
3805,Knight Rider,2008,knight_rider,0,0,0,0,0,0,0,0,0,0,0,0,0,http://content7.flixster.com/movie/10/86/01/10860117_det.jpg
3806,Mackenna's Gold,1969,mackennas_gold,5.4,5,2,3,40,0,0,0,0,0,0,0,0,http://content6.flixster.com/movie/29/53/295396_det.jpg
3807,Sinbad and the Eye of the Tiger,1977,sinbad_and_the_eye_of_the_tiger,6,8,5,3,62,0,0,0,0,0,0,0,0,http://content7.flixster.com/movie/10/93/16/10931669_det.jpg
3808,La ciociara,1960,1022238-two_women,8.6,7,7,0,100,0,0,0,0,0,0,0,0,http://content7.flixster.com/movie/11/15/22/11152213_det.jpg
3809,What About Bob?,1991,what_about_bob,6.4,38,31,7,81,6.9,7,6,1,85,3.3,13746,74,http://content8.flixster.com/movie/25/46/254602_det.jpg
3810,White Sands,1992,white_sands,5,13,6,7,46,0,1,0,1,0,2.9,802,36,http://content6.flixster.com/movie/10/88/01/10880192_det.jpg
3811,'Breaker' Morant,1980,breaker_morant,8.4,20,20,0,100,0,0,0,0,0,0,0,0,http://content6.flixster.com/movie/31/55/14/3155140_det.jpg
3812,Every Thing You Always Wanted to Know About Sex * But Were Afraid to Ask,1972,everything_you_always_wanted_to_know_about_sex_but_were_afraid_to_ask,7.3,19,17,2,89,0,0,0,0,0,0,0,0,http://content7.flixster.com/movie/10/83/96/10839641_det.jpg
3813,Interiors,1978,interiors,6.5,12,9,3,75,0,0,0,0,0,0,0,0,http://content6.flixster.com/movie/26/07/260700_det.jpg
3814,Love and Death,1975,love_and_death,8,15,15,0,100,0,1,1,0,100,4,4797,88,http://content9.flixster.com/movie/10/88/73/10887311_det.jpg
3816,La historia oficial,1985,official_story,8.3,8,8,0,100,0,1,1,0,100,3.9,624,86,http://content8.flixster.com/movie/10/88/87/10888722_det.jpg
3817,S√∏ndagsengler,1996,other_side_of_sunday,0,3,2,1,66,0,0,0,0,0,0,0,0,http://content9.flixster.com/movie/25/99/259903_det.jpg
3818,Pot o' Gold,1941,pot_o_gold,0,2,1,1,50,0,0,0,0,0,0,0,0,http://content7.flixster.com/movie/10/91/52/10915293_det.jpg
3819,Tampopo,1985,tampopo,8.3,13,13,0,100,0,1,1,0,100,4.3,2542,93,http://content9.flixster.com/movie/30/69/306915_det.jpg
3820,Thomas and the Magic Railroad,2000,thomas_and_the_magic_railroad,3.9,65,12,53,18,4.3,19,5,14,26,2.8,700,41,http://content9.flixster.com/movie/25/12/251295_det.jpg
3821,Nutty Professor II: The Klumps,2000,nutty_professor_ii_the_klumps,4.4,84,22,62,26,4.8,22,8,14,36,2.7,14847,53,http://content8.flixster.com/movie/28/85/288598_det.jpg
3822,La fille sur le pont,1999,girl_on_the_bridge,7.4,39,35,4,89,7.4,7,6,1,85,4.1,2378,88,http://content8.flixster.com/movie/10/92/73/10927326_det.jpg
3823,Wonderland,2003,wonderland,5,98,34,64,34,4.5,32,7,25,21,3.3,3666,67,http://content7.flixster.com/movie/26/94/269429_det.jpg
3824,Autumn in New York,2000,autumn_in_new_york,4.1,68,14,54,20,3.6,19,3,16,15,3,6655,56,http://content9.flixster.com/movie/10/88/81/10888131_det.jpg
3825,Coyote Ugly,2000,coyote_ugly,3.9,94,20,74,21,3.6,27,5,22,18,3.2,65988,73,http://content7.flixster.com/movie/25/81/258105_det.jpg
3826,Hollow Man,2000,hollow_man,4.4,112,31,81,27,3.8,29,5,24,17,2.6,18221,35,http://content6.flixster.com/movie/63/74/30/6374304_det.jpg
3827,Space Cowboys,2000,space_cowboys,6.8,114,90,24,78,7,28,23,5,82,3,9433,49,http://content6.flixster.com/movie/25/79/257904_det.jpg
3829,Mad About Mambo,2000,mad_about_mambo,5.2,14,8,6,57,0,4,1,3,25,3.1,674,46,http://content7.flixster.com/movie/10/91/63/10916361_det.jpg
3830,Psycho Beach Party,2000,psycho_beach_party,5.5,31,17,14,54,4.4,7,2,5,28,3.3,1978,62,http://content7.flixster.com/movie/10/93/52/10935297_det.jpg
3831,Saving Grace,2000,,6,88,56,32,63,6.3,23,15,8,65,3.8,3065,82,http://content8.flixster.com/movie/10/91/52/10915290_det.jpg
3832,I tre volti della paura,1963,black_sabbath,6.7,12,10,2,83,0,0,0,0,0,0,0,0,http://content9.flixster.com/movie/10/92/03/10920307_det.jpg
3833,The Brain That Wouldn't Die,1962,brain-that-wouldnt-die,4.2,11,4,7,36,0,0,0,0,0,0,0,0,http://content9.flixster.com/movie/10/93/53/10935331_det.jpg
3834,Bronco Billy,1980,bronco_billy,6.5,15,12,3,80,0,0,0,0,0,0,0,0,http://content9.flixster.com/movie/26/32/263203_det.jpg
3835,Crush,2001,,\N,\N,\N,\N,\N,\N,\N,\N,\N,\N,\N,\N,\N,\N
3836,Kelly's Heroes,1970,kellys_heroes,7,14,12,2,85,0,0,0,0,0,0,0,0,http://content9.flixster.com/movie/25/44/254407_det.jpg
3837,Phantasm II,1988,phantasm_2,3.9,14,4,10,28,0,1,0,1,0,0,0,0,http://content6.flixster.com/movie/11/15/27/11152776_det.jpg
3838,Phantasm III: Lord of the Dead,1994,phantasm_iii_lord_of_the_dead,4.5,9,4,5,44,0,0,0,0,0,0,0,0,http://content9.flixster.com/movie/25/74/77/2574775_det.jpg
3839,Phantasm IV: Oblivion,1998,phantasm_iv_oblivion,3.5,7,1,6,14,0,0,0,0,0,0,0,0,http://content8.flixster.com/movie/27/63/276314_det.jpg
3840,Pumpkinhead,1988,pumpkinhead,5.3,16,9,7,56,0,1,0,1,0,2.9,3312,52,http://content9.flixster.com/movie/27/06/270611_det.jpg
3841,Air America,1990,air_america,3.4,14,2,12,14,0,1,0,1,0,2.7,5347,37,http://content9.flixster.com/movie/28/31/283191_det.jpg
3843,Sleepaway Camp,1983,sleepaway_camp,6.2,10,7,3,70,0,0,0,0,0,0,0,0,http://content8.flixster.com/movie/26/86/268626_det.jpg
3844,Steel Magnolias,1989,steel_magnolias,5.8,18,12,6,66,0,1,1,0,100,3.6,26167,88,http://content7.flixster.com/movie/10/93/46/10934665_det.jpg
3845,Et Dieu... cr√©a la femme,1956,1000914-and_god_created_woman,6.2,11,8,3,72,0,1,0,1,0,3,1435,52,http://content6.flixster.com/movie/26/27/262712_det.jpg
3846,Easy Money,1983,1006425-easy_money,5.2,6,2,4,33,0,1,0,1,0,3.1,883,57,http://content9.flixster.com/movie/10/86/90/10869099_det.jpg
3847,Ilsa: She Wolf of the SS,1975,ilsa_she_wolf_of_the_ss,3.9,10,3,7,30,0,1,0,1,0,3,950,49,http://content7.flixster.com/movie/69/92/699201_det.jpg
3848,Silent Fall,1994,silent_fall,4.1,17,4,13,23,3.2,5,0,5,0,3,420,37,http://content6.flixster.com/movie/27/86/278604_det.jpg
3849,The Spiral Staircase,1945,1019625-spiral_staircase,8,13,12,1,92,0,0,0,0,0,0,0,0,http://content9.flixster.com/movie/10/87/39/10873955_det.jpg
3850,What Ever Happened to Aunt Alice?,1969,whatever-happened-to-aunt-alice,0,0,0,0,0,0,0,0,0,0,0,0,0,http://content6.flixster.com/movie/11/13/19/11131956_det.jpg
3851,I'm the One That I Want,2000,im_the_one_that_i_want,6.7,22,13,9,59,0,4,2,2,50,0,0,0,http://content6.flixster.com/movie/10/88/07/10880788_det.jpg
3852,The Tao of Steve,2000,tao_of_steve,6.8,47,37,10,78,7.8,9,9,0,100,3.4,1245,66,http://content6.flixster.com/movie/27/07/270720_det.jpg
3853,The Tic Code,1999,the-tic-code,6.6,28,21,7,75,7.2,11,10,1,90,3.5,135,64,http://content7.flixster.com/movie/10/88/66/10886661_det.jpg
3854,Aim√©e & Jaguar,1999,aimee-and-jaguar,7.2,48,43,5,89,7.1,13,12,1,92,4,1140,84,http://content7.flixster.com/movie/28/68/286805_det.jpg
3855,Une liaison pornographique,1999,affair_of_love,7.4,34,29,5,85,8.6,7,7,0,100,3.7,724,75,http://content8.flixster.com/movie/11/12/64/11126438_det.jpg
3857,Bless the Child,2000,bless_the_child,2.9,97,3,94,3,2.4,28,0,28,0,2.8,4085,45,http://content7.flixster.com/movie/27/47/274709_det.jpg
3858,Cecil B. DeMented,2000,cecil_b_demented,5.6,78,40,38,51,4.4,24,8,16,33,3.4,2682,65,http://content9.flixster.com/movie/10/86/70/10867015_det.jpg
3859,The Eyes of Tammy Faye,2000,eyes_of_tammy_faye,7,34,29,5,85,7.6,6,6,0,100,3.6,398,69,http://content6.flixster.com/movie/26/54/265428_det.jpg
3860,The Opportunists,2000,opportunists,5.7,26,14,12,53,6.9,6,5,1,83,3.1,74,41,http://content9.flixster.com/movie/10/84/04/10840431_det.jpg
3861,The Replacements,2000,replacements,4.9,105,42,63,40,4.5,32,11,21,34,3.1,15029,70,http://content9.flixster.com/movie/55/36/61/5536619_det.jpg
3862,About Adam,2000,about_adam,6,57,39,18,68,6.7,16,13,3,81,3,2040,45,http://content8.flixster.com/movie/10/89/01/10890130_det.jpg
3863,The Cell,2000,cell,5.3,142,65,77,45,4.5,31,13,18,41,2.8,13598,55,http://content6.flixster.com/movie/27/01/270120_det.jpg
3864,Gojira ni-sen mireniamu,1999,cnn-millennium-20002000,0,0,0,0,0,0,0,0,0,0,0,0,0,http://content8.flixster.com/movie/10/90/41/10904122_det.jpg
3865,The Original Kings of Comedy,2000,original_kings_of_comedy,6.9,87,75,12,86,7.1,29,26,3,89,3.7,3266,81,http://content7.flixster.com/movie/11/14/72/11147213_det.jpg
3866,Sunset Blvd.,1950,sunset_boulevard,9.2,52,51,1,98,8.2,7,7,0,100,4.3,12588,95,http://content7.flixster.com/movie/10/88/29/10882989_det.jpg
3867,All the Rage,1999,its_the_rage,4.2,11,3,8,27,0,1,0,1,0,2.9,444,40,http://content7.flixster.com/movie/28/54/285421_det.jpg
3868,The Naked Gun: From the Files of Police Squad!,1988,naked_gun_from_the_files_of_police_squad,7.2,35,31,4,88,0,4,4,0,100,3.2,16516,78,http://content7.flixster.com/movie/10/88/60/10886069_det.jpg
3869,The Naked Gun 2¬Ω: The Smell of Fear,1991,naked_gun_2_12_the_the_smell_of_fear,5.8,34,19,15,55,6.9,7,6,1,85,2.9,10932,66,http://content9.flixster.com/movie/26/63/266323_det.jpg
3870,Our Town,1940,1015737-our_town,7.2,7,6,1,85,0,0,0,0,0,0,0,0,http://content8.flixster.com/movie/30/99/309994_det.jpg
3871,Shane,1953,shane,8.3,28,27,1,96,0,4,3,1,75,3.7,3957,78,http://content6.flixster.com/movie/29/13/291312_det.jpg
3872,"Suddenly, Last Summer",1959,suddenly_last_summer,7.7,6,6,0,100,0,0,0,0,0,0,0,0,http://content6.flixster.com/movie/10/93/54/10935496_det.jpg
3873,Cat Ballou,1965,cat_ballou,7.4,19,19,0,100,0,0,0,0,0,0,0,0,http://content7.flixster.com/movie/28/61/286105_det.jpg
3874,Un divan √† New York,1996,couch_in_new_york,0,3,1,2,33,0,0,0,0,0,0,0,0,http://content7.flixster.com/movie/10/88/49/10884953_det.jpg
3875,The Devil Rides Out,1968,devil_rides_out,7.3,14,13,1,92,0,2,2,0,100,3.7,898,74,http://content7.flixster.com/movie/25/32/253293_det.jpg
3876,Tom and Jerry: The Movie,1992,tom_and_jerry_the_movie,2.8,6,1,5,16,0,0,0,0,0,0,0,0,http://content6.flixster.com/movie/25/23/252328_det.jpg
3877,Supergirl,1984,supergirl,3.3,24,2,22,8,0,4,0,4,0,2.3,7270,28,http://content6.flixster.com/movie/26/29/262904_det.jpg
3878,X: The Unknown,1956,x-the-unknown1956,0,0,0,0,0,0,0,0,0,0,0,0,0,http://content7.flixster.com/movie/10/85/80/10858085_det.jpg
3879,The Art of War,2000,1099604-art_of_war,3.9,80,13,67,16,3.8,25,6,19,24,2.9,3794,45,http://content6.flixster.com/movie/10/94/73/10947324_det.jpg
3880,The Ballad of Ramblin' Jack,2000,ballad_of_ramblin_jack,7.4,18,17,1,94,0,3,3,0,100,3.6,162,48,http://content8.flixster.com/movie/26/39/263998_det.jpg
3881,Bittersweet Motel,2000,bittersweet-motel,0,1,1,0,100,0,1,1,0,100,4.3,140,92,http://content8.flixster.com/movie/10/87/69/10876914_det.jpg
3882,Bring It On,2000,bring_it_on,6,115,73,42,63,5.7,32,19,13,59,3.1,100795,68,http://content7.flixster.com/movie/10/89/97/10899785_det.jpg
3883,Catfish in Black Bean Sauce,1999,catfish_in_black_bean_sauce,5.3,14,6,8,42,0,4,1,3,25,3.5,264,64,http://content8.flixster.com/movie/26/18/261810_det.jpg
3884,Star Trek,2009,star_trek_11,8.1,281,265,16,94,7.8,41,38,3,92,4.1,380680,91,http://content9.flixster.com/movie/10/88/85/10888595_det.jpg
3885,Love & Sex,2000,,\N,\N,\N,\N,\N,\N,\N,\N,\N,\N,\N,\N,\N,\N
3886,Steal This Movie,2000,steal_this_movie,5.5,41,22,19,53,5.1,9,4,5,44,3.6,704,69,http://content7.flixster.com/movie/27/75/277505_det.jpg
3887,Went to Coney Island on a Mission from God... Be Back by Five,1998,went_to_coney_island_on_a_mission_from_god_be_back_by_five,5.4,7,3,4,42,0,1,0,1,0,0,0,0,http://content7.flixster.com/movie/10/83/93/10839329_det.jpg
3888,Skipped Parts,2000,skipped_parts,0,4,1,3,25,0,0,0,0,0,0,0,0,http://content8.flixster.com/movie/28/06/280614_det.jpg
3889,Highlander: Endgame,2000,highlander_endgame,3.3,53,6,47,11,3.6,13,2,11,15,2.8,5402,49,http://content9.flixster.com/movie/10/94/47/10944767_det.jpg
3891,Center Stage: Turn It Up,2008,1204891-center_stage_turn_it_up,0,4,2,2,50,0,0,0,0,0,0,0,0,http://content7.flixster.com/movie/10/90/33/10903349_det.jpg
3892,Grey's Anatomy,2005,,\N,\N,\N,\N,\N,\N,\N,\N,\N,\N,\N,\N,\N,\N
3893,Nurse Betty,2000,nurse_betty,7.2,129,108,21,83,6.6,33,24,9,72,2.6,4271,37,http://content6.flixster.com/movie/28/37/283792_det.jpg
3894,Solas,1999,solas,7.3,19,17,2,89,7.3,5,4,1,80,4,317,87,http://content7.flixster.com/movie/10/89/28/10892865_det.jpg
3895,The Watcher,2000,watcher,3.4,87,9,78,10,3.3,25,2,23,8,2.7,3820,36,http://content7.flixster.com/movie/27/40/274005_det.jpg
3896,The Way of the Gun,2000,way_of_the_gun,5.4,102,48,54,47,4.9,24,10,14,41,3.3,5742,68,http://content7.flixster.com/movie/28/09/280993_det.jpg
3897,Almost Famous,2000,almost_famous,7.8,159,139,20,87,7.1,33,26,7,78,3.7,57797,89,http://content6.flixster.com/movie/55/05/22/5505220_det.jpg
3898,Bait,2000,1100039-bait,4.2,81,21,60,25,3.4,22,4,18,18,2.9,2354,44,http://content9.flixster.com/movie/27/57/275707_det.jpg
3899,The Circus,1928,1052608-circus,8.4,15,15,0,100,0,2,2,0,100,4.1,1756,92,http://content8.flixster.com/movie/31/12/311202_det.jpg
3900,Crime and Punishment in Suburbia,2000,crime_and_punishment_in_suburbia,3.6,29,6,23,20,3,12,2,10,16,3.3,634,61,http://content9.flixster.com/movie/10/87/78/10877807_det.jpg
3901,Duets,2000,1100086-duets,3.9,88,18,70,20,3.9,25,5,20,20,2.9,2253,44,http://content7.flixster.com/movie/26/98/269817_det.jpg
3902,Goya en Burdeos,1999,goya_in_bordeaux,6,26,14,12,53,6.2,6,2,4,33,3.5,289,65,http://content8.flixster.com/movie/28/03/280302_det.jpg
3903,Urbania,2000,urbania,6.8,27,19,8,70,7.2,6,4,2,66,3.6,469,73,http://content7.flixster.com/movie/27/56/275605_det.jpg
3905,The Specials,2000,specials,5.1,15,7,8,46,0,1,0,1,0,3.3,699,59,http://content9.flixster.com/movie/28/20/282091_det.jpg
3906,Under Suspicion,2000,1100197-under_suspicion,5.3,44,22,22,50,5.2,12,6,6,50,3.2,1858,49,http://content9.flixster.com/movie/27/62/276215_det.jpg
3907,Prince of Central Park,2000,1099709-prince_of_central_park,4.4,5,1,4,20,0,1,0,1,0,3,480,40,http://content8.flixster.com/movie/10/87/55/10875574_det.jpg
3908,Urban Legends: Final Cut,2000,urban_legends_final_cut,3,78,7,71,8,2.6,20,1,19,5,2.5,5717,35,http://content7.flixster.com/movie/10/94/63/10946361_det.jpg
3909,Woman on Top,2000,woman_on_top,4.8,95,33,62,34,4.7,28,9,19,32,3,2022,44,http://content7.flixster.com/movie/28/55/285509_det.jpg
3910,Dancer in the Dark,2000,dancer_in_the_dark,6.7,113,76,37,67,6.2,26,17,9,65,4.1,17700,90,http://content6.flixster.com/movie/26/89/268916_det.jpg
3911,Best in Show,2000,best_in_show,7.5,107,101,6,94,7.6,29,28,1,96,3.7,12719,87,http://content7.flixster.com/movie/10/87/12/10871241_det.jpg
3912,A Beautiful Mind,2001,beautiful_mind,7.1,180,140,40,77,7.2,37,30,7,81,3.9,103150,91,http://content9.flixster.com/movie/10/93/45/10934587_det.jpg
3913,Barenaked in America,1999,barenaked_in_america,6.4,18,14,4,77,6.9,5,4,1,80,0,0,0,http://images.rottentomatoescdn.com/images/defaults/poster_default.gif
3914,The Broken Hearts Club: A Romantic Comedy,2000,broken_hearts_club,6,27,17,10,62,0,4,3,1,75,3.6,2111,70,http://content9.flixster.com/movie/10/95/55/10955507_det.jpg
3915,Girlfight,2001,,\N,\N,\N,\N,\N,\N,\N,\N,\N,\N,\N,\N,\N,\N
3916,Remember the Titans,2000,remember_the_titans,6.3,130,94,36,72,5.8,32,20,12,62,3.9,91483,91,http://content6.flixster.com/movie/25/47/254720_det.jpg
3917,Hellraiser,1987,hellraiser,5.9,30,19,11,63,0,3,0,3,0,3.4,13712,77,http://content6.flixster.com/movie/28/39/283900_det.jpg
3918,Hellbound: Hellraiser II,1988,hellbound_hellraiser_2,5.1,18,8,10,44,0,3,1,2,33,3.2,6950,68,http://content8.flixster.com/movie/28/97/289722_det.jpg
3919,Hellraiser III: Hell on Earth,1992,hellraiser_iii_hell_on_earth,3.8,9,2,7,22,0,1,0,1,0,2.9,5917,52,http://content7.flixster.com/movie/10/03/36/10033649_det.jpg
3920,"In weiter Ferne, so nah!",1993,myopic-visions,0,0,0,0,0,0,0,0,0,0,0,0,0,http://content8.flixster.com/movie/10/84/17/10841786_det.jpg
3921,Psycho Beach Party,2000,psycho_beach_party,5.5,31,17,14,54,4.4,7,2,5,28,3.3,1978,62,http://content7.flixster.com/movie/10/93/52/10935297_det.jpg
3922,Bikini Beach,1964,bikini_beach,0,0,0,0,0,0,0,0,0,0,0,0,0,http://content9.flixster.com/movie/10/82/75/10827579_det.jpg
3923,Return of the Fly,1959,return_of_the_fly,4.8,12,5,7,41,0,0,0,0,0,0,0,0,http://content8.flixster.com/movie/11/15/26/11152646_det.jpg
3924,Pajama Party,1964,pajama_party,4.5,7,3,4,42,0,0,0,0,0,0,0,0,http://content8.flixster.com/movie/29/90/299022_det.jpg
3925,Stranger Than Paradise,1984,stranger_than_paradise,7.6,19,18,1,94,0,1,1,0,100,4,4419,88,http://content6.flixster.com/movie/10/91/84/10918452_det.jpg
3926,Voyage to the Bottom of the Sea,1961,voyage_to_the_bottom_of_the_sea,6.2,11,9,2,81,0,0,0,0,0,0,0,0,http://content8.flixster.com/movie/92/70/47/9270470_det.jpg
3927,Fantastic Voyage,1966,fantastic_voyage,7,25,23,2,92,0,3,3,0,100,3.3,1258,66,http://content8.flixster.com/movie/10/90/66/10906686_det.jpg
3928,Bud Abbott Lou Costello Meet Frankenstein,1948,abbott_and_costello,7.1,22,20,2,90,0,2,0,2,0,3.8,2347,81,http://content8.flixster.com/movie/10/22/00/10220010_det.jpg
3929,The Bank Dick,1940,bank_dick,8.6,21,21,0,100,0,3,3,0,100,0,0,0,http://content9.flixster.com/movie/10/88/80/10888087_det.jpg
3930,Creature from the Black Lagoon,1954,1004906-creature_from_the_black_lagoon,7,26,22,4,84,0,2,1,1,50,3.3,4189,63,http://content9.flixster.com/movie/11/14/44/11144431_det.jpg
3931,The Giant Gila Monster,1959,giant_gila_monster,2.9,8,1,7,12,0,0,0,0,0,0,0,0,http://content6.flixster.com/movie/31/02/310216_det.jpg
3932,The Invisible Man,1933,1010695-invisible_man,8.4,29,29,0,100,0,4,4,0,100,3.7,2484,78,http://content7.flixster.com/movie/28/79/287917_det.jpg
3933,The Killer Shrews,1959,killer_shrews,4.7,9,5,4,55,0,0,0,0,0,0,0,0,http://content8.flixster.com/movie/30/60/306098_det.jpg
3934,Kronos,1957,kronos,5,6,4,2,66,0,0,0,0,0,0,0,0,http://content6.flixster.com/movie/28/77/287704_det.jpg
3936,The Phantom of the Opera,2004,phantom_of_the_opera,5,165,54,111,32,4.6,37,10,27,27,3.7,70849,86,http://content9.flixster.com/movie/35/84/18/3584187_det.jpg
3937,Runaway Jury,2003,runaway_jury,6.6,152,111,41,73,6.6,38,28,10,73,3.4,11578,73,http://content7.flixster.com/movie/25/81/258113_det.jpg
3938,The Slumber Party Massacre,1982,slumber_party_massacre,4,10,3,7,30,0,0,0,0,0,0,0,0,http://content8.flixster.com/movie/28/14/281498_det.jpg
3939,Slumber Party Massacre II,1987,slumber_party_massacre_2,0,3,0,3,0,0,0,0,0,0,0,0,0,http://content9.flixster.com/movie/28/44/284403_det.jpg
3940,Slumber Party Massacre III,1990,slumber_party_massacre_3,0,2,0,2,0,0,0,0,0,0,0,0,0,http://content9.flixster.com/movie/28/96/84/2896843_det.jpg
3941,Sorority House Massacre,1986,sorority_house_massacre,0,4,0,4,0,0,0,0,0,0,0,0,0,http://content6.flixster.com/movie/10/88/60/10886084_det.jpg
3942,Sorority House Massacre II,1990,sorority-house-massacre-ii-night-frenzy-nighty-nightmare,0,2,1,1,50,0,0,0,0,0,0,0,0,http://content8.flixster.com/movie/11/12/44/11124498_det.jpg
3943,Bamboozled,2000,bamboozled,5.4,96,46,50,47,5.5,32,16,16,50,3.6,2334,74,http://content8.flixster.com/movie/10/94/78/10947830_det.jpg
3944,Bootmen,2000,bootmen,4.9,17,6,11,35,4.4,5,1,4,20,3.4,1576,65,http://content9.flixster.com/movie/27/56/275699_det.jpg
3945,Digimon: Digital Monsters,1999,digimon_digital_monsters,0,3,0,3,0,0,0,0,0,0,0,0,0,http://content8.flixster.com/movie/10/99/03/10990386_det.jpg
3946,Get Carter,2000,1100569-get_carter,3.6,60,7,53,11,2.9,19,1,18,5,2.5,4003,31,http://content7.flixster.com/movie/27/85/278597_det.jpg
3947,Get Carter,2000,1100569-get_carter,3.6,60,7,53,11,2.9,19,1,18,5,2.5,4003,31,http://content7.flixster.com/movie/27/85/278597_det.jpg
3948,Meet the Parents,2000,meet_the_parents,6.9,140,118,22,84,7.1,35,29,6,82,3.6,119331,79,http://content9.flixster.com/movie/10/80/18/10801895_det.jpg
3949,Requiem for a Dream,2000,requiem_for_a_dream,7.4,127,99,28,77,6.6,32,21,11,65,4.1,103666,93,http://content9.flixster.com/movie/29/00/290095_det.jpg
3950,Tigerland,2000,tigerland,7,42,32,10,76,7.5,10,9,1,90,3.4,8243,68,http://content6.flixster.com/movie/27/38/273896_det.jpg
3951,Two Family House,2000,two_family_house,7.6,33,29,4,87,8.2,10,10,0,100,3.6,294,79,http://content6.flixster.com/movie/10/92/85/10928504_det.jpg
3952,The Contender,2000,1100998-contender,6.7,128,97,31,75,6.2,34,25,9,73,3.5,2093,72,http://content7.flixster.com/movie/28/54/285405_det.jpg
3953,Dr T and the Women,2000,dr_t_and_the_women,5.7,106,60,46,56,5.9,33,21,12,63,2.3,2922,20,http://content9.flixster.com/movie/10/88/12/10881219_det.jpg
3954,Just Looking,1999,just_looking,5.3,21,9,12,42,4.7,5,1,4,20,3.1,291,54,http://content8.flixster.com/movie/28/51/285106_det.jpg
3955,The Ladies Man,2000,1101029-ladies_man,3.2,71,8,63,11,3.3,18,3,15,16,2.6,2790,43,http://content9.flixster.com/movie/27/08/270807_det.jpg
3956,Lost Souls,2000,1101034-lost_souls,3,89,6,83,6,2.6,26,0,26,0,2.6,2140,26,http://content7.flixster.com/movie/27/93/279313_det.jpg
3957,Billy Jack,1971,billy_jack,5.4,13,8,5,61,0,1,0,1,0,3.4,2007,63,http://content9.flixster.com/movie/26/46/264695_det.jpg
3958,Billy Jack Goes to Washington,1977,billy_jack_goes_to_washington,2.7,7,0,7,0,0,0,0,0,0,0,0,0,http://content6.flixster.com/movie/10/89/74/10897408_det.jpg
3959,The Time Machine,2002,1112951-time_machine,4.8,146,41,105,28,5,32,6,26,18,2.7,10389,45,http://content6.flixster.com/movie/10/91/76/10917636_det.jpg
3960,Thir13en Ghosts,2001,thirteen_ghosts,3.4,89,11,78,12,3.4,22,3,19,13,3,20700,60,http://content8.flixster.com/movie/26/88/268814_det.jpg
3961,Ghoulies,1985,ghoulies,3,8,0,8,0,0,0,0,0,0,0,0,0,http://content8.flixster.com/movie/20/86/09/2086090_det.jpg
3962,Ghoulies II,1988,ghoulies_2,1.8,5,0,5,0,0,0,0,0,0,0,0,0,http://content7.flixster.com/movie/10/85/88/10858853_det.jpg
3963,The Unsinkable Molly Brown,1964,unsinkable_molly_brown,5.1,7,5,2,71,0,0,0,0,0,0,0,0,http://content9.flixster.com/movie/29/18/291831_det.jpg
3964,The Adventures of Ichabod and Mr. Toad,1949,adventures_of_ichabod_and_mr_toad,7,10,9,1,90,0,3,2,1,66,3.4,2101,65,http://content7.flixster.com/movie/25/06/250693_det.jpg
3965,The Strange Love of Martha Ivers,1946,strange_love_of_martha_ivers,7.4,8,8,0,100,0,1,1,0,100,3.5,463,69,http://content9.flixster.com/movie/29/02/290227_det.jpg
3966,Detour,1945,1005744-detour,8.2,17,17,0,100,0,3,3,0,100,3.7,1411,75,http://content9.flixster.com/movie/30/37/303715_det.jpg
3967,Billy Elliot,2000,billy_elliot,7.2,114,97,17,85,7.3,33,29,4,87,3.4,21103,82,http://content9.flixster.com/movie/10/85/06/10850699_det.jpg
3968,Bedazzled,2000,1101051-bedazzled,5.4,109,53,56,48,5.2,32,14,18,43,2.7,15017,45,http://content6.flixster.com/movie/10/92/66/10926648_det.jpg
3969,Pay It Forward,2000,pay_it_forward,5,125,49,76,39,4.5,35,13,22,37,3.5,22458,82,http://content6.flixster.com/movie/10/88/49/10884904_det.jpg
3970,E tu vivrai nel terrore - L'aldil√†,1981,beyond,6.2,16,10,6,62,0,1,0,1,0,3.9,2574,80,http://content7.flixster.com/movie/28/79/287997_det.jpg
3971,The Private Eyes,1980,private_eyes,0,3,1,2,33,0,0,0,0,0,0,0,0,http://content6.flixster.com/movie/25/55/255512_det.jpg
3972,Jui kuen II,1994,legend_of_drunken_master,7,74,61,13,82,7.1,24,20,4,83,3.6,7905,83,http://content7.flixster.com/movie/10/93/12/10931221_det.jpg
3973,Book of Shadows: Blair Witch 2,2000,book_of_shadows_blair_witch_2,3.4,103,13,90,12,3,29,2,27,6,2.1,7040,24,http://content6.flixster.com/movie/10/89/11/10891180_det.jpg
3974,The Little Vampire,2000,little_vampire,5.5,65,35,30,53,5,20,9,11,45,2.7,4743,54,http://content8.flixster.com/movie/10/88/47/10884726_det.jpg
3975,Lucky Number Slevin,2006,the-bruce-movie,0,0,0,0,0,0,0,0,0,0,0,0,0,http://content6.flixster.com/movie/10/84/20/10842040_det.jpg
3976,Stardom,2000,stardom,4.9,21,8,13,38,5.3,5,2,3,40,2.8,424,34,http://content9.flixster.com/movie/28/22/282223_det.jpg
3977,Charlie's Angels: Full Throttle,2003,charlies_angels_full_throttle,5,171,74,97,43,5,37,15,22,40,3,33126,54,http://content8.flixster.com/movie/11/13/33/11133370_det.jpg
3978,The Legend of Bagger Vance,2000,legend_of_bagger_vance,5.2,128,54,74,42,4.7,32,12,20,37,3.2,9150,64,http://content6.flixster.com/movie/26/64/266492_det.jpg
3979,Little Nicky,2000,little_nicky,3.9,113,24,89,21,3.9,31,6,25,19,3.1,32660,64,http://content6.flixster.com/movie/25/96/259608_det.jpg
3980,Men of Honor,2000,men_of_honor,5.3,102,42,60,41,5.7,31,17,14,54,3.6,13217,83,http://content6.flixster.com/movie/10/92/08/10920896_det.jpg
3981,Red Planet,2000,red_planet,3.7,98,12,86,12,3.4,28,3,25,10,2.6,5320,32,http://content8.flixster.com/movie/25/89/258914_det.jpg
3982,What's Cooking?,2000,whats_cooking,5.5,65,34,31,52,5.2,21,10,11,47,3.4,440,64,http://content7.flixster.com/movie/11/13/20/11132065_det.jpg
3983,You Can Count on Me,2000,you_can_count_on_me,8,96,91,5,94,7.7,29,27,2,93,4,2952,87,http://content7.flixster.com/movie/27/13/271397_det.jpg
3984,Diamonds Are Forever,1971,diamonds_are_forever,6.4,36,24,12,66,5.7,6,3,3,50,3.4,12688,64,http://content7.flixster.com/movie/25/63/256325_det.jpg
3985,The Eagle Has Landed,1976,1006392-eagle_has_landed,6.5,5,4,1,80,0,0,0,0,0,0,0,0,http://content9.flixster.com/movie/25/80/258095_det.jpg
3986,The 6th Day,2000,sixth_day,5.2,112,45,67,40,5.1,31,13,18,41,2.7,12583,38,http://content9.flixster.com/movie/10/86/38/10863875_det.jpg
3987,Bounce,2000,bounce,5.5,105,54,51,51,5.1,32,14,18,43,2.7,3696,34,http://content9.flixster.com/movie/10/84/58/10845867_det.jpg
3988,How the Grinch Stole Christmas,2000,how_the_grinch_stole_christmas,5.6,127,67,60,52,5.2,31,16,15,51,3.1,34926,57,http://content9.flixster.com/movie/25/55/255591_det.jpg
3989,One Day in September,1999,one_day_in_september,8,28,27,1,96,0,3,3,0,100,4,829,88,http://content7.flixster.com/movie/10/88/53/10885373_det.jpg
3990,Rugrats in Paris: The Movie - Rugrats II,2000,rugrats_in_paris,6.3,72,54,18,75,5.8,22,13,9,59,2.8,5095,48,http://content9.flixster.com/movie/11/13/75/11137543_det.jpg
3991,102 Dalmatians,2000,102_dalmatians,4.4,89,27,62,30,4.2,27,8,19,29,2.9,17460,44,http://content8.flixster.com/movie/10/86/73/10867358_det.jpg
3992,Mal√®na,2000,1101561-1101561-malena,5.6,76,42,34,55,5,30,14,16,46,3.9,7433,85,http://content7.flixster.com/movie/27/07/270709_det.jpg
3993,Quills,2000,quills,6.6,118,88,30,74,6.2,35,25,10,71,3.6,9122,81,http://content7.flixster.com/movie/27/08/270809_det.jpg
3994,Unbreakable,2000,unbreakable,6.2,156,106,50,67,5.6,33,19,14,57,3.3,35079,73,http://content7.flixster.com/movie/10/89/48/10894809_det.jpg
3995,Boys Life 3,2000,boys_life_3,5.4,7,4,3,57,0,2,0,2,0,3.2,77,43,http://content8.flixster.com/movie/10/88/59/10885982_det.jpg
3996,Wo hu cang long,2000,crouching_tiger_hidden_dragon,8.6,143,139,4,97,8.4,34,33,1,97,3.5,47802,81,http://content8.flixster.com/movie/25/49/254902_det.jpg
3997,Dungeons & Dragons,2000,dungeons_and_dragons,3.1,87,9,78,10,3.1,26,2,24,7,2.2,6148,30,http://content8.flixster.com/movie/26/65/266510_det.jpg
3998,Proof of Life,2000,proof_of_life,5.3,113,44,69,38,4.9,32,10,22,31,2.9,6955,44,http://content7.flixster.com/movie/10/87/12/10871261_det.jpg
3999,Vertical Limit,2000,vertical_limit,5.2,107,50,57,46,5.4,32,17,15,53,2.8,6863,44,http://content8.flixster.com/movie/10/88/37/10883746_det.jpg
4000,The Bounty,1984,1002947-bounty,6.2,16,13,3,81,0,3,2,1,66,3.4,2904,64,http://content6.flixster.com/movie/10/88/45/10884508_det.jpg
4001,Code of Silence,1985,code_of_silence,5.4,10,4,6,40,0,1,1,0,100,3,1217,50,http://content9.flixster.com/movie/10/90/23/10902395_det.jpg
4002,"Planes, Trains & Automobiles",1987,planes_trains_and_automobiles,7.8,41,39,2,95,7.1,7,6,1,85,3.4,13720,81,http://content8.flixster.com/movie/49/20/99/4920994_det.jpg
4003,She's Having a Baby,1988,shes_having_a_baby,5.4,20,10,10,50,0,1,0,1,0,3.1,2609,48,http://content7.flixster.com/movie/25/90/259009_det.jpg
4005,The Living Daylights,1987,living_daylights,6.1,33,24,9,72,6.1,8,5,3,62,3.1,9634,61,http://content9.flixster.com/movie/25/93/259311_det.jpg
4006,Transformers,2007,real-the-movie2005,0,0,0,0,0,0,0,0,0,0,0,0,0,http://content8.flixster.com/movie/10/91/83/10918394_det.jpg
4007,Wall Street,1987,wall_street,6.8,48,37,11,77,4.5,7,2,5,28,3.5,10858,79,http://content7.flixster.com/movie/11/15/30/11153029_det.jpg
4008,Born on the Fourth of July,1989,born_on_the_fourth_of_july,7.3,36,32,4,88,6.6,7,5,2,71,3.3,11412,69,http://content7.flixster.com/movie/10/88/87/10888705_det.jpg
4009,Talk Radio,1988,talk_radio,6.7,25,20,5,80,0,4,2,2,50,3.6,1535,77,http://content7.flixster.com/movie/27/94/279497_det.jpg
4010,Brewster's Millions,1985,1003075-brewsters_millions,4.7,20,8,12,40,0,0,0,0,0,0,0,0,http://content7.flixster.com/movie/10/88/50/10885073_det.jpg
4011,Snatch.,2000,snatch,6.4,136,98,38,72,5.9,34,22,12,64,4,125460,92,http://content7.flixster.com/movie/10/93/72/10937277_det.jpg
4012,Punchline,1988,punchline,5.4,16,8,8,50,0,1,0,1,0,2.8,1447,35,http://content9.flixster.com/movie/28/00/280007_det.jpg
4013,Mr. Accident,2000,mr_accident,3,6,1,5,16,0,0,0,0,0,0,0,0,http://content7.flixster.com/movie/10/91/91/10919173_det.jpg
4014,Chocolat,2000,1103080-chocolat,6,114,71,43,62,6.1,32,20,12,62,3.6,62492,82,http://content6.flixster.com/movie/10/24/34/10243432_det.jpg
4015,"Dude, Where's My Car?",2000,dude_wheres_my_car,3.6,54,10,44,18,4.2,14,4,10,28,2.8,34490,52,http://content6.flixster.com/movie/60/97/609760_det.jpg
4016,The Emperor's New Groove,2000,emperors_new_groove,7,126,107,19,84,6.6,32,24,8,75,3.4,35081,75,http://content9.flixster.com/movie/25/10/251095_det.jpg
4017,Who the #$&% Is Jackson Pollock?,2006,who_the_and_is_jackson_pollock,7.4,15,15,0,100,7.8,7,7,0,100,3.5,1003,71,http://content6.flixster.com/movie/34/45/95/3445952_det.jpg
4018,What Women Want,2000,what_women_want,5.6,118,62,56,52,5.8,32,20,12,62,3.1,33431,60,http://content6.flixster.com/movie/62/99/74/6299748_det.jpg
4019,Finding Forrester,2000,finding_forrester,6.5,122,90,32,73,6.3,30,21,9,70,3.4,15572,76,http://content7.flixster.com/movie/25/61/256105_det.jpg
4020,The Gift,2000,1103231-gift,5.9,116,65,51,56,6.1,29,18,11,62,3.1,8477,56,http://content9.flixster.com/movie/27/01/270195_det.jpg
4021,Before Night Falls,2000,before_night_falls,6.9,95,71,24,74,7.6,28,26,2,92,3.8,7012,79,http://content8.flixster.com/movie/27/16/271614_det.jpg
4022,Cast Away,2000,cast_away,7.4,152,136,16,89,7.2,34,30,4,88,3.5,60473,80,http://content9.flixster.com/movie/10/93/45/10934595_det.jpg
4023,The Family Man,2000,family_man,5.4,125,65,60,52,4.7,31,11,20,35,3.1,19358,66,http://content7.flixster.com/movie/10/84/98/10849849_det.jpg
4024,The House of Mirth,2000,house_of_mirth,6.9,93,75,18,80,6.9,31,25,6,80,3.5,1118,69,http://content7.flixster.com/movie/10/89/71/10897185_det.jpg
4025,Miss Congeniality,2000,miss_congeniality,5.1,113,46,67,40,4.3,27,8,19,29,3.2,63572,71,http://content8.flixster.com/movie/55/05/33/5505338_det.jpg
4026,Injeong sajeong bol geot eobtda,1999,,\N,\N,\N,\N,\N,\N,\N,\N,\N,\N,\N,\N,\N,\N
4027,"O Brother, Where Art Thou?",2000,o_brother_where_art_thou,7.1,143,109,34,76,6.6,35,24,11,68,3.7,35122,87,http://content7.flixster.com/movie/97/83/14/9783145_det.jpg
4028,Songcatcher,2000,songcatcher,6.3,80,57,23,71,6.3,26,19,7,73,3.7,521,77,http://content6.flixster.com/movie/25/52/255224_det.jpg
4029,State and Main,2000,state_and_main,7.3,113,97,16,85,6.8,29,24,5,82,3.3,2255,64,http://content8.flixster.com/movie/27/27/272726_det.jpg
4030,Dracula 2000,2000,immortality2000,0,0,0,0,0,0,0,0,0,0,0,0,0,http://content6.flixster.com/movie/10/85/16/10851624_det.jpg
4031,All the Pretty Horses,2000,all_the_pretty_horses,4.9,99,32,67,32,4.6,33,8,25,24,3,2957,43,http://content9.flixster.com/movie/25/94/259407_det.jpg
4032,An Everlasting Piece,2000,everlasting_piece,5.2,45,22,23,48,6.2,18,14,4,77,3.6,540,73,http://content9.flixster.com/movie/27/90/279095_det.jpg
4033,Thirteen Days,2000,thirteen_days,7.1,114,94,20,82,7.1,28,24,4,85,3.4,4777,76,http://content9.flixster.com/movie/10/89/34/10893483_det.jpg
4034,Traffic,2000,1103281-traffic,8,149,136,13,91,7.8,39,36,3,92,3.5,26217,81,http://content9.flixster.com/movie/27/66/276615_det.jpg
4035,The Claim,2000,claim,5.8,83,52,31,62,6.2,28,18,10,64,3.1,892,46,http://content7.flixster.com/movie/28/22/282225_det.jpg
4036,Shadow of the Vampire,2000,shadow_of_the_vampire,7,133,108,25,81,6.9,32,27,5,84,3.4,5965,69,http://content8.flixster.com/movie/28/54/285410_det.jpg
4037,House of Games,1987,house_of_games,8.2,24,23,1,95,0,1,1,0,100,3.8,1676,80,http://content8.flixster.com/movie/10/91/35/10913522_det.jpg
4038,Kill Me Again,1989,kill_me_again,0,4,4,0,100,0,0,0,0,0,0,0,0,http://content8.flixster.com/movie/11/14/85/11148506_det.jpg
4039,Annie,1982,annie_1981,4.9,23,12,11,52,0,4,2,2,50,3.1,20236,64,http://content8.flixster.com/movie/26/47/264726_det.jpg
4040,Don't Tell Mom the Babysitter's Dead,1991,mother-mom-never-dies,0,0,0,0,0,0,0,0,0,0,0,0,0,http://content8.flixster.com/movie/10/88/52/10885290_det.jpg
4041,An Officer and a Gentleman,1982,officer_and_a_gentleman,7.4,16,15,1,93,0,1,1,0,100,3.5,8345,79,http://content6.flixster.com/movie/10/88/91/10889116_det.jpg
4042,The Alamo,2004,general-santa-ana,0,0,0,0,0,0,0,0,0,0,0,0,0,http://content7.flixster.com/movie/10/84/54/10845441_det.jpg
4043,At Close Range,1986,at_close_range,7.1,14,13,1,92,0,1,1,0,100,3.5,2435,71,http://content6.flixster.com/movie/11/15/08/11150824_det.jpg
4044,Breaker! Breaker!,1977,breaker_breaker,0,1,0,1,0,0,0,0,0,0,0,0,0,http://content7.flixster.com/movie/10/89/13/10891301_det.jpg
4045,Breakheart Pass,1975,breakheart_pass,6.3,7,5,2,71,0,0,0,0,0,0,0,0,http://content6.flixster.com/movie/10/88/68/10886868_det.jpg
4046,Friendly Persuasion,1956,friendly_persuasion,7.7,6,6,0,100,0,0,0,0,0,0,0,0,http://content7.flixster.com/movie/71/18/55/7118553_det.jpg
4047,Gettysburg,1993,1046038-gettysburg,7.1,15,13,2,86,0,3,3,0,100,3.7,4656,86,http://content8.flixster.com/movie/25/39/253922_det.jpg
4048,Imaginary Crimes,1994,imaginary_crimes,6.5,7,5,2,71,0,3,2,1,66,3.2,276,55,http://content7.flixster.com/movie/10/90/37/10903753_det.jpg
4049,Rancho Deluxe,1975,rancho_deluxe,6,12,8,4,66,0,4,1,3,25,3,463,42,http://content6.flixster.com/movie/10/93/16/10931684_det.jpg
4050,The St. Francisville Experiment,2000,the-st-francisville-experiment,0,3,0,3,0,0,0,0,0,0,0,0,0,http://content7.flixster.com/movie/10/93/08/10930861_det.jpg
4051,Ein Toter hing im Netz,1960,ein-toter-hing-im-netz-horrors-of-spider-island,0,0,0,0,0,0,0,0,0,0,0,0,0,http://content8.flixster.com/movie/10/87/23/10872302_det.jpg
4052,Antitrust,2001,antitrust,4.1,102,25,77,24,4,31,9,22,29,2.8,5738,48,http://content6.flixster.com/movie/11/12/75/11127532_det.jpg
4053,Double Take,2001,1104038-double_take,3.4,75,9,66,12,3.5,22,4,18,18,2.8,2242,47,http://content8.flixster.com/movie/26/35/263518_det.jpg
4054,Save the Last Dance,2001,save_the_last_dance_for_me,0,0,0,0,0,0,0,0,0,0,0,0,0,http://content7.flixster.com/movie/10/87/40/10874033_det.jpg
4055,Panic Room,2002,panic_room,6.9,178,136,42,76,6.6,34,24,10,70,3,19615,61,http://content9.flixster.com/movie/10/91/39/10913971_det.jpg
4056,The Pledge,2001,1104203-pledge,6.8,119,92,27,77,7.1,36,31,5,86,3.2,4315,55,http://content9.flixster.com/movie/10/89/47/10894799_det.jpg
4057,Kids World,2001,kids_world,0,2,0,2,0,0,1,0,1,0,3.2,289,47,http://content8.flixster.com/movie/48/66/41/4866418_det.jpg
4059,The Amati Girls,2000,amati_girls,4.2,12,5,7,41,3.3,5,1,4,20,3.4,179,65,http://content7.flixster.com/movie/31/03/53/3103537_det.jpg
4060,Love Field,1992,love_field,5.7,10,5,5,50,0,3,0,3,0,3.2,596,48,http://content9.flixster.com/movie/26/32/263291_det.jpg
4061,Man on the Moon,1999,1093579-man_on_the_moon,6.2,117,73,44,62,5.3,31,16,15,51,3.3,15027,74,http://content8.flixster.com/movie/10/87/18/10871826_det.jpg
4062,Mystic Pizza,1988,1165378-romantic_movie_favorites,0,0,0,0,0,0,0,0,0,0,0,0,0,http://content7.flixster.com/movie/10/84/73/10847333_det.jpg
4063,Prelude to a Kiss,1992,prelude_to_a_kiss,5.8,21,13,8,61,0,4,2,2,50,2.8,2250,37,http://content8.flixster.com/movie/10/88/59/10885926_det.jpg
4064,Coffy,1973,coffy,6.7,19,15,4,78,0,4,2,2,50,3.7,2668,73,http://content7.flixster.com/movie/27/18/271809_det.jpg
4065,Foxy Brown,1974,foxy_brown,5.5,18,10,8,55,0,2,1,1,50,3.4,1680,67,http://content8.flixster.com/movie/27/18/271810_det.jpg
4066,I'm Gonna Git You Sucka,1988,im_gonna_git_you_sucka,5.7,26,16,10,61,4.2,5,2,3,40,3.4,2387,69,http://content8.flixster.com/movie/27/21/272122_det.jpg
4067,Untamed Heart,1993,untamed_heart,5.6,25,13,12,52,0,3,2,1,66,3.4,3409,76,http://content7.flixster.com/movie/10/84/98/10849889_det.jpg
4068,Sugar & spice: F√ªmi zekka,2006,,\N,\N,\N,\N,\N,\N,\N,\N,\N,\N,\N,\N,\N,\N
4069,The Wedding Planner,2001,wedding_video,0,2,2,0,100,0,0,0,0,0,0,0,0,http://content6.flixster.com/movie/10/89/24/10892424_det.jpg
4070,Amy,1997,1104229-amy,5,14,6,8,42,6.1,6,4,2,66,3.7,361,76,http://content9.flixster.com/movie/26/68/266815_det.jpg
4072,Trol√∂sa,2000,,\N,\N,\N,\N,\N,\N,\N,\N,\N,\N,\N,\N,\N,\N
4073,The Invisible Circus,1999,invisible_circus,4.1,60,13,47,21,3.8,19,3,16,15,3,935,44,http://content9.flixster.com/movie/10/87/08/10870815_det.jpg
4074,Die Stille nach dem Schu√ü,2000,legend_of_rita,7.4,14,12,2,85,0,4,4,0,100,3.5,304,66,http://content8.flixster.com/movie/10/92/33/10923310_det.jpg
4076,Two Ninas,1999,two-ninas,5.9,9,6,3,66,0,4,3,1,75,3,339,40,http://content9.flixster.com/movie/28/17/281799_det.jpg
4077,Harry un ami qui vous veut du bien,2000,with_a_friend_like_harry,7.5,88,84,4,95,7.9,26,26,0,100,3.6,960,74,http://content6.flixster.com/movie/10/91/88/10918860_det.jpg
4078,Amazing Grace and Chuck,1987,amazing_grace_and_chuck,4.4,7,2,5,28,0,2,0,2,0,0,0,0,http://content6.flixster.com/movie/34/10/42/3410420_det.jpg
4079,Amazon Women on the Moon,1987,amazon_women_on_the_moon,5.5,11,7,4,63,0,1,0,1,0,3.2,2625,53,http://content6.flixster.com/movie/10/91/50/10915000_det.jpg
4080,Baby Boom,1987,baby_boom,6.4,16,13,3,81,0,1,1,0,100,2.9,3027,56,http://content9.flixster.com/movie/10/92/69/10926931_det.jpg
4081,Back to the Beach,1987,back_to_the_beach,5.8,14,10,4,71,0,1,1,0,100,2.9,1446,49,http://content8.flixster.com/movie/10/88/39/10883942_det.jpg
4082,Barfly,1987,barfly,6.6,17,13,4,76,0,2,1,1,50,3.8,2187,82,http://content7.flixster.com/movie/28/21/282193_det.jpg
4083,Best Seller,1987,best_seller,5.9,10,6,4,60,0,1,0,1,0,3.1,763,45,http://content8.flixster.com/movie/27/96/279602_det.jpg
4084,Beverly Hills Cop II,1987,beverly_hills_cop_2,4.8,24,11,13,45,0,1,0,1,0,3.1,15724,63,http://content7.flixster.com/movie/10/84/44/10844413_det.jpg
4085,Beverly Hills Cop,1984,beverly_hills_cop,7.1,36,30,6,83,6.4,5,3,2,60,3.4,24776,73,http://content6.flixster.com/movie/10/84/44/10844412_det.jpg
4086,The Big Easy,1986,big_easy,7.5,13,13,0,100,0,1,1,0,100,3.3,1369,61,http://content8.flixster.com/movie/26/81/268126_det.jpg
4087,Da wan,2001,big_shots_funeral,4.7,15,3,12,20,0,1,0,1,0,3.6,201,72,http://content8.flixster.com/movie/10/87/11/10871130_det.jpg
4088,The Big Town,1987,1002361-big_town,5.5,6,4,2,66,0,1,1,0,100,3,433,30,http://content6.flixster.com/movie/10/88/23/10882396_det.jpg
4089,Born in East L.A.,1987,born_in_east_la,4.9,7,3,4,42,0,0,0,0,0,0,0,0,http://content7.flixster.com/movie/10/87/27/10872713_det.jpg
4090,The Brave Little Toaster,1987,brave_little_toaster,7.1,12,9,3,75,0,0,0,0,0,0,0,0,http://content8.flixster.com/movie/25/12/251214_det.jpg
4091,Can't Buy Me Love,1987,cant_buy_me_love,4.8,19,8,11,42,0,3,0,3,0,3.3,7122,73,http://content9.flixster.com/movie/25/49/254907_det.jpg
4092,Cherry 2000,1987,cherry_2000,2.7,6,0,6,0,0,0,0,0,0,0,0,0,http://content6.flixster.com/movie/26/16/261692_det.jpg
4093,Paul Blart: Mall Cop,2009,paul_blart_mall_cop,4.6,106,37,69,34,4.5,25,8,17,32,3.2,234394,50,http://content6.flixster.com/movie/10/88/40/10884092_det.jpg
4094,Critical Condition,1987,1004964-critical_condition,0,1,1,0,100,0,0,0,0,0,0,0,0,http://content9.flixster.com/movie/10/90/00/10900071_det.jpg
4095,Cry Freedom,1987,cry_freedom,6.4,21,16,5,76,6,5,3,2,60,3.8,2642,86,http://content6.flixster.com/movie/25/74/257420_det.jpg
4096,Cursed,2005,you-must-kill,0,0,0,0,0,0,0,0,0,0,0,0,0,http://content7.flixster.com/movie/10/84/78/10847865_det.jpg
4097,Killer Movie,2008,,0,1,0,1,0,0,0,0,0,0,0,0,0,http://content7.flixster.com/movie/10/83/93/10839337_det.jpg
4098,Dawn of the Dead,2004,dawn_of_the_dead,6.7,171,130,41,76,6.1,32,20,12,62,3.4,49706,75,http://content8.flixster.com/movie/28/60/286018_det.jpg
4099,Death Before Dishonor,1987,1005492-death_before_dishonor,0,4,0,4,0,0,1,0,1,0,2.9,538,33,http://content9.flixster.com/movie/27/82/278219_det.jpg
4100,Disorderlies,1987,disorderlies,0,2,0,2,0,0,0,0,0,0,0,0,0,http://content8.flixster.com/movie/10/94/16/10941650_det.jpg
4101,Dogs in Space,1986,dogs_in_space,0,2,1,1,50,0,0,0,0,0,0,0,0,http://content9.flixster.com/movie/40/82/26/4082263_det.jpg
4102,Eddie Murphy Raw,1987,eddie_murphy_raw,6.4,20,16,4,80,0,2,2,0,100,3.7,5495,84,http://content9.flixster.com/movie/10/87/80/10878027_det.jpg
4103,Empire of the Sun,1987,empire_of_the_sun,6.8,35,28,7,80,5.7,6,3,3,50,3.9,15781,88,http://content9.flixster.com/movie/25/43/254399_det.jpg
4104,Ernest Goes to Camp,1987,ernest_goes_to_camp,5.4,13,8,5,61,0,0,0,0,0,0,0,0,http://content6.flixster.com/movie/26/05/260504_det.jpg
4105,The Evil Dead,1981,the-evil-dead,8.1,45,45,0,100,0,3,3,0,100,3.6,26792,81,http://content8.flixster.com/movie/28/56/285618_det.jpg
4106,Extreme Prejudice,1987,,6.4,7,5,2,71,0,1,1,0,100,3.1,682,49,http://content9.flixster.com/movie/28/54/285495_det.jpg
4107,Family Viewing,1987,family-viewing,0,0,0,0,0,0,0,0,0,0,0,0,0,http://content8.flixster.com/movie/10/83/96/10839674_det.jpg
4108,Five Corners,1987,five_corners,6.1,7,5,2,71,0,0,0,0,0,0,0,0,http://content7.flixster.com/movie/10/91/75/10917521_det.jpg
4109,Flowers in the Attic,1987,flowers_in_the_attic,3.4,7,1,6,14,0,0,0,0,0,0,0,0,http://content8.flixster.com/movie/10/87/05/10870534_det.jpg
4110,The Fourth Protocol,1987,,5.7,14,9,5,64,0,2,2,0,100,3.4,544,58,http://content6.flixster.com/movie/10/90/70/10907056_det.jpg
4111,Gardens of Stone,1987,gardens_of_stone,4.7,13,5,8,38,4.2,6,1,5,16,3.4,619,57,http://content8.flixster.com/movie/10/88/87/10888706_det.jpg
4112,Giulia e Giulia,1987,julia_and_julia,0,4,2,2,50,0,1,1,0,100,2.7,36,33,http://content6.flixster.com/movie/10/86/45/10864516_det.jpg
4113,The Glass Menagerie,1987,1008391-glass_menagerie,6,9,6,3,66,0,0,0,0,0,0,0,0,http://content7.flixster.com/movie/11/12/67/11126789_det.jpg
4114,"Good Morning, Babylon",1987,good_morning_babylon,0,4,3,1,75,0,0,0,0,0,0,0,0,http://content7.flixster.com/movie/88/06/47/8806473_det.jpg
4115,Hiding Out,1987,hiding_out,4.7,6,2,4,33,0,1,0,1,0,3.3,562,64,http://content8.flixster.com/movie/10/88/47/10884750_det.jpg
4116,Hollywood Shuffle,1987,hollywood-shuffle,6.5,23,20,3,86,6.6,5,4,1,80,0,0,0,http://content7.flixster.com/movie/10/87/69/10876921_det.jpg
4117,Hope and Glory,1987,hope_and_glory,8.4,17,16,1,94,0,1,1,0,100,3.7,1181,82,http://content9.flixster.com/movie/25/70/257027_det.jpg
4118,Hot Pursuit,1987,1009972-hot_pursuit,0,3,0,3,0,0,0,0,0,0,0,0,0,http://content8.flixster.com/movie/26/24/262406_det.jpg
4119,Housekeeping,1987,housekeeping,7.6,8,8,0,100,0,1,1,0,100,4.2,254,85,http://content8.flixster.com/movie/63/56/47/6356474_det.jpg
4120,Hunk,1987,hunk,0,2,0,2,0,0,0,0,0,0,0,0,0,http://content8.flixster.com/movie/87/57/69/8757694_det.jpg
4121,Innerspace,1987,innerspace,6.6,34,27,7,79,6.4,6,5,1,83,3.1,4478,59,http://content6.flixster.com/movie/25/89/258992_det.jpg
4122,Ironweed,1987,ironweed,7.4,10,9,1,90,0,1,1,0,100,3.4,1004,58,http://content7.flixster.com/movie/10/90/87/10908757_det.jpg
4123,Ishtar,1987,ishtar,3.4,26,5,21,19,0,1,0,1,0,2.3,1043,33,http://content9.flixster.com/movie/20/86/00/2086003_det.jpg
4124,Jaws: The Revenge,1987,jaws-the-revenge,2,20,0,20,0,2.2,5,0,5,0,2.5,12154,30,http://content6.flixster.com/movie/10/93/72/10937244_det.jpg
4125,Leonard Part 6,1987,leonard-part-6,0,0,0,0,0,0,0,0,0,0,0,0,0,http://content8.flixster.com/movie/26/43/264330_det.jpg
4126,Less Than Zero,1987,less_than_zero,5.2,24,13,11,54,0,3,1,2,33,3.4,3388,65,http://content6.flixster.com/movie/27/07/270724_det.jpg
4127,Like Father Like Son,1987,1012362-like_father_like_son,0,1,0,1,0,0,0,0,0,0,0,0,0,http://content8.flixster.com/movie/59/54/59/5954594_det.jpg
4128,The Lost Boys,1987,lost_boys,6.3,40,30,10,75,0,4,2,2,50,3.7,48695,85,http://content7.flixster.com/movie/10/93/70/10937097_det.jpg
4129,Made in Heaven,1987,1013004-made_in_heaven,4.4,10,4,6,40,0,1,0,1,0,0,0,0,http://content6.flixster.com/movie/10/90/56/10905608_det.jpg
4130,Maid to Order,1987,maid_to_order,4.6,11,4,7,36,0,1,0,1,0,2.8,763,50,http://content7.flixster.com/movie/10/87/06/10870645_det.jpg
4131,Making Mr. Right,1987,making_mr_right,4.8,13,6,7,46,0,3,2,1,66,2.8,480,33,http://content8.flixster.com/movie/26/59/265922_det.jpg
4132,Mannequin,1987,,\N,\N,\N,\N,\N,\N,\N,\N,\N,\N,\N,\N,\N,\N
4133,Masters of the Universe,1987,masters_of_the_universe,3.1,16,2,14,12,0,3,0,3,0,2.6,7837,39,http://content8.flixster.com/movie/10/91/75/10917570_det.jpg
4135,The Monster Squad,1987,monster_squad,5.5,16,9,7,56,0,2,0,2,0,3.6,8621,76,http://content9.flixster.com/movie/10/93/48/10934819_det.jpg
4136,A Month in the Country,1987,month_in_the_country,0,2,2,0,100,0,0,0,0,0,0,0,0,http://content6.flixster.com/movie/87/63/46/8763468_det.jpg
4137,Morgan Stewart's Coming Home,1987,morgan_stewarts_coming_home,0,4,0,4,0,0,0,0,0,0,0,0,0,http://content6.flixster.com/movie/10/91/02/10910268_det.jpg
4138,My Demon Lover,1987,my_demon_lover,0,3,0,3,0,0,0,0,0,0,0,0,0,http://content9.flixster.com/movie/10/12/38/10123847_det.jpg
4139,No Man's Land,2001,no_mans_land,7.8,97,90,7,92,8.2,24,23,1,95,4.1,3608,92,http://content9.flixster.com/movie/27/16/271623_det.jpg
4140,North Shore,1987,north_shore,0,2,0,2,0,0,0,0,0,0,0,0,0,http://content7.flixster.com/movie/25/80/258005_det.jpg
4141,Head Over Heels,2001,1104725-head_over_heels,3.3,86,8,78,9,3.7,28,5,23,17,2.9,5738,60,http://content9.flixster.com/movie/25/92/259211_det.jpg
4142,Left Behind,2000,left_behind,3.1,41,5,36,12,3.2,15,2,13,13,3.2,3491,66,http://content7.flixster.com/movie/10/85/47/10854761_det.jpg
4143,Valentine,2001,valentine,3.1,69,6,63,8,3.1,21,3,18,14,2.5,6295,40,http://content7.flixster.com/movie/27/73/277309_det.jpg
4144,Fa yeung nin wa,2000,1104325-in_the_mood_for_love,7.6,98,86,12,87,7.6,27,23,4,85,4.4,17073,94,http://content9.flixster.com/movie/10/93/41/10934123_det.jpg
4145,Cabin Fever,2002,1125409-cabin_fever,5.9,134,84,50,62,5.2,31,15,16,48,2.6,15690,45,http://content8.flixster.com/movie/10/89/04/10890498_det.jpg
4146,The Million Dollar Hotel,2000,million_dollar_hotel,4.2,41,10,31,24,3.5,13,2,11,15,3.4,3687,64,http://content7.flixster.com/movie/65/00/650017_det.jpg
4147,Kr√°mpack,2000,nico_and_dani,6.6,52,45,7,86,6.8,19,15,4,78,3.5,545,69,http://content9.flixster.com/movie/10/88/85/10888571_det.jpg
4148,Hannibal,2001,1104385-hannibal,5.1,162,63,99,38,4.8,37,14,23,37,3.4,44476,69,http://content7.flixster.com/movie/10/93/72/10937237_det.jpg
4149,Saving Silverman,2001,saving_silverman,3.3,98,16,82,16,2.6,33,2,31,6,3,11086,52,http://content8.flixster.com/movie/27/08/270802_det.jpg
4150,Signs & Wonders,2000,signs_and_wonders,6,27,18,9,66,6.6,12,9,3,75,3,91,35,http://content6.flixster.com/movie/10/88/73/10887344_det.jpg
4151,Le go√ªt des autres,2000,taste_of_others,7.9,57,57,0,100,7.8,23,23,0,100,3.8,1673,80,http://content8.flixster.com/movie/11/14/86/11148634_det.jpg
4152,Vatel,2000,vatel,4.6,32,10,22,31,4.4,11,3,8,27,3.4,1090,59,http://content6.flixster.com/movie/26/04/260412_det.jpg
4153,Down to Earth,2001,1104813-down_to_earth,3.9,94,18,76,19,4,30,8,22,26,2.8,6402,46,http://content8.flixster.com/movie/26/21/262194_det.jpg
4154,Recess: School's Out,2001,recess_schools_out,5.9,68,42,26,61,5.3,19,10,9,52,3.1,1678,51,http://content9.flixster.com/movie/41/61/59/4161599_det.jpg
4155,Sweet November,2001,1104841-sweet_november,3.5,95,15,80,15,3.3,33,6,27,18,3.4,24564,76,http://content9.flixster.com/movie/25/67/256799_det.jpg
4156,Company Man,2000,company_man,3.3,62,9,53,14,2.9,23,1,22,4,2.9,433,40,http://content6.flixster.com/movie/26/63/266308_det.jpg
4157,The Price of Milk,2000,price_of_milk,5.4,47,23,24,48,5.5,16,8,8,50,3.7,727,69,http://content6.flixster.com/movie/10/87/85/10878580_det.jpg
4158,Monkeybone,2001,monkeybone,3.9,111,22,89,19,3.8,29,5,24,17,2.3,5059,30,http://content8.flixster.com/movie/10/43/39/10433978_det.jpg
4159,3000 Miles to Graceland,2001,3000_miles_to_graceland,3.5,95,13,82,13,2.7,23,1,22,4,2.9,8755,45,http://content8.flixster.com/movie/27/29/272922_det.jpg
4160,La veuve de Saint-Pierre,2000,widow_of_st_pierre,7.2,76,67,9,88,7.2,29,25,4,86,3.6,806,72,http://content6.flixster.com/movie/10/86/88/10868808_det.jpg
4161,The Mexican,2001,mexican,5.5,127,70,57,55,4.7,33,13,20,39,2.9,16576,47,http://content7.flixster.com/movie/28/54/285413_det.jpg
4162,See Spot Run,2001,see_spot_run,3.7,76,18,58,23,4.2,25,8,17,32,2.8,4645,51,http://content9.flixster.com/movie/25/92/259291_det.jpg
4163,Carman: The Champion,2001,carman_the_champion,4.1,9,1,8,11,0,2,1,1,50,3.4,245,63,http://content7.flixster.com/movie/10/92/76/10927645_det.jpg
4164,The Caveman's Valentine,2001,cavemans_valentine,5.1,80,35,45,43,4.7,29,11,18,37,3.1,1346,52,http://content7.flixster.com/movie/28/03/280393_det.jpg
4165,Eu Tu Eles,2000,me_you_them,6.4,55,41,14,74,6.5,19,14,5,73,3.4,377,62,http://content8.flixster.com/movie/10/91/34/10913466_det.jpg
4166,Series 7: The Contenders,2001,series_7_the_contenders,6.5,79,55,24,69,6.5,26,19,7,73,3.4,1190,65,http://content9.flixster.com/movie/28/53/285395_det.jpg
4167,15 Minutes,2001,,\N,\N,\N,\N,\N,\N,\N,\N,\N,\N,\N,\N,\N,\N
4168,Get Over It,2001,get_over_it,5.1,62,28,34,45,5.4,18,9,9,50,2.9,9761,51,http://content9.flixster.com/movie/10/87/96/10879663_det.jpg
4169,Blow Dry,2001,1101191-blow_dry,4,63,12,51,19,4.2,24,5,19,20,3.1,2504,53,http://content9.flixster.com/movie/10/87/44/10874487_det.jpg
4170,Hit and Runway,1999,hit_and_runway,4.5,34,11,23,32,4.1,12,3,9,25,2.6,61,19,http://content6.flixster.com/movie/10/84/01/10840112_det.jpg
4171,Long Night's Journey Into Day,2000,long_nights_journey_into_day,7.5,15,14,1,93,7.7,8,8,0,100,4,115,82,http://images.rottentomatoescdn.com/images/defaults/poster_default.gif
4172,Simon Magus,1999,,\N,\N,\N,\N,\N,\N,\N,\N,\N,\N,\N,\N,\N,\N
4173,When Brendan Met Trudy,2000,when_brendan_met_trudy,5.7,60,37,23,61,5.5,24,14,10,58,3.3,72,58,http://content6.flixster.com/movie/10/89/94/10899440_det.jpg
4174,The Mists of Avalon,2001,mists_of_avalon,5.6,7,3,4,42,0,1,1,0,100,3.7,4639,74,http://content9.flixster.com/movie/10/93/48/10934803_det.jpg
4175,Grey's Anatomy,2005,,\N,\N,\N,\N,\N,\N,\N,\N,\N,\N,\N,\N,\N,\N
4176,Madadayo,1993,madadayo,7.2,15,13,2,86,0,4,4,0,100,3.9,918,80,http://content8.flixster.com/movie/29/78/297894_det.jpg
4177,The Mirror Crack'd,1980,mirror_crackd,5.7,8,6,2,75,0,0,0,0,0,0,0,0,http://content6.flixster.com/movie/10/87/77/10877748_det.jpg
4178,Of Mice and Men,1992,1040322-of_mice_and_men,7.9,25,24,1,96,8.9,6,6,0,100,3.5,6505,77,http://content9.flixster.com/movie/26/07/260727_det.jpg
4179,Pixote: A Lei do Mais Fraco,1981,pixote,8.6,9,9,0,100,0,0,0,0,0,0,0,0,http://content9.flixster.com/movie/28/08/280891_det.jpg
4180,Reform School Girls,1986,reform_school_girls,4,6,1,5,16,0,0,0,0,0,0,0,0,http://content9.flixster.com/movie/27/18/271807_det.jpg
4181,Tapeheads,1988,tapeheads,5.6,15,9,6,60,0,4,1,3,25,3,937,43,http://content9.flixster.com/movie/27/86/278699_det.jpg
4182,Tuff Turf,1985,tuff_turf,4,5,1,4,20,0,1,0,1,0,3.5,827,65,http://content9.flixster.com/movie/27/10/271091_det.jpg
4183,The Unbelievable Truth,1989,unbelievable_truth,7.7,10,10,0,100,0,1,1,0,100,3.9,679,87,http://content7.flixster.com/movie/27/70/277021_det.jpg
4184,The Bishop's Wife,1947,bishops_wife,6.5,19,15,4,78,0,4,2,2,50,3.8,1928,81,http://content9.flixster.com/movie/29/06/290699_det.jpg
4185,Elvis: That's the Way It Is,1970,elvis_thats_the_way_it_is,6.6,7,6,1,85,0,0,0,0,0,0,0,0,http://content9.flixster.com/movie/35/68/06/3568067_det.jpg
4186,The Fortune Cookie,1966,fortune_cookie,7.4,21,19,2,90,0,3,3,0,100,3.6,1049,77,http://content7.flixster.com/movie/29/70/297093_det.jpg
4187,Lilies of the Field,1963,1012370-lilies_of_the_field,7.8,12,12,0,100,0,0,0,0,0,0,0,0,http://content8.flixster.com/movie/10/87/68/10876898_det.jpg
4188,Hans Christian Andersen,1952,hans_christian_andersen,6,5,4,1,80,0,0,0,0,0,0,0,0,http://content8.flixster.com/movie/28/60/286010_det.jpg
4189,The Greatest Story Ever Told,1965,greatest_story_ever_told,4.7,18,7,11,38,0,3,2,1,66,3.5,3122,68,http://content9.flixster.com/movie/10/95/45/10954503_det.jpg
4190,Elmer Gantry,1960,elmer_gantry,7.8,26,25,1,96,0,3,2,1,66,3.8,750,82,http://content7.flixster.com/movie/10/87/75/10877589_det.jpg
4191,Alfie,2004,alfie,5.5,149,73,76,48,5.2,38,16,22,42,2.9,15367,49,http://content9.flixster.com/movie/27/01/270103_det.jpg
4192,Demetrius and the Gladiators,1954,demetrius_and_the_gladiators,0,3,2,1,66,0,0,0,0,0,0,0,0,http://content8.flixster.com/movie/29/40/294006_det.jpg
4193,The Fantasticks,1995,the-fantasticks,5.2,24,12,12,50,0,2,0,2,0,3.2,418,48,http://content8.flixster.com/movie/26/14/261418_det.jpg
4194,'I Know Where I'm Going!',1945,i_know_where_im_going,8.8,8,8,0,100,0,0,0,0,0,0,0,0,http://content8.flixster.com/movie/29/23/292302_det.jpg
4195,The Abominable Dr. Phibes,1971,abominable_dr_phibes,6.8,22,17,5,77,0,0,0,0,0,0,0,0,http://content6.flixster.com/movie/26/27/262700_det.jpg
4196,"Die, Monster, Die!",1965,die_monster_die,5.6,5,4,1,80,0,0,0,0,0,0,0,0,http://content9.flixster.com/movie/10/90/34/10903435_det.jpg
4197,Dan in Real Life,2007,dan_in_real_life,6.2,167,107,60,64,6.6,35,22,13,62,3.5,112489,70,http://content6.flixster.com/movie/95/90/60/9590608_det.jpg
4198,Battle Beyond the Stars,1980,battle_beyond_the_stars,4.1,8,2,6,25,0,0,0,0,0,0,0,0,http://content7.flixster.com/movie/39/52/90/3952905_det.gif
4199,Death Warrant,1990,death_warrant,0,4,0,4,0,0,0,0,0,0,0,0,0,http://content7.flixster.com/movie/27/69/276909_det.jpg
4200,Double Impact,1991,double_impact,3.5,12,1,11,8,0,2,0,2,0,2.7,5123,45,http://content6.flixster.com/movie/10/88/98/10889864_det.jpg
4201,Pirates of the Caribbean: At World's End,2007,pirates_of_the_caribbean_3,5.4,213,95,118,44,5.2,40,14,26,35,3.8,1768593,74,http://content6.flixster.com/movie/10/95/55/10955508_det.jpg
4202,Hot Fuzz,2007,hot_fuzz,7.7,194,176,18,90,7.2,39,36,3,92,4,177532,88,http://content7.flixster.com/movie/57/50/84/5750845_det.jpg
4203,Harley Davidson and the Marlboro Man,1991,harley_davidson_and_the_marlboro_man,3.6,15,4,11,26,0,1,0,1,0,3.2,2463,63,http://content9.flixster.com/movie/27/19/271991_det.jpg
4204,Losin' It,1983,1012754-losin_it,3.9,8,1,7,12,0,2,1,1,50,2.7,1511,30,http://content9.flixster.com/movie/27/99/279915_det.jpg
4205,Mermaids,1990,mermaids,6.2,15,12,3,80,0,2,1,1,50,3,6806,63,http://content9.flixster.com/movie/96/68/25/9668255_det.jpg
4206,The Mighty Quinn,1989,mighty_quinn,6.4,17,14,3,82,0,3,3,0,100,3.2,1203,49,http://content7.flixster.com/movie/27/36/273697_det.jpg
4207,Navy Seals,1990,1029427-navy_seals,3.8,20,4,16,20,4.1,5,2,3,40,2.9,2470,46,http://content6.flixster.com/movie/28/51/285192_det.jpg
4208,Unmade Beds,1976,unmade-beds1980,0,0,0,0,0,0,0,0,0,0,0,0,0,http://content7.flixster.com/movie/10/84/80/10848097_det.jpg
4209,Rated X,2000,,\N,\N,\N,\N,\N,\N,\N,\N,\N,\N,\N,\N,\N,\N
4210,Manhunter,1986,1013248-manhunter,7.7,32,30,2,93,0,4,4,0,100,3.5,13592,70,http://content7.flixster.com/movie/27/46/274601_det.jpg
4211,Reversal of Fortune,1990,reversal_of_fortune,7.7,32,30,2,93,8.4,7,7,0,100,3.5,1155,69,http://content6.flixster.com/movie/27/51/275104_det.jpg
4212,Death on the Nile,1978,death_on_the_nile,6,11,8,3,72,0,0,0,0,0,0,0,0,http://content7.flixster.com/movie/25/56/255601_det.jpg
4213,DeepStar Six,1989,deepstar-six,2.5,6,0,6,0,0,0,0,0,0,0,0,0,http://content9.flixster.com/movie/10/85/84/10858439_det.jpg
4214,Revenge of the Nerds,1984,,\N,\N,\N,\N,\N,\N,\N,\N,\N,\N,\N,\N,\N,\N
4215,Revenge of the Nerds II: Nerds in Paradise,1987,revenge_of_the_nerds_ii_nerds_in_paradise,3.6,18,1,17,5,0,3,0,3,0,2.6,3253,40,http://content7.flixster.com/movie/20/77/72/2077729_det.jpg
4216,Longtime Companion,1989,longtime_companion,7.7,15,15,0,100,0,1,1,0,100,3.9,741,81,http://content7.flixster.com/movie/27/20/272025_det.jpg
4217,4 Little Girls,1997,4_little_girls,8.4,25,25,0,100,9.1,7,7,0,100,3.8,1088,81,http://content7.flixster.com/movie/29/22/292201_det.jpg
4218,The River's Edge,1957,,0,2,1,1,50,0,0,0,0,0,0,0,0,http://content6.flixster.com/movie/10/92/73/10927392_det.jpg
4219,Girls Just Want to Have Fun,1985,girls_just_want_to_have_fun,4.5,12,4,8,33,0,0,0,0,0,0,0,0,http://content8.flixster.com/movie/10/89/22/10892298_det.jpg
4220,The Longest Yard,2005,longest_yard,4.8,163,51,112,31,5.2,35,14,21,40,3.3,198675,67,http://content8.flixster.com/movie/10/86/70/10867014_det.jpg
4221,Necessary Roughness,1991,necessary_roughness,4.6,12,3,9,25,0,2,1,1,50,3,1806,45,http://content9.flixster.com/movie/25/73/257391_det.jpg
4222,C.H.U.D.,1984,chud,3.7,11,2,9,18,0,0,0,0,0,0,0,0,http://content6.flixster.com/movie/27/05/270596_det.jpg
4223,Enemy at the Gates,2001,enemy_at_the_gates,5.6,135,72,63,53,5.6,31,16,15,51,3.6,31546,81,http://content9.flixster.com/movie/10/89/26/10892639_det.jpg
4224,Exit Wounds,2001,exit_wounds,4.4,64,21,43,32,4.1,18,5,13,27,2.8,6171,55,http://content8.flixster.com/movie/27/22/272222_det.jpg
4225,The Dish,2000,dish,7.4,95,91,4,95,7.3,26,25,1,96,3.6,1829,77,http://content9.flixster.com/movie/25/74/257411_det.jpg
4226,Memento,2000,memento,8.1,135,125,10,92,7.7,32,30,2,93,4,103567,93,http://content9.flixster.com/movie/26/78/267827_det.jpg
4227,Band of Brothers,2001,laughing-matters-next-gen,0,0,0,0,0,0,0,0,0,0,0,0,0,http://content9.flixster.com/movie/10/91/84/10918427_det.jpg
4228,Heartbreakers,2001,1105990-heartbreakers,5.3,115,60,55,52,4.7,32,12,20,37,2.9,11640,51,http://content9.flixster.com/movie/46/50/44/4650443_det.jpg
4229,Say It Isn't So,2001,say_it_isnt_so,3.1,101,9,92,8,2.5,28,2,26,7,2.6,2001,34,http://content9.flixster.com/movie/10/87/39/10873979_det.jpg
4230,Too Much Sleep,1997,too_much_sleep,6.1,45,30,15,66,6.9,21,19,2,90,1.5,3,0,http://content9.flixster.com/movie/10/99/31/10993155_det.jpg
4231,Someone Like You...,2001,1106020-someone_like_you,4.8,105,43,62,40,4.3,28,9,19,32,3.1,6824,60,http://content6.flixster.com/movie/10/89/08/10890848_det.jpg
4232,Spy Kids 2: Island of Lost Dreams,2002,spy_kids_2_island_of_lost_dreams,6.6,127,95,32,74,6.7,30,23,7,76,2.6,12329,43,http://content8.flixster.com/movie/10/86/89/10868998_det.jpg
4233,Tomcats,2001,,\N,\N,\N,\N,\N,\N,\N,\N,\N,\N,\N,\N,\N,\N
4234,The Tailor of Panama,2001,tailor_of_panama,6.8,111,86,25,77,7.3,33,30,3,90,3,2860,42,http://content8.flixster.com/movie/27/40/274026_det.jpg
4235,Amores perros,2000,amores_perros,7.8,111,102,9,91,7.7,30,29,1,96,4.2,37736,93,http://content8.flixster.com/movie/26/73/267314_det.jpg
4236,Keep the River on Your Right: A Modern Cannibal Tale,2000,keep_the_river_on_your_right_a_modern_cannibal_tale,6.6,49,38,11,77,6.9,18,16,2,88,3.3,344,49,http://content8.flixster.com/movie/28/00/280018_det.jpg
4237,Les glaneurs et la glaneuse,2000,the-gleaners-and-i,7.7,37,34,3,91,7.9,13,13,0,100,4,608,87,http://content6.flixster.com/movie/29/61/296128_det.jpg
4238,The Making of 'Along Came a Spider',2001,,\N,\N,\N,\N,\N,\N,\N,\N,\N,\N,\N,\N,\N,\N
4239,Blow,2001,blow,5.8,134,73,61,54,5.3,32,13,19,40,3.8,70428,88,http://content8.flixster.com/movie/10/87/44/10874486_det.jpg
4240,Just Visiting,2001,just_visiting,4.7,76,25,51,32,4.6,23,8,15,34,2.9,2005,48,http://content9.flixster.com/movie/25/91/259107_det.jpg
4241,Pok√©mon 3: The Movie,2001,pokemon_the_movie_3,4,53,12,41,22,3.9,16,3,13,18,3.1,4327,57,http://content9.flixster.com/movie/25/35/253591_det.jpg
4242,Beautiful Creatures,2000,beautiful_creatures,4.8,59,22,37,37,4.7,19,7,12,36,3,741,38,http://content6.flixster.com/movie/10/89/15/10891552_det.jpg
4243,Brigham City,2001,brigham_city,6.2,24,17,7,70,6.7,7,6,1,85,3.4,535,70,http://content6.flixster.com/movie/26/35/263516_det.jpg
4244,Roozi ke zan shodam,2000,day_i_became_a_woman,7.3,56,49,7,87,7.6,23,22,1,95,4,301,82,http://content6.flixster.com/movie/29/58/295820_det.jpg
4245,Shadow Magic,2000,shadow_magic,6.2,49,35,14,71,6.9,19,15,4,78,3.5,284,58,http://content6.flixster.com/movie/10/89/48/10894872_det.jpg
4246,Bridget Jones's Diary,2001,bridget_jones_diary,6.8,151,121,30,80,6.2,35,24,11,68,3.3,70748,77,http://content7.flixster.com/movie/26/97/269701_det.jpg
4247,Joe Dirt,2001,joe_dirt,3,74,8,66,10,2.7,24,1,23,4,2.8,16165,63,http://content6.flixster.com/movie/25/79/257912_det.jpg
4248,Josie and the Pussycats,2001,josie_and_the_pussycats,5.2,118,62,56,52,5.6,29,17,12,58,2.6,7768,45,http://content8.flixster.com/movie/11/12/75/11127538_det.jpg
4249,Kingdom Come,2001,kingdom_come,4.3,64,18,46,28,4.3,22,7,15,31,3.4,1386,66,http://content7.flixster.com/movie/26/17/261721_det.jpg
4250,Body of Lies,2008,10009225-body_of_lies,5.8,194,102,92,52,5.6,40,21,19,52,3.5,38376,66,http://content7.flixster.com/movie/10/88/79/10887933_det.jpg
4251,Chopper,2000,chopper,6.4,64,45,19,70,7,20,17,3,85,3.9,6049,89,http://content6.flixster.com/movie/27/25/272516_det.jpg
4252,Dayereh,2000,1105687-circle,7.8,60,56,4,93,7.9,20,19,1,95,3.7,578,75,http://content9.flixster.com/movie/10/91/53/10915351_det.jpg
4253,Lakeboat,2000,lakeboat,6.6,41,34,7,82,6.5,15,11,4,73,3.2,199,57,http://content8.flixster.com/movie/28/25/282506_det.jpg
4254,Crocodile Dundee in Los Angeles,2001,crocodile_dundee_in_los_angeles,3.6,77,9,68,11,3.6,23,2,21,8,2.4,8135,37,http://content9.flixster.com/movie/26/11/261123_det.jpg
4255,Freddy Got Fingered,2001,freddy_got_fingered,2.7,91,10,81,10,2.6,27,2,25,7,2.5,14822,54,http://content8.flixster.com/movie/27/25/272510_det.jpg
4256,The Center of the World,2001,center_of_the_world,4.8,80,27,53,33,3.6,24,3,21,12,3,592,42,http://content7.flixster.com/movie/10/93/79/10937909_det.jpg
4258,Sweet and Lowdown,1999,sweet_and_lowdown,6.8,59,46,13,77,6.5,16,11,5,68,3.6,3877,76,http://content8.flixster.com/movie/26/07/260798_det.jpg
4259,The Luzhin Defence,2000,luzhin_defence,5.9,71,42,29,59,6.1,23,14,9,60,3.5,403,68,http://content6.flixster.com/movie/26/67/266712_det.jpg
4260,Jonas Brothers: The 3D Concert Experience,2009,jonas_brothers_3d,4.2,71,16,55,22,4.6,22,7,15,31,3.3,74109,64,http://content7.flixster.com/movie/10/92/39/10923953_det.jpg
4261,Lilies - Les feluettes,1996,1090236-lilies,7.2,7,7,0,100,0,2,2,0,100,4,517,83,http://content6.flixster.com/movie/27/62/276292_det.jpg
4262,Scarface,1983,1018324-scarface,7.5,50,44,6,88,8,5,4,1,80,4.1,121090,93,http://content6.flixster.com/movie/49/68/81/4968812_det.jpg
4263,Days of Wine and Roses,1962,1005381-days_of_wine_and_roses,9,7,7,0,100,0,0,0,0,0,0,0,0,http://content9.flixster.com/movie/10/03/99/10039999_det.jpg
4265,Driven,2001,1107198-driven,3.6,108,14,94,12,3.6,27,3,24,11,2.5,7367,40,http://content8.flixster.com/movie/26/03/260326_det.jpg
4266,The Forsaken,2001,forsaken,3.3,53,4,49,7,3.5,11,2,9,18,2.9,2483,45,http://content9.flixster.com/movie/27/58/275891_det.jpg
4267,One Night at McCool's,2001,one_night_at_mccools,4.7,102,34,68,33,4,31,7,24,22,2.7,2770,38,http://content8.flixster.com/movie/28/17/281714_det.jpg
4268,Town & Country,2001,town_and_country,3.5,89,12,77,13,3.7,24,4,20,16,2.4,717,16,http://content8.flixster.com/movie/28/30/283026_det.jpg
4269,Ratatouille,2007,ratatouille,8.4,213,205,8,96,8.3,42,41,1,97,3.9,414956,84,http://content6.flixster.com/movie/41/60/98/4160984_det.jpg
4270,The Mummy Returns,2001,mummy_returns,5.2,137,64,73,46,5.2,33,15,18,45,3.3,65125,69,http://content7.flixster.com/movie/10/83/85/10838569_det.jpg
4271,Eureka,2000,1107897-eureka,7.2,42,38,4,90,6.8,19,16,3,84,4.1,667,88,http://content7.flixster.com/movie/18/96/61/1896617_det.jpg
4272,Tuvalu,1999,tuvalu,6.8,26,19,7,73,6.3,6,3,3,50,4.1,583,90,http://content8.flixster.com/movie/30/02/300206_det.jpg
4273,Sous le sable,2000,under_the_sand,7.5,70,66,4,94,7.8,23,23,0,100,3.7,924,79,http://content6.flixster.com/movie/10/88/93/10889300_det.jpg
4274,Cleopatra,1963,1004330-cleopatra,5.4,20,8,12,40,0,3,2,1,66,3.4,3444,73,http://content7.flixster.com/movie/28/62/286201_det.jpg
4275,Krull,1983,monster-in-the-forest-the-story-of-the-cyclop,0,0,0,0,0,0,0,0,0,0,0,0,0,http://content8.flixster.com/movie/10/87/04/10870422_det.jpg
4276,Lost in America,1985,lost_in_america,7.9,24,23,1,95,0,1,1,0,100,3.5,869,71,http://content6.flixster.com/movie/27/07/270792_det.jpg
4277,The Lost World: Jurassic Park,1997,lost_world_jurassic_park,5.6,59,29,30,49,5.1,13,6,7,46,3.2,46513,55,http://content9.flixster.com/movie/10/84/11/10841191_det.jpg
4278,Triumph des Willens,1935,triumph_of_the_will,7.8,16,15,1,93,0,0,0,0,0,0,0,0,http://content7.flixster.com/movie/30/57/305709_det.jpg
4279,True Believer,1989,true_believer,7,22,21,1,95,0,4,3,1,75,3.2,549,49,http://content8.flixster.com/movie/27/72/277218_det.jpg
4280,The World According to Garp,1982,world_according_to_garp,6.3,14,11,3,78,0,1,1,0,100,3.5,3647,75,http://content8.flixster.com/movie/10/91/70/10917006_det.jpg
4281,Candy,2006,candy,5.8,74,36,38,48,6.1,24,14,10,58,3.8,9542,78,http://content8.flixster.com/movie/10/88/35/10883510_det.jpg
4282,Fellini - Satyricon,1969,fellini_satyricon,7,22,17,5,77,7.3,5,4,1,80,3.7,3120,73,http://content7.flixster.com/movie/10/92/40/10924089_det.jpg
4283,Roma,1972,fellinis_roma,6.5,12,7,5,58,0,2,1,1,50,3.9,1894,82,http://content8.flixster.com/movie/10/92/40/10924098_det.jpg
4284,Frankie and Johnny,1991,1037161-frankie_and_johnny,6.8,17,13,4,76,0,2,1,1,50,3.2,4527,62,http://content6.flixster.com/movie/27/20/272016_det.jpg
4285,Frankie and Johnny,1991,1037161-frankie_and_johnny,6.8,17,13,4,76,0,2,1,1,50,3.2,4527,62,http://content6.flixster.com/movie/27/20/272016_det.jpg
4286,A Home of Our Own,1993,1046076-home_of_our_own,5.7,11,5,6,45,0,3,1,2,33,3.3,706,67,http://content8.flixster.com/movie/10/87/40/10874074_det.jpg
4287,Paris - When It Sizzles,1964,paris_when_it_sizzles,5.8,7,4,3,57,0,0,0,0,0,0,0,0,http://content9.flixster.com/movie/29/32/293291_det.jpg
4288,Pola X,1999,pola_x,6.6,20,15,5,75,6.9,7,6,1,85,3.3,449,54,http://content9.flixster.com/movie/29/59/295995_det.jpg
4289,La citt√† delle donne,1980,city_of_women,7.1,9,7,2,77,0,2,1,1,50,3.7,1181,74,http://content9.flixster.com/movie/27/88/278899_det.jpg
4290,Boy A,2007,boy-a,7.5,57,51,6,89,7.5,23,20,3,86,3.5,5895,84,http://content8.flixster.com/movie/10/85/07/10850786_det.jpg
4291,Nine to Five,1980,9_to_5,6.9,25,22,3,88,0,1,1,0,100,3.2,3894,70,http://content7.flixster.com/movie/25/60/256025_det.jpg
4292,Norma Rae,1979,norma_rae,7.5,19,17,2,89,0,3,2,1,66,3.5,1339,77,http://content8.flixster.com/movie/10/86/43/10864390_det.jpg
4293,Summer Rental,1985,summer_rental,4.4,13,2,11,15,0,0,0,0,0,0,0,0,http://content7.flixster.com/movie/25/67/256701_det.jpg
4294,"The 5,000 Fingers of Dr. T.",1953,the-5000-fingers-of-dr-t,6.8,13,10,3,76,0,0,0,0,0,0,0,0,http://content8.flixster.com/movie/25/18/251810_det.jpg
4295,Catchfire,1990,backtrack,5.2,7,3,4,42,0,0,0,0,0,0,0,0,http://content9.flixster.com/movie/10/88/51/10885159_det.jpg
4296,Love Story,1970,love_story,5.8,21,12,9,57,0,4,4,0,100,3.5,10498,75,http://content6.flixster.com/movie/25/68/256816_det.jpg
4297,Pelle erobreren,1987,pelle_the_conqueror,7.3,8,8,0,100,0,1,1,0,100,3.9,852,86,http://content9.flixster.com/movie/10/93/54/10935431_det.jpg
4298,Du rififi chez les hommes,1955,du-rififi-chez-les-hommes-rififi,8.1,40,37,3,92,7.8,9,8,1,88,4.3,2008,95,http://content7.flixster.com/movie/10/87/66/10876601_det.jpg
4299,A Knight's Tale,2001,knights_tale,5.8,137,79,58,57,5.7,34,20,14,58,3.5,77647,80,http://content7.flixster.com/movie/10/91/18/10911869_det.jpg
4300,Bread and Roses,2000,bread_and_roses,6.1,62,40,22,64,6.3,21,15,6,71,3.7,1038,76,http://content9.flixster.com/movie/74/96/53/7496539_det.jpg
4301,Calle 54,2000,calle_54,7.2,47,41,6,87,7.7,19,17,2,89,3.7,351,74,http://content6.flixster.com/movie/25/14/251404_det.jpg
4302,The King Is Alive,2000,king_is_alive,5.8,65,39,26,60,4.7,16,6,10,37,3.3,375,55,http://content9.flixster.com/movie/28/49/284923_det.jpg
4303,Sordid Lives,2000,sordid_lives,4.4,27,10,17,37,4.1,8,2,6,25,4.1,754,87,http://content9.flixster.com/movie/28/54/285407_det.jpg
4304,Startup.com,2001,startupcom,7.6,92,85,7,92,7.4,30,27,3,90,3.4,490,65,http://content7.flixster.com/movie/27/04/270493_det.jpg
4305,Angel Eyes,2001,angel-links,0,0,0,0,0,0,0,0,0,0,0,0,0,http://content6.flixster.com/movie/10/84/92/10849212_det.jpg
4306,Shrek,2001,shrek,7.7,174,155,19,89,7.6,36,31,5,86,3.9,208170,87,http://content6.flixster.com/movie/25/44/254400_det.jpg
4307,Fast Food Fast Women,2000,fast_food_fast_women,4.8,35,17,18,48,4.5,14,6,8,42,3.4,504,63,http://content8.flixster.com/movie/10/91/62/10916258_det.jpg
4308,Moulin Rouge!,2001,1107863-moulin_rouge,7,168,130,38,77,6.1,35,23,12,65,3.7,110817,88,http://content9.flixster.com/movie/11/13/74/11137447_det.jpg
4309,Petits fr√®res,1999,petits_freres,5.7,13,8,5,61,0,4,4,0,100,2.6,22,25,http://content7.flixster.com/movie/11/13/29/11132953_det.jpg
4310,Pearl Harbor,2001,1108389-pearl_harbor,4.3,159,41,118,25,4.1,36,8,28,22,3.3,80658,73,http://content7.flixster.com/movie/31/29/312925_det.jpg
4311,1732 H√∏tten,1998,bloody-angels,6.7,8,6,2,75,0,2,2,0,100,5,5,100,http://images.rottentomatoescdn.com/images/defaults/poster_default.gif
4312,Himalaya - l'enfance d'un chef,1999,himalaya,7.2,53,47,6,88,7.5,19,17,2,89,4,571,89,http://content8.flixster.com/movie/10/87/12/10871298_det.jpg
4313,The Man Who Cried,2000,man_who_cried,4.7,68,24,44,35,4.3,23,6,17,26,3.4,8886,61,http://content9.flixster.com/movie/10/88/32/10883295_det.jpg
4314,Our Song,2000,,7.3,51,46,5,90,7.7,21,20,1,95,3.8,342,78,http://content7.flixster.com/movie/10/87/48/10874869_det.jpg
4315,Gabriela,2001,1114093-gabriela,0,2,0,2,0,0,0,0,0,0,0,0,0,http://content9.flixster.com/movie/28/37/283799_det.jpg
4316,Ice Castles,1978,ice_castles,5.2,7,3,4,42,0,1,0,1,0,3.5,1225,71,http://content8.flixster.com/movie/25/62/256218_det.jpg
4317,Love Potion No. 9,1992,love_potion_9,3.7,11,3,8,27,0,0,0,0,0,0,0,0,http://content6.flixster.com/movie/25/98/259824_det.jpg
4318,Postcards from the Edge,1990,postcards_from_the_edge,6.8,20,18,2,90,0,2,2,0,100,3.3,2163,63,http://content6.flixster.com/movie/27/11/271128_det.jpg
4319,Apache,1954,apache,5.5,6,4,2,66,0,0,0,0,0,0,0,0,http://content9.flixster.com/movie/30/46/304603_det.jpg
4320,"Buffalo Bill and the Indians, or Sitting Bull's History Lesson",1976,buffalo_bill_and_the_indians_or_sitting_bulls_history_lesson,6.3,11,8,3,72,0,2,1,1,50,3.2,745,53,http://content8.flixster.com/movie/11/12/17/11121738_det.jpg
4321,City Slickers,1991,city_slickers,6.7,26,23,3,88,0,2,2,0,100,3.1,7371,59,http://content6.flixster.com/movie/11/15/27/11152780_det.jpg
4322,Eight Men Out,1988,eight_men_out,7.2,36,31,5,86,4.8,6,2,4,33,3.6,2938,76,http://content7.flixster.com/movie/25/44/254409_det.jpg
4323,The Horse Soldiers,1959,horse_soldiers,7.4,5,5,0,100,0,0,0,0,0,0,0,0,http://content6.flixster.com/movie/10/87/81/10878152_det.jpg
4324,The Kentuckian,1955,kentuckian,0,1,0,1,0,0,0,0,0,0,0,0,0,http://content6.flixster.com/movie/94/45/46/9445468_det.jpg
4325,La notte,1961,notte,6.8,14,10,4,71,0,1,1,0,100,4.2,1605,92,http://content9.flixster.com/movie/29/70/297091_det.jpg
4326,Mississippi Burning,1988,mississippi_burning,6.3,14,12,2,85,0,1,1,0,100,3.7,6011,87,http://content9.flixster.com/movie/10/95/08/10950843_det.jpg
4327,The Magnificent Seven,1960,1013077-magnificent_seven,7.9,27,25,2,92,0,0,0,0,0,0,0,0,http://content9.flixster.com/movie/10/86/96/10869667_det.jpg
4328,Return of the Seven,1966,return_of_the_magnificent_seven,3.3,7,1,6,14,0,0,0,0,0,0,0,0,http://content9.flixster.com/movie/10/86/96/10869663_det.jpg
4329,Rio Bravo,1959,rio_bravo,8.2,33,33,0,100,7.2,5,5,0,100,4,4947,89,http://content9.flixster.com/movie/28/59/285995_det.jpg
4330,The Scarlet Empress,1934,scarlet_empress,9,11,11,0,100,0,0,0,0,0,0,0,0,http://content6.flixster.com/movie/29/81/298104_det.jpg
4331,Semi-Tough,1977,semitough,6.6,5,4,1,80,0,2,1,1,50,3,355,32,http://content6.flixster.com/movie/28/05/280520_det.jpg
4332,The Usual Suspects,1995,usual_suspects,7.5,47,41,6,87,6.9,14,12,2,85,4.2,109588,95,http://content7.flixster.com/movie/24/63/48/2463485_det.jpg
4333,Throw Momma from the Train,1987,throw_momma_from_the_train,5.6,25,15,10,60,0,1,0,1,0,2.9,4120,51,http://content9.flixster.com/movie/10/94/07/10940735_det.jpg
4334,Yi yi,2000,the-last-days-of-hsin-yang,0,0,0,0,0,0,0,0,0,0,0,0,0,http://content9.flixster.com/movie/10/91/40/10914071_det.jpg
4335,Midnight Madness,1980,midnight_madness,0,3,0,3,0,0,1,0,1,0,3.6,703,71,http://content7.flixster.com/movie/26/54/265493_det.jpg
4336,Nattevagten,1994,1104068-nightwatch,0,4,2,2,50,0,0,0,0,0,0,0,0,http://content7.flixster.com/movie/97/66/95/9766957_det.jpg
4337,The Sand Pebbles,1966,sand_pebbles,7,16,14,2,87,0,0,0,0,0,0,0,0,http://content6.flixster.com/movie/10/94/80/10948056_det.jpg
4338,Twelve O'Clock High,1949,1022172-twelve_oclock_high,8.2,14,14,0,100,0,0,0,0,0,0,0,0,http://content9.flixster.com/movie/11/15/02/11150275_det.jpg
4339,Von Ryan's Express,1965,von_ryans_express,6.8,11,10,1,90,0,0,0,0,0,0,0,0,http://content9.flixster.com/movie/25/78/257811_det.jpg
4340,Animal House,1978,national_lampoons_animal_house,7.7,40,36,4,90,7.1,5,4,1,80,3.7,25149,88,http://content9.flixster.com/movie/11/15/27/11152731_det.jpg
4341,What's the Worst That Could Happen?,2001,whats_the_worst_that_could_happen,3.5,96,10,86,10,3.3,31,1,30,3,2.7,2321,41,http://content7.flixster.com/movie/10/83/80/10838013_det.jpg
4342,Big Eden,2000,big_eden,6,51,33,18,64,5.4,19,9,10,47,3.9,895,80,http://content7.flixster.com/movie/10/93/24/10932417_det.jpg
4343,Underworld: Evolution,2006,underworld_evolution,3.7,100,15,85,15,3.5,16,1,15,6,3.6,111035,77,http://content9.flixster.com/movie/31/24/312403_det.jpg
4344,Swordfish,2001,swordfish,4.3,134,34,100,25,3.5,34,6,28,17,3.2,30360,64,http://content9.flixster.com/movie/26/84/268491_det.jpg
4345,The Anniversary Party,2001,anniversary_party,5.8,111,67,44,60,5.5,31,18,13,58,3.2,1519,54,http://content6.flixster.com/movie/10/89/02/10890280_det.jpg
4346,Bride of the Wind,2001,the-wind2001,0,0,0,0,0,0,0,0,0,0,0,0,0,http://content6.flixster.com/movie/10/89/09/10890920_det.jpg
4347,Mus√≠me si pom√°hat,2000,divided_we_fall,7.3,61,55,6,90,7.7,23,22,1,95,4,599,89,http://content8.flixster.com/movie/26/66/266602_det.jpg
4348,Whatever Happened to Harold Smith?,1999,whatever_happened_to_harold_smith,4.6,10,4,6,40,0,3,0,3,0,3.5,629,61,http://content9.flixster.com/movie/75/70/23/7570239_det.gif
4349,Catch-22,1970,catch22,7.2,23,20,3,86,0,1,1,0,100,3.6,3246,74,http://content9.flixster.com/movie/26/89/268919_det.jpg
4350,Forgotten Silver,1995,forgotten_silver,7.5,10,10,0,100,0,2,2,0,100,3.7,1179,77,http://content7.flixster.com/movie/30/86/308609_det.jpg
4351,Point Break,1991,point_break,6,49,33,16,67,4.4,7,2,5,28,3.3,19358,75,http://content9.flixster.com/movie/10/92/39/10923947_det.jpg
4352,Shag,1989,shag_the_movie,6,14,9,5,64,0,4,3,1,75,3.9,1799,84,http://content9.flixster.com/movie/10/84/77/10847747_det.jpg
4353,Uncommon Valor,1983,1022314-uncommon_valor,6.1,9,5,4,55,0,1,0,1,0,3.4,1161,64,http://content6.flixster.com/movie/27/50/275004_det.jpg
4354,Unlawful Entry,1992,unlawful_entry,6.2,30,22,8,73,6.4,7,6,1,85,3.1,1826,44,http://content7.flixster.com/movie/27/37/273793_det.jpg
4355,Youngblood,1986,youngblood,3.8,6,2,4,33,0,1,0,1,0,3.4,2381,67,http://content6.flixster.com/movie/26/91/269104_det.jpg
4356,Gentlemen Prefer Blondes,1953,gentlemen_prefer_blondes,7.8,34,34,0,100,0,4,4,0,100,3.7,7651,82,http://content6.flixster.com/movie/10/89/32/10893256_det.jpg
4357,How to Marry a Millionaire,1953,how_to_marry_a_millionaire,7,13,12,1,92,0,0,0,0,0,0,0,0,http://content8.flixster.com/movie/67/48/45/6748450_det.jpg
4358,Movie Macabre,1981,,\N,\N,\N,\N,\N,\N,\N,\N,\N,\N,\N,\N,\N,\N
4359,The Seven Year Itch,1955,seven_year_itch,7.3,25,22,3,88,0,4,3,1,75,3.6,5407,75,http://content6.flixster.com/movie/28/65/286524_det.jpg
4360,There's No Business Like Show Business,1954,theres_no_business_like_show_business,6.4,11,8,3,72,0,0,0,0,0,0,0,0,http://content7.flixster.com/movie/10/91/07/10910725_det.jpg
4361,Tootsie,1982,tootsie,7.6,39,34,5,87,8.2,6,6,0,100,3.4,12431,75,http://content8.flixster.com/movie/25/67/256706_det.jpg
4362,The Boys Next Door,1996,1070693-boys_next_door,0,0,0,0,0,0,0,0,0,0,0,0,0,http://content7.flixster.com/movie/10/97/46/10974641_det.jpg
4363,Too Late the Hero,1970,too_late_the_hero,6,11,8,3,72,0,3,1,2,33,3.4,437,64,http://content8.flixster.com/movie/31/07/310794_det.jpg
4364,Das Trio,1998,,\N,\N,\N,\N,\N,\N,\N,\N,\N,\N,\N,\N,\N,\N
4365,Pavilion of Women,2001,pavilion_of_women,3.1,31,2,29,6,2.6,12,0,12,0,3.4,326,65,http://content6.flixster.com/movie/10/83/84/10838464_det.jpg
4366,Atlantis: The Lost Empire,2001,atlantis_the_lost_empire,5.3,125,57,68,45,5,30,12,18,40,2.9,15720,50,http://content8.flixster.com/movie/25/73/257314_det.jpg
4367,Lara Croft: Tomb Raider,2001,lara_croft_tomb_raider,3.9,154,29,125,18,3.9,35,7,28,20,3.1,46926,60,http://content8.flixster.com/movie/10/87/58/10875862_det.jpg
4368,Dr. Dolittle 2,2001,dr_dolittle_2,4.9,104,42,62,40,5.4,31,14,17,45,2.8,16612,43,http://content7.flixster.com/movie/10/88/91/10889141_det.jpg
4369,The Fast and the Furious,2001,1108372-fast_and_the_furious,5.4,143,76,67,53,5.7,33,21,12,63,3.4,122441,81,http://content8.flixster.com/movie/10/89/31/10893122_det.jpg
4370,Artificial Intelligence: AI,2001,ai_artificial_intelligence,6.6,186,135,51,72,6.4,40,27,13,67,3.1,42316,58,http://content7.flixster.com/movie/10/86/76/10867613_det.jpg
4371,Baby Boy,2001,baby_boy,6.1,90,62,28,68,6.3,31,24,7,77,3.8,15836,85,http://content6.flixster.com/movie/27/19/271920_det.jpg
4372,Crazy/Beautiful,2001,crazy-beautiful,5.8,97,61,36,62,5.6,29,17,12,58,3.1,9723,68,http://content6.flixster.com/movie/25/80/258012_det.jpg
4373,Pootie Tang,2001,pootie_tang,3.8,41,11,30,26,4.2,18,7,11,38,2.7,4226,56,http://content8.flixster.com/movie/25/90/259010_det.jpg
4374,Snow Days,1999,let_it_snow,5,17,9,8,52,5.5,7,4,3,57,3.2,238,55,http://content6.flixster.com/movie/28/55/285520_det.jpg
4375,Dr√¥le de F√©lix,2000,adventures_of_felix,6.3,39,27,12,69,6.4,15,11,4,73,3.4,60,52,http://content6.flixster.com/movie/10/84/94/10849468_det.jpg
4376,Down from the Mountain,2000,down_from_the_mountain,7.5,31,30,1,96,7.9,11,11,0,100,3.5,336,75,http://content8.flixster.com/movie/25/13/251302_det.jpg
4377,Les poup√©es russes,2005,russian_dolls,6.6,47,34,13,72,6.8,17,11,6,64,3.6,8145,76,http://content6.flixster.com/movie/27/23/02/2723024_det.jpg
4378,Sexy Beast,2000,sexy_beast,7.2,118,101,17,85,7.7,31,30,1,96,3.7,7958,83,http://content7.flixster.com/movie/10/91/95/10919513_det.jpg
4379,"South of Heaven, West of Hell",2000,south_of_heaven_west_of_hell,3.5,7,1,6,14,0,0,0,0,0,0,0,0,http://content7.flixster.com/movie/41/69/15/4169153_det.jpg
4380,Der Krieger und die Kaiserin,2000,,\N,\N,\N,\N,\N,\N,\N,\N,\N,\N,\N,\N,\N,\N
4381,Le placard,2001,closet,7,79,68,11,86,6.7,24,18,6,75,3.7,2303,76,http://content9.flixster.com/movie/27/14/271495_det.jpg
4382,Dances with Wolves,1990,dances_with_wolves,7,46,35,11,76,6.9,10,7,3,70,3.6,28000,84,http://content6.flixster.com/movie/10/87/82/10878268_det.jpg
4383,Les rivi√®res pourpres,2000,crimson_rivers,6,53,36,17,67,4.9,16,6,10,37,3.5,3727,70,http://content7.flixster.com/movie/27/46/274617_det.jpg
4384,Lumumba,2000,lumumba,7,55,46,9,83,7.2,23,20,3,86,3.9,339,81,http://content9.flixster.com/movie/30/40/304027_det.jpg
4385,Pandaemonium,2000,pandaemonium,5.7,26,15,11,57,4.9,7,3,4,42,3.7,260,70,http://content8.flixster.com/movie/11/15/05/11150586_det.jpg
4386,The Truth About Cats & Dogs,1996,truth_about_cats_and_dogs,6.7,36,30,6,83,7.6,6,5,1,83,2.9,6120,55,http://content9.flixster.com/movie/10/88/92/10889235_det.jpg
4387,Kiss of the Dragon,2001,kiss_of_the_dragon,5.3,103,53,50,51,5.2,27,13,14,48,3.3,12628,70,http://content7.flixster.com/movie/27/15/271525_det.jpg
4388,Scary Movie 2,2001,scary_movie_2,3.3,106,15,91,14,3.2,29,2,27,6,3,85716,68,http://content8.flixster.com/movie/26/77/267706_det.jpg
4389,Lost and Delirious,2001,lost_and_delirious,5.4,58,29,29,50,5.6,22,11,11,50,3.8,3998,79,http://content8.flixster.com/movie/26/77/267714_det.jpg
4390,Baise-moi,2000,baisemoi,4.2,56,12,44,21,3.7,19,1,18,5,2.7,2080,38,http://content9.flixster.com/movie/10/88/87/10888771_det.jpg
4391,Mua he chieu thang dung,2000,vertical_ray_of_the_sun,7.1,55,45,10,81,7,20,17,3,85,4,746,84,http://content6.flixster.com/movie/11/14/31/11143156_det.jpg
4393,Another Woman,1988,another_woman,6.2,20,12,8,60,5.7,6,3,3,50,3.7,1472,75,http://content7.flixster.com/movie/26/36/263697_det.jpg
4394,Beach Blanket Bingo,1965,beach_blanket_bingo,5.4,7,5,2,71,0,0,0,0,0,0,0,0,http://content8.flixster.com/movie/28/81/288114_det.jpg
4395,I soliti ignoti,1958,big_deal_on_madonna_street,7.3,8,7,1,87,0,0,0,0,0,0,0,0,http://content6.flixster.com/movie/29/95/299528_det.jpg
4396,The Cannonball Run,1981,cannonball_run,4.2,29,9,20,31,0,3,0,3,0,3.1,6545,59,http://content8.flixster.com/movie/10/08/33/10083378_det.jpg
4397,Cannonball Run II,1984,cannonball_run_2,2.4,9,1,8,11,0,1,0,1,0,2.7,2869,42,http://content6.flixster.com/movie/25/73/257396_det.jpg
4398,Speed Zone!,1989,speed_zone,0,4,0,4,0,0,1,0,1,0,3,765,43,http://content9.flixster.com/movie/62/27/622755_det.jpg
4399,Le journal d'une femme de chambre,1964,1005815-diary_of_a_chambermaid,8,19,16,3,84,0,1,0,1,0,3.8,1018,82,http://content9.flixster.com/movie/10/92/19/10921927_det.jpg
4401,Donovan's Reef,1963,the-reef,0,0,0,0,0,0,0,0,0,0,0,0,0,http://content9.flixster.com/movie/10/88/97/10889767_det.jpg
4402,Dr. Goldfoot and the Bikini Machine,1965,dr_goldfoot_and_the_bikini_machine,3.8,5,1,4,20,0,0,0,0,0,0,0,0,http://content6.flixster.com/movie/25/29/252992_det.jpg
4403,House of Usher,1960,1007021-fall_of_the_house_of_usher,6.7,21,18,3,85,0,2,1,1,50,3.5,2068,69,http://content8.flixster.com/movie/10/89/71/10897194_det.jpg
4404,Faust: Love of the Damned,2000,faust_love_of_the_damned,0,3,1,2,33,0,0,0,0,0,0,0,0,http://content7.flixster.com/movie/10/90/86/10908669_det.jpg
4405,Der letzte Mann,1924,last_laugh,9,24,24,0,100,0,3,3,0,100,4.1,1020,90,http://content6.flixster.com/movie/96/68/17/9668176_det.jpg
4406,The Man Who Shot Liberty Valance,1962,man_who_shot_liberty_valance,8.6,34,33,1,97,0,2,2,0,100,4,5590,89,http://content8.flixster.com/movie/10/89/17/10891714_det.jpg
4407,Salvador (Puig Antich),2006,10006953-salvador,0,2,0,2,0,0,1,0,1,0,0,0,0,http://content8.flixster.com/movie/28/99/81/2899814_det.jpg
4408,11'09''01 - September 11,2002,september_11,6.6,58,45,13,77,6.6,21,16,5,76,3.5,303,62,http://content9.flixster.com/movie/10/88/53/10885371_det.jpg
4409,Shadows and Fog,1991,shadows_and_fog,5.9,21,12,9,57,0,0,0,0,0,0,0,0,http://content7.flixster.com/movie/10/91/80/10918069_det.jpg
4410,Something Wild,1986,something_wild,7,28,24,4,85,6.2,5,3,2,60,3.2,1139,58,http://content7.flixster.com/movie/10/79/25/10792537_det.jpg
4411,The Sons of Katie Elder,1965,sons_of_katie_elder,6.6,11,11,0,100,0,0,0,0,0,0,0,0,http://content8.flixster.com/movie/29/24/292414_det.jpg
4412,The Thing with Two Heads,1972,thing_with_two_heads,2.1,7,0,7,0,0,1,0,1,0,2.8,123,36,http://content6.flixster.com/movie/10/85/35/10853520_det.jpg
4413,Village of the Giants,1965,village_of_the_giants,0,4,0,4,0,0,0,0,0,0,0,0,0,http://content9.flixster.com/movie/30/29/302915_det.jpg
4414,X,1963,,6.6,21,18,3,85,0,3,3,0,100,3.3,872,61,http://content9.flixster.com/movie/29/78/297819_det.jpg
4415,Nice Dreams,1981,cheech_and_chongs_nice_dreams,4.5,7,3,4,42,0,0,0,0,0,0,0,0,http://content6.flixster.com/movie/10/87/68/10876856_det.jpg
4416,The Day the Earth Caught Fire,1961,day_the_earth_caught_fire,6.5,6,5,1,83,0,0,0,0,0,0,0,0,http://content9.flixster.com/movie/28/67/286795_det.jpg
4417,Quella villa accanto al cimitero,1981,the-house-by-the-cemetery,4.6,6,2,4,33,0,0,0,0,0,0,0,0,http://content8.flixster.com/movie/10/91/59/10915906_det.jpg
4418,Things Are Tough All Over,1982,cheech_and_chong_things_are_tough_all_over,0,1,1,0,100,0,0,0,0,0,0,0,0,http://content7.flixster.com/movie/10/87/27/10872717_det.jpg
4419,All That Heaven Allows,1955,all_that_heaven_allows,7.6,26,24,2,92,0,3,1,2,33,0,0,0,http://content9.flixster.com/movie/29/45/294527_det.jpg
4420,The Barefoot Contessa,1954,barefoot_contessa,7.5,8,8,0,100,0,1,1,0,100,3.6,1121,70,http://content7.flixster.com/movie/29/56/295629_det.jpg
4421,Blackout,2007,1177641-blackout,0,3,1,2,33,0,0,0,0,0,0,0,0,http://content7.flixster.com/movie/11/12/75/11127585_det.jpg
4422,Viskningar och rop,1972,cries_and_whispers,8.2,27,24,3,88,8,5,4,1,80,4.3,3227,91,http://content7.flixster.com/movie/13/62/63/1362637_det.jpg
4423,The Entertainer,1960,1032798-entertainer,7.8,8,7,1,87,0,0,0,0,0,0,0,0,http://content8.flixster.com/movie/30/25/302502_det.jpg
4424,Il giardino dei Finzi Contini,1970,the-garden-of-the-finzicontinis,8.1,12,12,0,100,0,3,3,0,100,3.9,483,81,http://content7.flixster.com/movie/11/12/23/11122341_det.jpg
4425,Howling III,1987,howling_iii,3,10,2,8,20,0,0,0,0,0,0,0,0,http://content7.flixster.com/movie/10/83/97/10839725_det.jpg
4426,Kiss Me Deadly,1955,kiss_me_deadly,7.9,26,25,1,96,0,4,3,1,75,4,1672,85,http://content8.flixster.com/movie/28/69/286922_det.jpg
4427,The Lion in Winter,1968,1012386-lion_in_winter,8,21,20,1,95,0,4,4,0,100,4.1,3596,88,http://content7.flixster.com/movie/11/14/62/11146205_det.jpg
4428,The Misfits,1961,misfits,7.8,13,13,0,100,0,0,0,0,0,0,0,0,http://content6.flixster.com/movie/29/26/292600_det.jpg
4429,Moby Dick,1998,1080898-moby_dick,6.2,6,4,2,66,0,0,0,0,0,0,0,0,http://content7.flixster.com/movie/26/37/263721_det.jpg
4430,Hot Popcorn: Movie Awards Greatest Moments,2005,,\N,\N,\N,\N,\N,\N,\N,\N,\N,\N,\N,\N,\N,\N
4431,Rembrandt,1936,1017391-rembrandt,0,4,3,1,75,0,0,0,0,0,0,0,0,http://content8.flixster.com/movie/10/93/42/10934274_det.jpg
4432,Sweet Smell of Success,1957,sweet_smell_of_success,8.7,41,41,0,100,8.2,7,7,0,100,4.1,1652,91,http://content9.flixster.com/movie/10/85/09/10850983_det.jpg
4433,Written on the Wind,1956,written_on_the_wind,7.4,21,17,4,80,0,1,1,0,100,3.8,927,76,http://content8.flixster.com/movie/10/89/05/10890530_det.jpg
4434,La decima vittima,1965,tenth_victim,0,4,4,0,100,0,0,0,0,0,0,0,0,http://content8.flixster.com/movie/10/89/40/10894082_det.jpg
4435,Oberst Redl,1985,colonel_redl,0,3,3,0,100,0,0,0,0,0,0,0,0,http://content7.flixster.com/movie/10/92/93/10929333_det.jpg
4436,Obsession,1976,1015361-obsession,6,14,11,3,78,0,1,1,0,100,3.3,664,58,http://content6.flixster.com/movie/26/38/263824_det.jpg
4437,Suspiria,1977,1020662-suspiria,7.9,30,28,2,93,0,3,3,0,100,3.9,7987,84,http://content9.flixster.com/movie/10/93/47/10934783_det.jpg
4438,Jing wu men,1972,laugh-track-the-chinese-connection,0,0,0,0,0,0,0,0,0,0,0,0,0,http://content9.flixster.com/movie/10/84/89/10848931_det.jpg
4439,Christiane F. - Wir Kinder vom Bahnhof Zoo,1981,christiane_f,0,4,3,1,75,0,1,1,0,100,3.9,1584,83,http://content9.flixster.com/movie/27/81/278127_det.jpg
4440,Tang shan da xiong,1971,fists_of_fury,5.6,10,6,4,60,0,0,0,0,0,0,0,0,http://content8.flixster.com/movie/10/15/51/10155126_det.jpg
4441,Game of Death,1978,1008085-game_of_death,6,8,6,2,75,0,0,0,0,0,0,0,0,http://content7.flixster.com/movie/11/12/60/11126073_det.jpg
4442,The Last Dragon,1985,the-last-dragon,0,4,0,4,0,0,1,0,1,0,3.9,4398,84,http://content7.flixster.com/movie/11/12/45/11124501_det.jpg
4443,Outland,1981,outland,5.8,22,13,9,59,0,3,2,1,66,0,0,0,http://content8.flixster.com/movie/27/19/271922_det.jpg
4444,Meng long guo jiang,1972,return_of_the_dragon,6.5,8,8,0,100,0,0,0,0,0,0,0,0,http://content8.flixster.com/movie/10/93/76/10937650_det.jpg
4445,T-Rex: Back to the Cretaceous,1998,imax_trex_back_to_the_cretaceous,6.1,19,13,6,68,6.5,7,5,2,71,2.8,304,34,http://content9.flixster.com/movie/30/13/301323_det.jpg
4446,Final Fantasy: The Spirits Within,2001,final_fantasy_the_spirits_within,5.2,141,61,80,43,4.8,28,9,19,32,3,17822,54,http://content6.flixster.com/movie/10/87/74/10877484_det.jpg
4447,Legally Blonde,2001,1155861-blonde,0,1,0,1,0,0,0,0,0,0,0,0,0,http://content9.flixster.com/movie/10/84/93/10849327_det.jpg
4448,The Score,2001,1108799-score,6.5,126,93,33,73,6.1,34,21,13,61,3.3,12417,64,http://content7.flixster.com/movie/10/84/63/10846373_det.jpg
4449,Adanggaman,2000,adanggaman,6.7,10,9,1,90,0,3,3,0,100,3.5,119,55,http://content9.flixster.com/movie/10/84/34/10843403_det.jpg
4450,Bully,2001,bully,5.6,83,42,41,50,4.9,22,9,13,40,3.5,6131,70,http://content6.flixster.com/movie/15/26/77/1526772_det.jpg
4451,Jump Tomorrow,2001,jump_tomorrow,6.6,54,44,10,81,6.9,19,17,2,89,4.1,302,88,http://content9.flixster.com/movie/10/89/33/10893359_det.jpg
4452,Made,2001,made,6.3,107,75,32,70,5.9,31,20,11,64,3.3,3264,66,http://content6.flixster.com/movie/27/01/270100_det.jpg
4453,Michael Jordan to the Max,2000,michael-jordan-to-the-max,6.2,25,16,9,64,4.7,8,1,7,12,3.8,753,78,http://content6.flixster.com/movie/10/94/37/10943796_det.jpg
4454,More,1998,more1998,0,0,0,0,0,0,0,0,0,0,0,0,0,http://content6.flixster.com/movie/93/38/34/9338348_det.jpg
4457,Bianca Beauchamp All Access 2: Rubberized,2008,bianca-beauchamp-all-access-2-rubberized,0,0,0,0,0,0,0,0,0,0,0,0,0,http://content6.flixster.com/movie/10/88/44/10884416_det.jpg
4458,Africa: The Serengeti,1994,imax_africa_the_serengeti,8,5,5,0,100,0,0,0,0,0,0,0,0,http://content8.flixster.com/movie/10/87/38/10873886_det.jpg
4459,Alaska: Spirit of the Wild,1997,imax_alaska_spirit_of_the_world,0,3,3,0,100,0,0,0,0,0,0,0,0,http://content8.flixster.com/movie/11/12/59/11125978_det.jpg
4461,Siegfried & Roy: The Magic Box,1999,1136658-siegfried_and_roy_the_magic_box,6.5,14,10,4,71,0,4,3,1,75,3.2,48,40,http://content8.flixster.com/movie/10/87/29/10872978_det.jpg
4462,18 Again!,1988,18_again,4,7,2,5,28,0,1,0,1,0,2.8,1550,44,http://content7.flixster.com/movie/10/89/20/10892005_det.jpg
4463,Star Trek,1966,,\N,\N,\N,\N,\N,\N,\N,\N,\N,\N,\N,\N,\N,\N
4464,The Accidental Tourist,1988,accidental_tourist,7.1,26,21,5,80,0,2,1,1,50,3.2,1424,57,http://content7.flixster.com/movie/10/37/96/10379653_det.jpg
4465,The Accused,1988,1000224-accused,7.1,19,18,1,94,0,1,1,0,100,3.5,3437,77,http://content7.flixster.com/movie/10/92/01/10920193_det.jpg
4466,Above the Law,1988,above_the_law,5.1,14,8,6,57,0,2,1,1,50,2.8,5280,52,http://content8.flixster.com/movie/27/27/272706_det.jpg
4467,The Adventures of Baron Munchausen,1988,adventures_of_baron_munchausen,7.2,27,24,3,88,0,3,3,0,100,0,0,0,http://content8.flixster.com/movie/11/12/29/11122994_det.jpg
4468,Apartment Zero,1988,apartment_zero,6.9,18,17,1,94,0,4,3,1,75,3.5,629,64,http://content8.flixster.com/movie/23/12/83/2312830_det.jpg
4469,Appointment with Death,1988,appointment_with_death,0,2,0,2,0,0,0,0,0,0,0,0,0,http://content7.flixster.com/movie/10/86/39/10863993_det.jpg
4470,The Little Mermaid: Ariel's Beginning,2008,little_mermaid_ariels_beginning,0,4,2,2,50,0,0,0,0,0,0,0,0,http://content6.flixster.com/movie/11/13/18/11131876_det.jpg
4471,Arthur 2: On the Rocks,1988,arthur_2_on_the_rocks,3.3,13,2,11,15,0,1,0,1,0,2.5,865,33,http://content7.flixster.com/movie/10/36/12/10361217_det.jpg
4472,Bad Dreams,1988,bad_dreams,3.3,8,1,7,12,0,1,0,1,0,3.1,374,46,http://content6.flixster.com/movie/32/99/96/3299960_det.jpg
4473,Bat*21,1988,bat_21,6.1,10,8,2,80,0,2,1,1,50,3.1,1497,51,http://content9.flixster.com/movie/27/04/270495_det.jpg
4474,The Beach,2000,beach,4.4,116,22,94,18,3.9,31,4,27,12,2.9,21479,59,http://content6.flixster.com/movie/10/88/39/10883940_det.jpg
4475,The Beast of War,1988,1001878-beast,0,1,1,0,100,0,0,0,0,0,0,0,0,http://content6.flixster.com/movie/10/91/95/10919500_det.jpg
4476,Big Business,1929,big_business-1929,0,2,2,0,100,0,0,0,0,0,0,0,0,http://content9.flixster.com/movie/10/97/91/10979167_det.jpg
4477,Big Top Pee-wee,1988,big_top_peewee,4.6,19,6,13,31,0,1,0,1,0,2.5,2934,32,http://content9.flixster.com/movie/25/99/259907_det.jpg
4478,Biloxi Blues,1988,biloxi_blues,6,18,13,5,72,0,1,0,1,0,3.1,2051,52,http://content7.flixster.com/movie/10/85/72/10857297_det.jpg
4479,The Birds,1963,1002448-birds,8,40,38,2,95,0,4,2,2,50,3.5,17449,80,http://content8.flixster.com/movie/10/83/82/10838298_det.jpg
4480,The Blob,1988,1002585-blob,5.6,16,9,7,56,0,0,0,0,0,0,0,0,http://content6.flixster.com/movie/27/38/273804_det.jpg
4481,The Boost,1988,boost,5.1,6,3,3,50,0,1,1,0,100,3.2,281,52,http://content8.flixster.com/movie/27/61/276122_det.jpg
4482,"Bright Lights, Big City",1988,1003098-bright_lights_big_city,5.5,18,11,7,61,5.6,5,3,2,60,2.8,1095,37,http://content7.flixster.com/movie/10/88/86/10888617_det.jpg
4483,Caddyshack II,1988,caddyshack_2,1.9,11,0,11,0,0,1,0,1,0,2.4,2756,26,http://content6.flixster.com/movie/26/26/262696_det.jpg
4484,Camille Claudel,1988,camille_claudel,8.3,8,8,0,100,0,1,1,0,100,3.9,1318,85,http://content6.flixster.com/movie/26/92/269224_det.jpg
4485,Casual Sex?,1988,casual_sex,0,3,0,3,0,0,0,0,0,0,0,0,0,http://content9.flixster.com/movie/10/91/49/10914991_det.gif
4486,Clean and Sober,1988,clean_and_sober,5.3,11,6,5,54,0,1,1,0,100,3.2,1014,60,http://content6.flixster.com/movie/27/10/271096_det.jpg
4487,Cocktail,1988,1004420-cocktail,3.7,21,3,18,14,0,2,0,2,0,3,13625,60,http://content9.flixster.com/movie/26/88/268891_det.jpg
4488,Colors,1988,1004485-colors,6.7,28,23,5,82,7.3,6,5,1,83,3.3,5019,66,http://content8.flixster.com/movie/10/87/54/10875478_det.jpg
4489,Coming to America,1988,coming_to_america,5.7,36,23,13,63,2.5,5,0,5,0,3.4,32197,82,http://content7.flixster.com/movie/10/86/72/10867213_det.jpg
4490,The Couch Trip,1988,couch_trip,5.2,7,3,4,42,0,1,0,1,0,2.9,521,40,http://content6.flixster.com/movie/27/94/279404_det.jpg
4491,Criminal Law,1988,criminal_law,4.6,8,3,5,37,0,1,0,1,0,3,410,35,http://content6.flixster.com/movie/54/75/67/5475676_det.gif
4492,Critters,1986,critters,5.2,14,8,6,57,0,1,1,0,100,2.7,6045,43,http://content8.flixster.com/movie/26/10/261026_det.jpg
4493,Critters 2,1988,critters_2_the_main_course,4.4,9,3,6,33,0,1,0,1,0,2.6,2866,38,http://content8.flixster.com/movie/26/18/261894_det.jpg
4494,Critters 3,1991,critters_3,2.8,6,0,6,0,0,0,0,0,0,0,0,0,http://content9.flixster.com/movie/26/66/266695_det.jpg
4495,Crossing Delancey,1988,crossing_delancey,6.9,20,17,3,85,0,1,0,1,0,3.6,495,75,http://content6.flixster.com/movie/10/89/81/10898124_det.jpg
4496,DOA: Dead or Alive,2006,doa_dead_or_alive,4.5,44,15,29,34,4.2,10,2,8,20,2.7,71044,43,http://content7.flixster.com/movie/10/93/50/10935009_det.jpg
4497,Dead Heat,1988,1005399-dead_heat,0,3,1,2,33,0,0,0,0,0,0,0,0,http://content7.flixster.com/movie/27/42/274209_det.jpg
4498,The Dead Pool,1988,dead_pool,5.6,26,14,12,53,0,1,1,0,100,3.2,4365,49,http://content6.flixster.com/movie/10/88/91/10889184_det.jpg
4499,Dirty Rotten Scoundrels,1988,dirty_rotten_scoundrels,6.9,31,27,4,87,0,4,4,0,100,3.4,7136,78,http://content8.flixster.com/movie/26/56/265606_det.jpg
4500,Drowning by Numbers,1988,drowning-by-numbers,7.1,11,10,1,90,0,1,0,1,0,4.2,1008,91,http://content6.flixster.com/movie/51/26/18/5126188_det.jpg
4501,"Elvira, Mistress of the Dark",1988,elvira_mistress_of_the_dark,4.3,9,3,6,33,0,0,0,0,0,0,0,0,http://content6.flixster.com/movie/25/49/254996_det.jpg
4502,Ernest Saves Christmas,1988,ernest_saves_christmas,4.7,13,5,8,38,0,0,0,0,0,0,0,0,http://content7.flixster.com/movie/25/55/255517_det.jpg
4503,Everybody's All-American,1988,everybodys_allamerican,4.8,10,3,7,30,0,1,0,1,0,3.1,505,45,http://content9.flixster.com/movie/10/92/15/10921511_det.jpg
4504,Feds,1988,1007195-feds,4.3,5,1,4,20,0,1,1,0,100,3,269,50,http://content6.flixster.com/movie/36/61/76/3661768_det.jpg
4505,For Keeps?,1988,for_keeps,4.3,9,2,7,22,0,1,1,0,100,3.4,2404,64,http://content8.flixster.com/movie/10/84/53/10845358_det.jpg
4506,Frantic,1988,1007832-frantic,6.4,39,30,9,76,5.6,5,3,2,60,3.2,4749,56,http://content9.flixster.com/movie/27/46/274691_det.jpg
4507,Fresh Horses,1988,fresh_horses,3.6,6,0,6,0,0,0,0,0,0,0,0,0,http://content9.flixster.com/movie/10/84/05/10840563_det.jpg
4508,Gorillas in the Mist: The Story of Dian Fossey,1988,gorillas_in_the_mist,6.8,17,14,3,82,0,2,2,0,100,3.3,3826,72,http://content6.flixster.com/movie/10/93/48/10934816_det.jpg
4509,The Great Outdoors,1988,great_outdoors,4.2,13,5,8,38,0,0,0,0,0,0,0,0,http://content8.flixster.com/movie/25/62/256206_det.jpg
4510,Heartbreak Hotel,2006,10010193-heartbreak_hotel,0,1,1,0,100,0,0,0,0,0,0,0,0,http://content6.flixster.com/movie/10/87/04/10870488_det.jpg
4511,High Spirits,1988,high_spirits,3.4,11,2,9,18,0,0,0,0,0,0,0,0,http://content6.flixster.com/movie/25/60/256092_det.jpg
4512,Hot to Trot,1988,hot_to_trot,2.3,6,0,6,0,0,0,0,0,0,0,0,0,http://content9.flixster.com/movie/21/55/23/2155235_det.jpg
4513,The House on Carroll Street,1988,house_on_carroll_street,5.6,6,4,2,66,0,1,1,0,100,2.9,262,21,http://content6.flixster.com/movie/26/56/265624_det.jpg
4514,Howling IV: The Original Nightmare,1988,howling_iv_the_original_nightmare,0,0,0,0,0,0,0,0,0,0,0,0,0,http://content7.flixster.com/movie/10/87/88/10878801_det.jpg
4515,Imagine: John Lennon,1988,,7.4,13,12,1,92,0,1,1,0,100,4,1149,88,http://content6.flixster.com/movie/10/92/69/10926972_det.jpg
4516,Johnny Be Good,1988,johnny_be_good,2.3,11,0,11,0,0,3,0,3,0,2.6,1294,27,http://content7.flixster.com/movie/28/09/280909_det.jpg
4517,Lady in White,1988,lady_in_white,6.2,11,8,3,72,0,1,1,0,100,3.5,1031,70,http://content6.flixster.com/movie/26/06/260600_det.jpg
4518,The Lair of the White Worm,1988,lair_of_the_white_worm,5.5,21,12,9,57,0,1,0,1,0,2.9,1348,43,http://content8.flixster.com/movie/28/43/284306_det.jpg
4519,The Land Before Time,1988,land_before_time,5.9,14,10,4,71,0,1,1,0,100,3.3,18763,69,http://content8.flixster.com/movie/25/35/253518_det.jpg
4520,License to Drive,1988,license_to_drive,3.2,17,3,14,17,0,3,0,3,0,3,3880,61,http://content9.flixster.com/movie/25/48/254891_det.jpg
4521,Little Nikita,1988,little_nikita,5.7,7,6,1,85,0,1,0,1,0,3.1,1024,47,http://content7.flixster.com/movie/26/36/263609_det.jpg
4522,Masquerade,1988,1013488-masquerade,5.1,14,6,8,42,0,1,1,0,100,3.1,407,41,http://content7.flixster.com/movie/10/82/95/10829585_det.jpg
4523,The Milagro Beanfield War,1988,milagro_beanfield_war,5.9,27,16,11,59,5.9,6,3,3,50,3.6,855,72,http://content7.flixster.com/movie/26/74/267493_det.jpg
4524,Moon Over Parador,1988,moon_over_parador,4.8,12,5,7,41,0,1,0,1,0,2.9,529,39,http://content6.flixster.com/movie/26/12/261208_det.jpg
4525,Moving,1988,1014316-moving,0,3,1,2,33,0,0,0,0,0,0,0,0,http://content8.flixster.com/movie/24/53/52/2453526_det.jpg
4526,My Stepmother Is an Alien,1988,my_stepmother_is_an_alien,3.6,15,2,13,13,0,1,0,1,0,2.5,3796,32,http://content7.flixster.com/movie/10/95/40/10954029_det.jpg
4527,A Night in the Life of Jimmy Reardon,1988,night_in_the_life_of_jimmy_reardon,4.8,5,2,3,40,0,0,0,0,0,0,0,0,http://content7.flixster.com/movie/10/87/89/10878965_det.jpg
4528,Off Limits,1988,off_limits,4.9,8,4,4,50,0,1,0,1,0,3,458,31,http://content8.flixster.com/movie/27/91/279106_det.jpg
4529,Out of Rosenheim,1987,bagdad_cafe,6.7,16,14,2,87,0,2,1,1,50,4,2378,88,http://content6.flixster.com/movie/25/67/256708_det.jpg
4530,Permanent Record,1988,permanent_record,6.7,8,6,2,75,0,1,1,0,100,3.4,779,65,http://content6.flixster.com/movie/10/90/46/10904672_det.jpg
4531,Red Heat,1988,1017328-red_heat,5.3,15,8,7,53,0,1,1,0,100,2.7,4602,38,http://content9.flixster.com/movie/10/88/47/10884739_det.jpg
4532,Return of the Living Dead Part II,1988,return_of_the_living_dead_2,3.3,13,0,13,0,0,1,0,1,0,2.9,4031,47,http://content8.flixster.com/movie/55/37/50/5537506_det.jpg
4533,The Return of the Living Dead,1985,return_of_the_living_dead,7,26,23,3,88,0,1,1,0,100,3.3,10213,71,http://content6.flixster.com/movie/26/87/268716_det.jpg
4534,The Man from Snowy River II,1988,suitors,0,1,0,1,0,0,0,0,0,0,0,0,0,http://content6.flixster.com/movie/10/96/92/10969228_det.jpg
4535,The Man from Snowy River,1982,man_from_snowy_river,6.5,10,8,2,80,0,1,0,1,0,3.7,3791,85,http://content8.flixster.com/movie/11/13/37/11133714_det.jpg
4536,Rocket Gibraltar,1988,rocket_gibraltar,0,2,1,1,50,0,0,0,0,0,0,0,0,http://content7.flixster.com/movie/26/12/261221_det.jpg
4537,Running on Empty,1988,running_on_empty,6.9,11,9,2,81,0,2,1,1,50,3.8,1817,84,http://content7.flixster.com/movie/26/15/261525_det.jpg
4538,Salome's Last Dance,1988,salomes_last_dance,5.8,6,3,3,50,0,1,0,1,0,3.9,233,81,http://content9.flixster.com/movie/86/23/15/8623151_det.jpg
4539,Salsa,2000,salsa-2000,0,0,0,0,0,0,0,0,0,0,0,0,0,http://content7.flixster.com/movie/51/30/93/5130933_det.jpg
4540,Satisfaction,2007,,\N,\N,\N,\N,\N,\N,\N,\N,\N,\N,\N,\N,\N,\N
4541,The Serpent and the Rainbow,1988,the-rainbow-the-widowing-of-mrs-holroyd,0,0,0,0,0,0,0,0,0,0,0,0,0,http://content6.flixster.com/movie/10/85/15/10851584_det.jpg
4542,Shakedown,1988,1018704-shakedown,0,1,1,0,100,0,1,1,0,100,2.9,382,32,http://content6.flixster.com/movie/28/31/283120_det.jpg
4543,Shoot to Kill,1988,1018880-shoot_to_kill,7.1,11,11,0,100,0,1,1,0,100,3.2,950,57,http://content6.flixster.com/movie/10/88/55/10885520_det.jpg
4544,Short Circuit,1986,1018891-short_circuit,4.8,20,10,10,50,0,1,0,1,0,3.2,12589,66,http://content6.flixster.com/movie/26/51/265100_det.jpg
4545,Short Circuit,1986,1018891-short_circuit,4.8,20,10,10,50,0,1,0,1,0,3.2,12589,66,http://content6.flixster.com/movie/26/51/265100_det.jpg
4546,Spoorloos,1988,1036630-vanishing,8.4,33,33,0,100,0,4,4,0,100,4,2421,87,http://content8.flixster.com/movie/31/11/311198_det.jpg
4547,Stormy Monday,1988,stormy_monday,6.6,9,8,1,88,0,1,1,0,100,3.1,420,41,http://content9.flixster.com/movie/10/88/73/10887327_det.jpg
4548,Before Sunset,2004,before_sunset,8.3,158,150,8,94,8.4,39,38,1,97,4,20750,90,http://content8.flixster.com/movie/59/94/32/5994322_det.jpg
4549,Sweet Hearts Dance,1988,sweet_hearts_dance,5.5,10,5,5,50,0,1,0,1,0,3.2,431,45,http://content7.flixster.com/movie/27/92/279293_det.jpg
4550,Switching Channels,1988,switching_channels,5.3,9,5,4,55,0,1,1,0,100,2.9,314,31,http://content7.flixster.com/movie/41/82/79/4182797_det.jpg
4551,The Telephone,1988,telephone,0,0,0,0,0,0,0,0,0,0,0,0,0,http://content7.flixster.com/movie/63/89/82/6389825_det.jpg
4552,Tetsuo,1989,tetsuo-the-ironman,7.2,12,9,3,75,0,0,0,0,0,0,0,0,http://content8.flixster.com/movie/10/89/35/10893582_det.jpg
4553,They Live,1988,they_live,7,33,29,4,87,0,4,2,2,50,3.5,7637,77,http://content8.flixster.com/movie/28/06/280698_det.jpg
4554,To Kill a Priest,1988,to_kill_a_priest,0,4,3,1,75,0,1,0,1,0,3.5,191,68,http://content9.flixster.com/movie/11/12/75/11127503_det.jpg
4555,Torch Song Trilogy,1988,torch_song_trilogy,6.1,13,7,6,53,0,2,2,0,100,4,1240,89,http://content8.flixster.com/movie/10/92/90/10929066_det.jpg
4556,Track 29,1988,track_29,6.4,6,4,2,66,0,2,1,1,50,3.2,444,49,http://content6.flixster.com/movie/10/87/17/10871772_det.jpg
4557,Tucker: The Man and His Dream,1988,tucker_the_man_and_his_dream,7.2,35,30,5,85,6.8,7,5,2,71,3.2,1497,58,http://content7.flixster.com/movie/25/57/255709_det.jpg
4558,Twins,1988,1022191-twins,4.7,27,9,18,33,0,4,3,1,75,2.7,10066,41,http://content6.flixster.com/movie/10/88/47/10884784_det.jpg
4559,Vice Versa,1988,1022570-vice_versa,5,13,6,7,46,0,1,1,0,100,2.8,1418,40,http://content8.flixster.com/movie/59/54/54/5954546_det.jpg
4560,The Watcher,2000,watcher,3.4,87,9,78,10,3.3,25,2,23,8,2.7,3820,36,http://content7.flixster.com/movie/27/40/274005_det.jpg
4561,Waxwork,1988,waxwork,4.7,9,5,4,55,0,0,0,0,0,0,0,0,http://content7.flixster.com/movie/17/87/69/1787697_det.jpg
4562,Without a Clue,1988,without_a_clue,5.2,9,5,4,55,0,1,0,1,0,3.4,1126,68,http://content7.flixster.com/movie/25/76/257621_det.jpg
4563,Young Einstein,1988,young_einstein,3,17,3,14,17,0,1,0,1,0,2.6,1565,44,http://content9.flixster.com/movie/10/91/91/10919175_det.jpg
4564,The First $20 Million Is Always the Hardest,2002,first_20_million_is_always_the_hardest,2.4,9,1,8,11,0,2,0,2,0,3.2,483,50,http://content6.flixster.com/movie/26/67/266724_det.jpg
4565,American Ninja,1985,american_ninja,2.6,5,0,5,0,0,0,0,0,0,0,0,0,http://content7.flixster.com/movie/27/38/273813_det.jpg
4566,American Ninja 2: The Confrontation,1987,american_ninja_2_the_confrontation,0,0,0,0,0,0,0,0,0,0,0,0,0,http://content8.flixster.com/movie/10/92/83/10928366_det.jpg
4567,American Ninja 3: Blood Hunt,1989,american-ninja-3-blood-hunt,0,0,0,0,0,0,0,0,0,0,0,0,0,http://content9.flixster.com/movie/56/49/11/5649115_det.jpg
4568,Best of the Best,1989,1002142-best_of_the_best,0,4,2,2,50,0,1,0,1,0,3.2,4991,62,http://content8.flixster.com/movie/31/03/40/3103406_det.jpg
4569,Best of the Best 2,1993,best_of_the_best_2,3,9,1,8,11,0,1,0,1,0,2.9,1415,46,http://content6.flixster.com/movie/31/03/40/3103408_det.jpg
4570,Movie Critters' Big Picture,2003,,\N,\N,\N,\N,\N,\N,\N,\N,\N,\N,\N,\N,\N,\N
4571,Bill & Ted's Excellent Adventure,1989,bill_and_teds_excellent_adventure,6.3,32,26,6,81,0,3,1,2,33,3.3,30577,70,http://content6.flixster.com/movie/10/88/19/10881968_det.jpg
4572,Black Rain,1989,1002512-black_rain,5.4,21,12,9,57,0,1,0,1,0,0,0,0,http://content7.flixster.com/movie/20/77/72/2077725_det.jpg
4573,Blaze,1989,blaze,6.3,10,8,2,80,0,1,1,0,100,2.9,402,40,http://content7.flixster.com/movie/10/89/14/10891433_det.jpg
4574,Blind Fury,1989,blind_fury,4.8,10,6,4,60,0,1,0,1,0,3.1,1813,52,http://content6.flixster.com/movie/27/47/274720_det.jpg
4575,The Hunting Party,2007,1183674-hunting_party,6,89,47,42,52,5.8,26,12,14,46,3.4,13820,67,http://content7.flixster.com/movie/95/64/82/9564825_det.jpg
4576,C.H.U.D. II - Bud the Chud,1989,chud_2,0,0,0,0,0,0,0,0,0,0,0,0,0,http://content8.flixster.com/movie/10/91/74/10917490_det.jpg
4577,Casualties of War,1989,casualties_of_war,7.2,30,25,5,83,0,2,1,1,50,3.4,4154,70,http://content6.flixster.com/movie/10/90/66/10906684_det.jpg
4578,Chances Are,1989,chances_are,5.6,25,15,10,60,4.6,6,2,4,33,3.4,2184,66,http://content6.flixster.com/movie/25/71/257108_det.jpg
4579,Cookie's Fortune,1999,,7.5,55,47,8,85,7.4,12,11,1,91,3.2,1364,57,http://content7.flixster.com/movie/26/33/263325_det.jpg
4580,Cyborg,1989,cyborg,2.9,14,2,12,14,0,3,0,3,0,2.5,3775,35,http://content6.flixster.com/movie/27/42/274212_det.jpg
4581,Getting Even with Dad,1994,getting_even_with_dad,3.3,12,1,11,8,0,3,0,3,0,2.4,2200,29,http://content7.flixster.com/movie/10/92/22/10922209_det.jpg
4582,Dead Bang,1989,dead_bang,4.4,10,3,7,30,0,0,0,0,0,0,0,0,http://content6.flixster.com/movie/28/03/280300_det.jpg
4583,Disorganized Crime,1989,disorganized_crime,5.3,6,3,3,50,0,0,0,0,0,0,0,0,http://content8.flixster.com/movie/10/88/47/10884738_det.jpg
4584,Dream a Little Dream,1989,dream_a_little_dream,3,9,0,9,0,0,3,0,3,0,3.3,2148,67,http://content6.flixster.com/movie/10/92/30/10923008_det.jpg
4585,The Dream Team,1989,1006287-dream_team,5.2,13,7,6,53,0,1,0,1,0,3.1,1533,60,http://content6.flixster.com/movie/10/84/05/10840560_det.jpg
4586,A Dry White Season,1989,dry_white_season,6.4,11,10,1,90,0,1,1,0,100,0,0,0,http://content9.flixster.com/movie/26/84/268419_det.jpg
4587,Earth Girls Are Easy,1988,earth_girls_are_easy,5.5,32,20,12,62,6.8,7,6,1,85,2.6,5342,40,http://content9.flixster.com/movie/26/62/266219_det.jpg
4588,Eddie and the Cruisers II: Eddie Lives!,1989,eddie_and_the_cruisers_2_eddie_lives,0,0,0,0,0,0,0,0,0,0,0,0,0,http://content6.flixster.com/movie/25/74/52/2574524_det.jpg
4589,Eddie and the Cruisers,1983,eddie_and_the_cruisers,5.6,8,3,5,37,0,1,0,1,0,3.5,2405,71,http://content9.flixster.com/movie/25/59/255919_det.jpg
4590,Enemies: A Love Story,1989,,6.8,11,10,1,90,0,1,1,0,100,3.2,346,51,http://content9.flixster.com/movie/28/24/282423_det.jpg
4591,Erik the Viking,1989,1006690-erik_the_viking,4,10,3,7,30,0,1,0,1,0,3.2,1894,59,http://content7.flixster.com/movie/10/89/82/10898297_det.jpg
4592,The Experts,1989,experts,0,0,0,0,0,0,0,0,0,0,0,0,0,http://content7.flixster.com/movie/10/83/97/10839773_det.jpg
4593,Family Business,1989,family_business,5.1,15,6,9,40,0,1,1,0,100,2.8,1601,28,http://content6.flixster.com/movie/27/65/276512_det.jpg
4594,Farewell to the King,1989,farewell_to_the_king,5.5,11,6,5,54,0,1,1,0,100,3.2,415,53,http://content7.flixster.com/movie/10/90/60/10906001_det.jpg
4595,Fat Man and Little Boy,1989,fat_man_and_little_boy,5.2,17,9,8,52,0,3,1,2,33,3.1,908,44,http://content7.flixster.com/movie/10/91/68/10916849_det.jpg
4596,The Girl in a Swing,1988,girl_in_a_swing,0,3,1,2,33,0,1,0,1,0,2.4,61,25,http://content8.flixster.com/movie/10/83/96/10839682_det.jpg
4597,Gleaming the Cube,1989,gleaming_the_cube,4.2,8,2,6,25,0,0,0,0,0,0,0,0,http://content7.flixster.com/movie/25/83/258325_det.jpg
4598,Going Overboard,1989,going_overboard,0,3,0,3,0,0,0,0,0,0,0,0,0,http://content9.flixster.com/movie/27/70/277011_det.jpg
4599,Great Balls of Fire!,1989,great_balls_of_fire,5.8,24,15,9,62,0,2,0,2,0,3,3034,52,http://content7.flixster.com/movie/25/95/259513_det.jpg
4600,Gross Anatomy,1989,gross_anatomy,4.6,10,3,7,30,0,1,1,0,100,2.9,620,43,http://content9.flixster.com/movie/26/24/262427_det.jpg
4601,Chun gwong cha sit,1997,1083093-happy_together,7.1,31,24,7,77,7.1,9,7,2,77,4.1,4907,90,http://content8.flixster.com/movie/10/88/85/10888530_det.jpg
4602,Harlem Nights,1989,harlem_nights,3.8,14,3,11,21,0,3,0,3,0,3.3,5383,78,http://content9.flixster.com/movie/10/79/90/10799015_det.jpg
4603,Her Alibi,1989,her_alibi,3.8,13,2,11,15,0,1,0,1,0,2.7,795,37,http://content7.flixster.com/movie/10/87/73/10877353_det.jpg
4604,Homer and Eddie,1989,homer_and_eddie,2.3,7,0,7,0,0,0,0,0,0,0,0,0,http://content9.flixster.com/movie/10/21/38/10213867_det.jpg
4605,How to Get Ahead in Advertising,1989,how_to_get_ahead_in_advertising,6.3,14,8,6,57,0,1,0,1,0,3.7,1015,78,http://content8.flixster.com/movie/28/36/283626_det.jpg
4606,Immediate Family,1989,immediate_family,5,10,6,4,60,0,1,0,1,0,3.4,323,59,http://content8.flixster.com/movie/26/55/265522_det.jpg
4607,North Country,2005,north_country,6.7,166,114,52,68,6.8,38,26,12,68,3.5,14739,72,http://content8.flixster.com/movie/25/03/250394_det.jpg
4608,An Innocent Man,1989,innocent_man,4.8,7,2,5,28,0,1,0,1,0,2.9,1267,42,http://content6.flixster.com/movie/27/34/273400_det.jpg
4609,Jacknife,1989,jacknife,6,13,9,4,69,0,1,1,0,100,3.2,827,45,http://content9.flixster.com/movie/34/83/38/3483387_det.jpg
4610,The January Man,1989,january_man,3.8,14,3,11,21,0,1,0,1,0,2.8,957,31,http://content9.flixster.com/movie/27/77/277795_det.jpg
4611,Johnny Handsome,1989,johnny_handsome,6.2,13,8,5,61,0,1,1,0,100,3,857,42,http://content7.flixster.com/movie/10/87/85/10878513_det.jpg
4612,J√©sus de Montr√©al,1989,jesus_of_montreal,7.4,13,11,2,84,0,2,1,1,50,3.9,1256,85,http://content7.flixster.com/movie/10/87/67/10876753_det.jpg
4613,K-9,1989,k9,4.1,8,2,6,25,0,1,0,1,0,2.7,4457,46,http://content9.flixster.com/movie/26/61/266103_det.jpg
4614,Kickboxer,1989,1011487-kickboxer,0,4,2,2,50,0,0,0,0,0,0,0,0,http://content9.flixster.com/movie/11/14/33/11143319_det.jpg
4615,Last Exit to Brooklyn,1989,last_exit_to_brooklyn,6.6,13,10,3,76,0,2,1,1,50,3.6,623,73,http://content6.flixster.com/movie/66/25/52/6625528_det.jpg
4616,Lean on Me,1989,lean_on_me,5.8,14,9,5,64,0,1,0,1,0,3.7,5235,86,http://content6.flixster.com/movie/25/68/256820_det.jpg
4617,Let It Ride,1989,let_it_ride,5,10,3,7,30,0,0,0,0,0,0,0,0,http://content7.flixster.com/movie/25/73/257393_det.jpg
4618,Leviathan,1989,leviathan,4,19,2,17,10,0,2,0,2,0,2.7,1532,31,http://content7.flixster.com/movie/27/54/275409_det.jpg
4619,Little Monsters,1989,little_monsters,0,3,1,2,33,0,0,0,0,0,0,0,0,http://content8.flixster.com/movie/10/88/17/10881798_det.jpg
4620,Lock Up,1989,1012605-lock_up,4.3,10,2,8,20,0,0,0,0,0,0,0,0,http://content9.flixster.com/movie/27/48/274827_det.jpg
4621,Look Who's Talking,1989,look_whos_talking,5,33,19,14,57,3.9,7,2,5,28,2.9,13369,53,http://content6.flixster.com/movie/10/90/05/10900528_det.jpg
4622,Loverboy,2005,loverboy_2004,4.1,34,6,28,17,4.6,12,3,9,25,2.7,12704,32,http://content8.flixster.com/movie/10/37/58/1037586_det.jpg
4623,Major League,1989,major_league,6.6,31,26,5,83,0,4,2,2,50,3.3,13020,78,http://content7.flixster.com/movie/26/77/267709_det.jpg
4624,Meet the Feebles,1990,meet_the_feebles,6.6,20,15,5,75,0,1,0,1,0,3.5,3519,71,http://content8.flixster.com/movie/27/90/279010_det.jpg
4625,Millennium,1996,,\N,\N,\N,\N,\N,\N,\N,\N,\N,\N,\N,\N,\N,\N
4626,Miracle Mile,1988,miracle_mile,6.7,21,18,3,85,0,1,1,0,100,3.5,1088,70,http://content8.flixster.com/movie/10/89/50/10895018_det.jpg
4627,Miss Firecracker,1989,miss_firecracker,6,9,6,3,66,0,1,1,0,100,3.2,403,49,http://content7.flixster.com/movie/10/89/26/10892697_det.jpg
4628,New York Stories,1989,new_york_stories,6.1,23,17,6,73,6.4,5,3,2,60,3.4,3295,57,http://content6.flixster.com/movie/26/11/261108_det.jpg
4629,Next of Kin,1989,1014946-next_of_kin,4.6,7,3,4,42,0,0,0,0,0,0,0,0,http://content9.flixster.com/movie/27/52/275299_det.jpg
4630,No Holds Barred,1989,no_holds_barred,1.7,8,0,8,0,0,0,0,0,0,0,0,0,http://content7.flixster.com/movie/48/11/481125_det.jpg
4631,Old Gringo,1989,old_gringo,5.1,11,5,6,45,0,1,0,1,0,3.1,298,42,http://content6.flixster.com/movie/27/68/276800_det.jpg
4632,The Package,1989,package,5.3,14,9,5,64,0,2,2,0,100,3.2,849,45,http://content8.flixster.com/movie/10/93/12/10931258_det.gif
4633,Meet the Parents,2000,meet_the_parents,6.9,140,118,22,84,7.1,35,29,6,82,3.6,119331,79,http://content9.flixster.com/movie/10/80/18/10801895_det.jpg
4634,Penn & Teller Get Killed,1989,penn_and_teller_get_killed,4.6,7,1,6,14,0,0,0,0,0,0,0,0,http://content8.flixster.com/movie/95/99/13/9599138_det.jpg
4635,Pink Cadillac,1989,pink_cadillac,3.9,18,3,15,16,4.4,5,2,3,40,2.8,2125,30,http://content9.flixster.com/movie/10/88/96/10889695_det.jpg
4636,Punisher: War Zone,2008,punisher_war_zone,4.2,96,25,71,26,3.7,21,1,20,4,3,29393,47,http://content6.flixster.com/movie/10/88/11/10881196_det.jpg
4637,Red Scorpion,1989,red_scorpion,3.3,9,1,8,11,0,3,0,3,0,0,0,0,http://content7.flixster.com/movie/10/87/20/10872009_det.jpg
4638,Jurassic Park III,2001,,5.2,153,75,78,49,4.1,31,9,22,29,3,38571,47,http://content7.flixster.com/movie/25/58/255893_det.jpg
4639,America's Sweethearts,2001,americas_sweethearts,4.6,142,45,97,31,4,37,7,30,18,2.8,17330,43,http://content9.flixster.com/movie/50/54/39/5054399_det.jpg
4640,"O Brother, Where Art Thou?",2000,o_brother_where_art_thou,7.1,143,109,34,76,6.6,35,24,11,68,3.7,35122,87,http://content7.flixster.com/movie/97/83/14/9783145_det.jpg
4641,Ghost World,2001,ghost_world,7.8,148,136,12,91,8,33,32,1,96,3.6,20727,81,http://content8.flixster.com/movie/26/95/269506_det.jpg
4642,Hedwig and the Angry Inch,2001,hedwig_and_the_angry_inch,7.8,103,95,8,92,7.7,30,27,3,90,4.1,11932,91,http://content8.flixster.com/movie/26/77/267702_det.jpg
4643,Planet of the Apes,1968,1016397-planet_of_the_apes,7.4,44,39,5,88,5.5,5,3,2,60,3.4,12844,80,http://content7.flixster.com/movie/11/14/82/11148265_det.jpg
4644,Pane e tulipani,2000,bread_and_tulips,6.3,62,44,18,70,6.3,22,17,5,77,3.9,1393,85,http://content9.flixster.com/movie/25/60/256003_det.jpg
4645,The Cure,1995,1061860-cure,5.5,10,4,6,40,0,4,1,3,25,3.7,2207,79,http://content9.flixster.com/movie/10/86/12/10861271_det.jpg
4646,Greenfingers,2000,greenfingers,5.2,67,31,36,46,4.6,25,9,16,36,3.5,1333,68,http://content6.flixster.com/movie/27/35/273512_det.jpg
4649,Wet Hot American Summer,2001,wet_hot_american_summer,4.3,63,19,44,30,3.7,20,3,17,15,3.7,7016,85,http://content6.flixster.com/movie/10/89/50/10895024_det.jpg
4650,Relentless,1989,relentless,0,4,1,3,25,0,0,0,0,0,0,0,0,http://content8.flixster.com/movie/10/93/72/10937266_det.jpg
4651,Blueberry,2004,blueberry,4.2,7,2,5,28,0,0,0,0,0,0,0,0,http://content8.flixster.com/movie/10/86/10/10861006_det.jpg
4652,The Return of Swamp Thing,1989,return_of_swamp_thing,0,4,2,2,50,0,0,0,0,0,0,0,0,http://content8.flixster.com/movie/31/93/46/3193466_det.jpg
4653,The Return of the Musketeers,1989,the-return-of-the-musketeers,5.6,5,3,2,60,0,0,0,0,0,0,0,0,http://content6.flixster.com/movie/32/92/98/3292988_det.jpg
4654,Road House,1989,1017666-road_house,5.2,27,12,15,44,3.6,5,0,5,0,3.2,10370,68,http://content7.flixster.com/movie/26/87/268701_det.jpg
4655,Romero,1989,romero,7.3,8,6,2,75,0,1,0,1,0,3.8,512,79,http://content9.flixster.com/movie/26/08/260819_det.jpg
4656,Rosalie Goes Shopping,1989,rosalie_goes_shopping,6.1,7,5,2,71,0,2,1,1,50,3.6,136,64,http://content7.flixster.com/movie/11/12/80/11128097_det.jpg
4657,Rude Awakening,1998,,\N,\N,\N,\N,\N,\N,\N,\N,\N,\N,\N,\N,\N,\N
4658,Santa sangre,1989,santa_sangre,6.8,18,14,4,77,6.6,5,4,1,80,4.1,2145,88,http://content8.flixster.com/movie/32/88/53/3288534_det.jpg
4659,Notes on a Scandal,2006,notes_on_a_scandal,7.5,167,145,22,86,8,36,33,3,91,3.7,22200,81,http://content7.flixster.com/movie/11/15/27/11152769_det.jpg
4660,Scenes from the Class Struggle in Beverly Hills,1989,scenes_from_the_class_struggle_in_beverly_hills,5.8,5,4,1,80,0,1,0,1,0,3,268,38,http://content8.flixster.com/movie/10/88/97/10889766_det.jpg
4661,Sea of Love,1989,sea_of_love,7,19,16,3,84,0,1,1,0,100,3.3,3334,62,http://content9.flixster.com/movie/28/32/283295_det.jpg
4662,"See No Evil, Hear No Evil",1989,see_no_evil_hear_no_evil,3.4,11,2,9,18,0,1,0,1,0,3.3,6015,72,http://content8.flixster.com/movie/26/93/269306_det.jpg
4663,She's Out of Control,1989,shes_out_of_control,3,16,1,15,6,0,4,0,4,0,2.8,915,46,http://content9.flixster.com/movie/25/84/258407_det.jpg
4664,Shirley Valentine,1989,shirley_valentine,6.3,11,8,3,72,0,2,0,2,0,3.8,1235,85,http://content6.flixster.com/movie/10/88/20/10882056_det.jpg
4665,Shocker,1989,shocker,3.4,12,1,11,8,0,0,0,0,0,0,0,0,http://content8.flixster.com/movie/27/95/279506_det.jpg
4666,Skin Deep,1989,1019128-skin_deep,4.8,12,5,7,41,0,1,1,0,100,3,517,49,http://content8.flixster.com/movie/11/14/83/11148326_det.jpg
4667,Slaves of New York,1989,slaves_of_new_york,2.9,8,1,7,12,0,1,0,1,0,3.2,287,58,http://content8.flixster.com/movie/27/90/279018_det.jpg
4668,Some Girls,1988,some_girls,0,1,0,1,0,0,0,0,0,0,0,0,0,http://content6.flixster.com/movie/11/12/75/11127520_det.jpg
4669,Stepfather II,1989,,\N,\N,\N,\N,\N,\N,\N,\N,\N,\N,\N,\N,\N,\N
4670,The Stepfather,1987,stepfather,6.5,26,22,4,84,6.6,5,3,2,60,3.4,1144,64,http://content6.flixster.com/movie/42/62/40/4262408_det.jpg
4671,Sweetie,1989,sweetie,7.1,12,11,1,91,0,1,1,0,100,3.6,538,72,http://content7.flixster.com/movie/95/83/77/9583777_det.jpg
4672,The Tall Guy,1989,,6.7,12,10,2,83,0,2,2,0,100,3.1,901,55,http://content7.flixster.com/movie/27/89/278905_det.jpg
4673,Tango & Cash,1989,tango_and_cash,4.3,33,13,20,39,0,3,0,3,0,3,9072,54,http://content7.flixster.com/movie/27/22/272293_det.jpg
4674,This Is Spinal Tap,1984,this_is_spinal_tap,8.6,53,51,2,96,7.7,7,6,1,85,3.9,23608,91,http://content9.flixster.com/movie/28/14/281499_det.jpg
4675,Three Fugitives,1989,three_fugitives,3.9,13,2,11,15,0,0,0,0,0,0,0,0,http://content8.flixster.com/movie/25/98/259898_det.jpg
4676,Troop Beverly Hills,1989,troop_beverly_hills,3.2,12,1,11,8,0,2,0,2,0,2.6,2799,53,http://content7.flixster.com/movie/25/48/254813_det.jpg
4677,Turner & Hooch,1989,turner_and_hooch,5.2,21,13,8,61,0,0,0,0,0,0,0,0,http://content6.flixster.com/movie/25/66/256616_det.jpg
4678,UHF,1989,uhf,5.5,22,12,10,54,0,1,0,1,0,3.2,7472,73,http://content9.flixster.com/movie/25/61/256195_det.jpg
4679,Uncle Buck,1989,uncle_buck,5.8,17,9,8,52,0,1,0,1,0,3.2,13669,72,http://content6.flixster.com/movie/10/87/45/10874592_det.jpg
4680,Vampire's Kiss,1988,vampires_kiss,5.9,21,13,8,61,3.8,5,1,4,20,2.9,2172,48,http://content9.flixster.com/movie/10/89/22/10892243_det.jpg
4681,The War of the Roses,1989,war_of_the_roses,7,37,30,7,81,5.8,8,5,3,62,3.2,5702,64,http://content8.flixster.com/movie/26/89/268906_det.jpg
4682,Warlock,1989,warlock,5.3,15,8,7,53,0,1,0,1,0,3.1,2153,53,http://content7.flixster.com/movie/10/88/01/10880193_det.jpg
4683,The Wizard,1989,wizard,4.3,17,4,13,23,0,3,0,3,0,3.1,3783,60,http://content6.flixster.com/movie/10/92/08/10920824_det.jpg
4684,Worth Winning,1989,worth_winning,0,4,0,4,0,0,0,0,0,0,0,0,0,http://content6.flixster.com/movie/26/14/261428_det.jpg
4685,Warlock: The Armageddon,1993,warlock_the_armageddon,0,4,0,4,0,0,0,0,0,0,0,0,0,http://content6.flixster.com/movie/10/93/34/10933432_det.jpg
4686,Weekend at Bernie's II,1993,weekend_at_bernies_ii,2.5,28,3,25,10,3.7,5,2,3,40,0,0,0,http://content7.flixster.com/movie/25/66/256697_det.jpg
4687,Billy Liar,1963,billy_liar,7.6,9,9,0,100,0,1,1,0,100,4,754,82,http://content6.flixster.com/movie/10/04/18/10041868_det.jpg
4688,Black Robe,1991,black_robe,7,12,11,1,91,0,1,0,1,0,3.3,1641,60,http://content6.flixster.com/movie/28/35/283504_det.jpg
4689,Il gatto a nove code,1971,cat_o_nine_tails,6.4,12,10,2,83,0,0,0,0,0,0,0,0,http://content7.flixster.com/movie/26/52/265297_det.jpg
4690,The Cotton Club,1984,cotton_club,6.3,23,17,6,73,0,3,2,1,66,3.2,1978,53,http://content8.flixster.com/movie/10/85/17/10851710_det.jpg
4691,Def-Con 4,1985,defcon-41985,0,0,0,0,0,0,0,0,0,0,0,0,0,http://images.rottentomatoescdn.com/images/defaults/poster_default.gif
4692,The Hotel New Hampshire,1984,hotel_new_hampshire,6.1,13,9,4,69,0,0,0,0,0,0,0,0,http://content9.flixster.com/movie/27/40/274023_det.jpg
4693,Idiot Box,1996,idiot_box,0,3,1,2,33,0,0,0,0,0,0,0,0,http://content8.flixster.com/movie/30/42/304294_det.jpg
4694,Left Luggage,1998,left_luggage,5,11,4,7,36,0,3,1,2,33,4.1,417,89,http://content7.flixster.com/movie/10/85/66/10856613_det.jpg
4695,Who'll Stop the Rain,1978,wholl_stop_the_rain,6.8,7,5,2,71,0,0,0,0,0,0,0,0,http://content8.flixster.com/movie/27/84/278414_det.jpg
4696,"Zorro, the Gay Blade",1981,zorro_the_gay_blade,4.8,14,6,8,42,0,1,0,1,0,3.2,1667,60,http://content9.flixster.com/movie/11/12/19/11121915_det.jpg
4697,Basket Case,1982,basket_case,6.3,16,12,4,75,0,0,0,0,0,0,0,0,http://content7.flixster.com/movie/29/02/290225_det.jpg
4698,Orphans,1997,,\N,\N,\N,\N,\N,\N,\N,\N,\N,\N,\N,\N,\N,\N
4699,Original Sin,2001,original_sin,3.4,90,11,79,12,3.1,29,2,27,6,3.2,10609,67,http://content7.flixster.com/movie/10/85/74/10857493_det.jpg
4700,The Princess Diaries,2001,princess_diaries,5.1,110,51,59,46,5.2,28,13,15,46,3.2,83951,71,http://content7.flixster.com/movie/10/89/44/10894429_det.jpg
4701,Rush Hour 2,2001,rush_hour_2,5.4,125,64,61,51,5.1,33,17,16,51,3.3,64114,77,http://content6.flixster.com/movie/55/12/82/5512828_det.jpg
4702,Thomas est amoureux,2000,,\N,\N,\N,\N,\N,\N,\N,\N,\N,\N,\N,\N,\N,\N
4703,Chocolat,2000,1103080-chocolat,6,114,71,43,62,6.1,32,20,12,62,3.6,62492,82,http://content6.flixster.com/movie/10/24/34/10243432_det.jpg
4704,Hatari!,1962,hatari,6.6,22,15,7,68,0,4,3,1,75,3.7,1953,75,http://content8.flixster.com/movie/29/12/291226_det.jpg
4705,La cage aux folles,1978,la_cage_aux_folles,8,15,15,0,100,0,1,1,0,100,3.7,1639,79,http://content7.flixster.com/movie/27/30/273017_det.jpg
4706,La cage aux folles II,1980,la_cage_aux_folles_2,0,4,2,2,50,0,0,0,0,0,0,0,0,http://content9.flixster.com/movie/28/01/280107_det.jpg
4707,Liebestraum,1991,liebestraum,5.6,10,4,6,40,0,2,1,1,50,3.1,260,41,http://content7.flixster.com/movie/10/87/82/10878297_det.jpg
4708,Marat/Sade,1967,,\N,\N,\N,\N,\N,\N,\N,\N,\N,\N,\N,\N,\N,\N
4709,Paint Your Wagon,1969,paint_your_wagon,4.7,13,3,10,23,0,1,0,1,0,3.4,1851,66,http://content6.flixster.com/movie/10/92/33/10923336_det.jpg
4710,The Shootist,1976,shootist,7.9,14,13,1,92,0,1,1,0,100,3.9,2835,84,http://content7.flixster.com/movie/25/57/255729_det.jpg
4711,Theremin: An Electronic Odyssey,1994,theremin_an_electronic_odyssey,7.6,15,15,0,100,0,3,3,0,100,3.5,288,64,http://content7.flixster.com/movie/10/89/83/10898357_det.jpg
4712,L'enfant sauvage,1970,wild_child,8.4,25,25,0,100,8.5,9,9,0,100,3.7,996,78,http://content7.flixster.com/movie/25/18/251829_det.jpg
4713,Altered States,1980,altered_states,6.9,33,29,4,87,0,4,4,0,100,3.4,4339,66,http://content9.flixster.com/movie/27/12/271295_det.jpg
4714,Any Which Way You Can,1980,any_which_way_you_can,4.9,10,2,8,20,0,1,0,1,0,3.1,3457,50,http://content8.flixster.com/movie/25/76/257618_det.jpg
4715,A Crude Awakening: The Oil Crash,2006,a-crude-awakening-the-oil-crash,6.5,14,11,3,78,0,1,0,1,0,4,969,85,http://content8.flixster.com/movie/10/89/05/10890510_det.jpg
4716,Bad Timing,1980,1148372-bad_timing,6.9,5,3,2,60,0,1,0,1,0,3.7,926,79,http://content9.flixster.com/movie/26/78/267899_det.jpg
4717,The Big Brawl,1980,1002306-big_brawl,5.1,6,4,2,66,0,0,0,0,0,0,0,0,http://content6.flixster.com/movie/10/86/99/10869972_det.jpg
4718,American Pie,1999,american_pie,5.7,115,67,48,58,5.5,25,13,12,52,3.4,203348,63,http://content8.flixster.com/movie/11/12/27/11122778_det.jpg
4719,Osmosis Jones,2001,osmosis_jones,5.5,106,57,49,53,5.5,29,16,13,55,2.8,7220,40,http://content6.flixster.com/movie/10/91/51/10915192_det.jpg
4720,The Others,2001,1109257-others,7.2,146,122,24,83,6.4,33,21,12,63,3.3,47632,75,http://content7.flixster.com/movie/31/28/312825_det.jpg
4721,American Outlaws,2001,american_outlaws,3.6,100,13,87,13,3,28,2,26,7,3.2,5353,69,http://content8.flixster.com/movie/10/92/76/10927678_det.jpg
4722,All Over the Guy,2001,all_over_the_guy,4.9,47,20,27,42,4.8,17,7,10,41,3.5,1303,67,http://content8.flixster.com/movie/21/37/30/2137306_det.jpg
4723,The Deep End,2001,deep_end,7.1,114,93,21,81,7.6,29,26,3,89,3.3,1107,58,http://content6.flixster.com/movie/27/65/276500_det.jpg
4724,On the Edge,2001,,\N,\N,\N,\N,\N,\N,\N,\N,\N,\N,\N,\N,\N,\N
4725,Session 9,2001,session_9,6.2,63,38,25,60,4.7,17,6,11,35,3.4,5642,69,http://content7.flixster.com/movie/28/05/280525_det.jpg
4726,The Turandot Project,2000,turandot_project,6.9,30,23,7,76,6.7,9,7,2,77,3.3,205,49,http://content9.flixster.com/movie/30/37/303719_det.jpg
4727,Captain Corelli's Mandolin,2001,captain_corellis_mandolin,4.4,113,33,80,29,3.9,34,8,26,23,2.9,7435,51,http://content6.flixster.com/movie/10/94/83/10948332_det.jpg
4728,Rat Race,2001,rat_race,4.9,124,53,71,42,4.2,28,8,20,28,3.1,23720,63,http://content7.flixster.com/movie/10/88/81/10888109_det.jpg
4729,Aberdeen,2000,aberdeen,7,38,33,5,86,8,12,12,0,100,3.7,511,77,http://content9.flixster.com/movie/30/37/303791_det.jpg
4731,Innocence,2004,1185734-innocence,6.7,17,11,6,64,6.9,8,6,2,75,3.7,1170,73,http://content7.flixster.com/movie/10/92/29/10922973_det.jpg
4732,Bubble Boy,2001,bubble_boy,3.8,81,24,57,29,3.8,19,5,14,26,2.8,14041,52,http://content7.flixster.com/movie/10/91/54/10915485_det.jpg
4733,The Curse of the Jade Scorpion,2001,curse_of_the_jade_scorpion,5.2,122,55,67,45,5,36,14,22,38,3.1,4108,52,http://content6.flixster.com/movie/26/26/262600_det.jpg
4734,Jay and Silent Bob Strike Back,2001,jay_and_silent_bob_strike_back,5.6,148,78,70,52,5.3,31,14,17,45,3.4,44787,77,http://content9.flixster.com/movie/10/93/56/10935619_det.jpg
4735,Ghosts of Mars,2001,ghosts-of-mars,3.6,100,19,81,19,3.4,22,4,18,18,2.4,6302,29,http://content7.flixster.com/movie/10/88/98/10889805_det.jpg
4736,Summer Catch,2001,summer_catch,3.1,82,6,76,7,3,27,2,25,7,2.6,6249,44,http://content9.flixster.com/movie/25/91/259191_det.jpg
4737,An American Rhapsody,2001,1117045-rhapsody,0,0,0,0,0,0,0,0,0,0,0,0,0,http://content6.flixster.com/movie/10/84/97/10849776_det.jpg
4738,Happy Accidents,2000,happy_accidents,6.3,60,43,17,71,6.5,19,13,6,68,3.7,1489,77,http://content8.flixster.com/movie/10/89/15/10891586_det.jpg
4739,Famous,2000,lisa_picard_is_famous,5.4,41,18,23,43,5.5,13,7,6,53,3.1,356,40,http://content6.flixster.com/movie/26/61/266108_det.jpg
4740,Maybe Baby,2000,maybe_baby,5.1,28,13,15,46,3.8,8,2,6,25,3.1,1495,50,http://content9.flixster.com/movie/28/39/283911_det.jpg
4741,Tillsammans,2000,1109600-together,7.2,79,71,8,89,7.6,26,25,1,96,4,2485,87,http://content8.flixster.com/movie/10/94/07/10940734_det.jpg
4743,Tortilla Soup,2001,tortilla_soup,6.3,62,45,17,72,6,23,15,8,65,3.5,996,73,http://content6.flixster.com/movie/25/67/256720_det.jpg
4744,Jeepers Creepers,2001,jeepers_creepers,5.1,107,48,59,44,4.8,26,10,16,38,2.9,22835,56,http://content7.flixster.com/movie/10/95/36/10953697_det.jpg
4745,O,2001,o,6,123,78,45,63,5.2,31,16,15,51,3,4986,58,http://content9.flixster.com/movie/32/93/10/3293107_det.jpg
4746,Waking Up in Reno,2002,waking_up_in_reno,3.6,37,5,32,13,3.8,9,2,7,22,2.9,1272,36,http://content8.flixster.com/movie/10/89/56/10895634_det.jpg
4747,Speedway Junky,1999,speedway_junky,4.4,6,2,4,33,0,3,1,2,33,3.2,549,52,http://content6.flixster.com/movie/10/93/21/10932100_det.jpg
4748,3 Ninjas,1992,3_ninjas,3.4,5,0,5,0,0,0,0,0,0,0,0,0,http://content8.flixster.com/movie/10/88/99/10889982_det.jpg
4749,3 Ninjas Kick Back,1994,3_ninjas_kick_back,2.8,6,1,5,16,0,3,1,2,33,2.6,6654,39,http://content9.flixster.com/movie/10/91/76/10917627_det.jpg
4750,3 Ninjas Knuckle Up,1995,3_ninjas_knuckle_up,0,3,0,3,0,0,0,0,0,0,0,0,0,http://content7.flixster.com/movie/26/67/266705_det.jpg
4751,The Hunter,1980,1010230-hunter,4.8,9,4,5,44,0,1,0,1,0,3.2,898,53,http://content6.flixster.com/movie/26/25/262500_det.jpg
4752,Maniac,1980,maniac_1980,4.9,11,5,6,45,0,0,0,0,0,0,0,0,http://content8.flixster.com/movie/29/03/290394_det.jpg
4753,Interview with the Vampire: The Vampire Chronicles,1994,interview_with_the_vampire,5.8,45,26,19,57,4.6,10,4,6,40,3.7,77706,85,http://content6.flixster.com/movie/28/01/280124_det.jpg
4754,The Wicker Man,1973,1023637-wicker_man,7.7,45,41,4,91,0,4,4,0,100,3.6,8988,79,http://content7.flixster.com/movie/26/90/269021_det.jpg
4755,Wish Upon a Star,1996,wish_upon_a_star,0,3,1,2,33,0,0,0,0,0,0,0,0,http://content7.flixster.com/movie/25/71/257197_det.jpg
4756,The Three Musketeers,1973,1021340-three_musketeers,7.1,11,9,2,81,0,0,0,0,0,0,0,0,http://content6.flixster.com/movie/26/38/263800_det.jpg
4757,Rock Star,2001,star2001,0,0,0,0,0,0,0,0,0,0,0,0,0,http://content7.flixster.com/movie/10/85/15/10851541_det.jpg
4758,Soul Survivors,2001,soul_survivors,2.6,47,2,45,4,2.3,11,0,11,0,2.6,2441,34,http://content9.flixster.com/movie/27/72/277227_det.jpg
4759,Two Can Play That Game,2001,two_can_play_that_game,4.9,63,27,36,42,4.8,23,9,14,39,3.6,5802,82,http://content6.flixster.com/movie/10/87/89/10878916_det.jpg
4760,Bounce: Behind the Velvet Rope,2000,bounce_behind_the_velvet_rope,5.2,10,4,6,40,0,4,2,2,50,2.9,339,36,http://content9.flixster.com/movie/30/84/308415_det.jpg
4761,Diamond Men,2000,diamond_men,7,62,50,12,80,7.1,20,17,3,85,3.2,367,49,http://content8.flixster.com/movie/28/14/281402_det.jpg
4763,Satree lek,2000,iron_ladies,5.2,33,18,15,54,5.4,12,7,5,58,3.6,603,71,http://content6.flixster.com/movie/30/10/301000_det.jpg
4764,Kill Me Later,2001,kill_me_later,4.2,20,5,15,25,5.4,6,3,3,50,3.6,530,68,http://content7.flixster.com/movie/11/14/85/11148505_det.jpg
4765,L.I.E.,2001,1106648-lie,7,82,68,14,82,7.1,24,21,3,87,3.7,1868,77,http://content7.flixster.com/movie/28/69/286921_det.jpg
4766,La virgen de los sicarios,2000,our_lady_of_the_assassins,6.6,61,47,14,77,6.8,22,16,6,72,3.3,450,59,http://content7.flixster.com/movie/27/62/276217_det.jpg
4767,Abbott and Costello Meet the Mummy,1955,abbott_and_costello_meet_the_mummy,4.9,9,3,6,33,0,0,0,0,0,0,0,0,http://content6.flixster.com/movie/10/83/96/10839668_det.jpg
4768,"Dr. Mabuse, der Spieler - Ein Bild der Zeit",1922,dr_mabuse_the_gambler,7.4,11,10,1,90,0,1,0,1,0,4.1,721,90,http://content7.flixster.com/movie/10/88/71/10887161_det.jpg
4769,Into the Arms of Strangers: Stories of the Kindertransport,2000,into_the_arms_of_strangers_stories_of_the_kindertransport,7.7,34,32,2,94,7.4,11,10,1,90,3.8,433,82,http://content9.flixster.com/movie/26/18/261895_det.jpg
4770,The Glass House,2001,glass_house,4.2,84,18,66,21,4,20,4,16,20,2.8,7214,48,http://content9.flixster.com/movie/11/12/61/11126167_det.jpg
4771,Hard Ball,2001,,\N,\N,\N,\N,\N,\N,\N,\N,\N,\N,\N,\N,\N,\N
4772,Dinner Rush,2000,dinner_rush,7.1,44,40,4,90,7.7,13,13,0,100,3.8,853,80,http://content6.flixster.com/movie/10/91/04/10910432_det.jpg
4773,Haiku Tunnel,2001,haiku_tunnel,5.6,47,28,19,59,5.2,20,11,9,55,3.4,353,73,http://content7.flixster.com/movie/11/12/75/11127545_det.jpg
4774,Big Trouble,2002,1109942-big_trouble,5.4,110,53,57,48,4.8,31,9,22,29,2.9,3336,52,http://content9.flixster.com/movie/10/92/12/10921251_det.jpg
4775,Glitter,2001,glitter,2.8,85,6,79,7,2.7,27,1,26,3,2.1,7598,46,http://content6.flixster.com/movie/26/17/261728_det.jpg
4776,Training Day,2001,training_day,6.5,151,108,43,71,6.3,34,24,10,70,3.6,50545,85,http://content7.flixster.com/movie/10/91/83/10918353_det.jpg
4777,The American Astronaut,2001,1104332-american,0,0,0,0,0,0,0,0,0,0,0,0,0,http://content7.flixster.com/movie/10/84/81/10848173_det.jpg
4778,Children Underground,2001,children_underground,7.5,17,16,1,94,7.6,7,7,0,100,4.2,389,89,http://content9.flixster.com/movie/10/89/31/10893191_det.jpg
4779,Go Tigers!,2001,go_tigers,7.1,39,33,6,84,7.1,14,13,1,92,3.3,227,63,http://content7.flixster.com/movie/27/55/275513_det.jpg
4780,Taken,2008,taken,5.8,160,92,68,57,5.2,33,14,19,42,4,307912,83,http://content6.flixster.com/movie/10/88/42/10884248_det.jpg
4781,Megiddo: The Omega Code 2,2001,megiddo_the_omega_code_ii,3.1,19,2,17,10,2.5,7,0,7,0,3.1,612,51,http://content8.flixster.com/movie/27/10/21/2710214_det.jpg
4782,Sidewalks of New York,2001,1110008-sidewalks_of_new_york,5.5,91,51,40,56,5.4,24,12,12,50,3.1,1120,50,http://content6.flixster.com/movie/27/80/278024_det.jpg
4783,The Endurance: Shackleton's Legendary Antarctic Expedition,2000,the-endurance,7.7,65,62,3,95,7.9,24,24,0,100,3.8,415,79,http://content7.flixster.com/movie/25/13/251325_det.jpg
4784,The French Lieutenant's Woman,1981,french_lieutenants_woman,7.1,15,11,4,73,0,1,1,0,100,3.5,1859,67,http://content9.flixster.com/movie/10/88/93/10889347_det.jpg
4785,Il grande silenzio,1968,,\N,\N,\N,\N,\N,\N,\N,\N,\N,\N,\N,\N,\N,\N
4786,The Legend of Hell House,1973,legend_of_hell_house,5.7,13,6,7,46,0,1,0,1,0,3.3,1221,61,http://content6.flixster.com/movie/25/69/256904_det.jpg
4787,Little Man Tate,1991,little_man_tate,6.2,23,18,5,78,0,2,1,1,50,3.2,2824,62,http://content6.flixster.com/movie/10/91/68/10916848_det.jpg
4788,Moskva slezam ne verit,1980,moscow_does_not_believe_in_tears,0,3,1,2,33,0,0,0,0,0,0,0,0,http://content6.flixster.com/movie/10/87/83/10878364_det.jpg
4789,Phantom of the Paradise,1974,phantom_of_the_paradise,7.6,15,14,1,93,0,3,2,1,66,3.9,3007,81,http://content6.flixster.com/movie/25/89/258916_det.jpg
4790,The Return of a Man Called Horse,1976,return_of_a_man_called_horse,5.7,7,5,2,71,0,1,0,1,0,3.2,576,54,http://content7.flixster.com/movie/10/87/81/10878149_det.jpg
4791,Valdez Is Coming,1971,valdez_is_coming,0,1,1,0,100,0,0,0,0,0,0,0,0,http://content6.flixster.com/movie/10/87/72/10877260_det.jpg
4792,Thir13en Ghosts,2001,thirteen_ghosts,3.4,89,11,78,12,3.4,22,3,19,13,3,20700,60,http://content8.flixster.com/movie/26/88/268814_det.jpg
4793,Montenegro,1981,montenegro,7,12,11,1,91,0,3,2,1,66,3.6,259,71,http://content6.flixster.com/movie/27/49/274992_det.jpg
4794,The Phantom of the Opera,1925,1016240-phantom_of_the_opera,7.9,33,29,4,87,5.8,7,4,3,57,3.7,6169,77,http://content6.flixster.com/movie/10/12/76/10127664_det.jpg
4795,Father Goose,1964,father_goose,6.3,12,9,3,75,0,0,0,0,0,0,0,0,http://content7.flixster.com/movie/29/12/291209_det.jpg
4796,The Grass Is Greener,1960,grass_is_greener,6.6,7,7,0,100,0,0,0,0,0,0,0,0,http://content7.flixster.com/movie/29/78/297817_det.jpg
4797,A Hole in the Head,1959,1009736-hole_in_the_head,6.2,5,4,1,80,0,0,0,0,0,0,0,0,http://content6.flixster.com/movie/29/86/298616_det.jpg
4798,Indiscreet,1958,1010540-indiscreet,7.2,8,8,0,100,0,0,0,0,0,0,0,0,http://content7.flixster.com/movie/28/67/286705_det.jpg
4799,It's a Mad Mad Mad Mad World,1963,its_a_mad_mad_mad_mad_world,6.7,26,20,6,76,0,3,2,1,66,3.6,5290,79,http://content7.flixster.com/movie/10/88/83/10888317_det.jpg
4800,King Solomon's Mines,1950,1011638-king_solomons_mines,7.4,11,10,1,90,0,0,0,0,0,0,0,0,http://content6.flixster.com/movie/10/83/82/10838236_det.jpg
4801,The Little Foxes,1941,little_foxes,8.5,14,14,0,100,0,0,0,0,0,0,0,0,http://content6.flixster.com/movie/29/31/293120_det.jpg
4802,Operation Petticoat,1959,operation_petticoat,6.6,11,9,2,81,0,0,0,0,0,0,0,0,http://content7.flixster.com/movie/29/15/291505_det.jpg
4803,Play Misty for Me,1971,play_misty_for_me,7.3,30,25,5,83,7.3,5,4,1,80,3.5,2914,70,http://content8.flixster.com/movie/26/83/268314_det.jpg
4804,Pocketful of Miracles,1961,pocketful_of_miracles,5.8,8,5,3,62,0,0,0,0,0,0,0,0,http://content7.flixster.com/movie/29/35/293597_det.jpg
4805,Sayonara,1957,sayonara,7.2,9,9,0,100,0,0,0,0,0,0,0,0,http://content7.flixster.com/movie/10/87/39/10873953_det.jpg
4806,Obchod na korze,1965,shop_on_main_street,8.9,12,12,0,100,0,0,0,0,0,0,0,0,http://content7.flixster.com/movie/10/88/19/10881997_det.jpg
4807,The Hunting Party,2007,1183674-hunting_party,6,89,47,42,52,5.8,26,12,14,46,3.4,13820,67,http://content7.flixster.com/movie/95/64/82/9564825_det.jpg
4808,The Vanishing,1993,1042295-vanishing,4.8,33,15,18,45,4,6,1,5,16,3.1,3338,51,http://content9.flixster.com/movie/10/83/88/10838867_det.jpg
4809,Silkwood,1983,silkwood,7,22,16,6,72,0,3,1,2,33,3.7,2741,78,http://content6.flixster.com/movie/28/23/282396_det.jpg
4810,I Never Promised You a Rose Garden,1977,i_never_promised_you_a_rose_garden,0,3,2,1,66,0,1,1,0,100,3.3,304,50,http://content6.flixster.com/movie/31/23/312304_det.jpg
4811,Quadrophenia,1979,quadrophenia,7.2,5,5,0,100,0,0,0,0,0,0,0,0,http://content9.flixster.com/movie/10/85/27/10852763_det.jpg
4812,SpaceCamp,1986,space_camp,4.8,10,4,6,40,0,1,0,1,0,2.9,2441,46,http://content6.flixster.com/movie/26/59/265996_det.jpg
4813,When Worlds Collide,1951,when_worlds_collide,5.9,19,15,4,78,0,3,2,1,66,3.4,786,64,http://content7.flixster.com/movie/25/10/251021_det.jpg
4814,Don't Say a Word,2001,dont_say_a_word,4.4,112,26,86,23,4.6,30,10,20,33,3,6502,55,http://content8.flixster.com/movie/10/87/40/10874002_det.jpg
4815,Hearts in Atlantis,2001,hearts_in_atlantis,5.7,133,65,68,48,5.3,30,13,17,43,3.3,4981,64,http://content6.flixster.com/movie/10/88/83/10888348_det.jpg
4816,Zoolander,2001,zoolander,5.9,127,79,48,62,6.1,29,18,11,62,3.3,107651,78,http://content6.flixster.com/movie/10/87/05/10870540_det.jpg
4817,Born Romantic,2000,born_romantic,5.5,31,18,13,58,5.3,9,5,4,55,3.3,588,56,http://content6.flixster.com/movie/10/92/09/10920968_det.jpg
4818,Extreme Days,2001,extreme_days,4.4,7,3,4,42,0,1,1,0,100,3.9,1488,85,http://content8.flixster.com/movie/27/03/25/2703250_det.jpg
4819,Go Figure,2005,go-figure,0,0,0,0,0,0,0,0,0,0,0,0,0,http://content8.flixster.com/movie/83/77/88/8377882_det.jpg
4820,Won't Anybody Listen,2001,wont_anybody_listen,0,3,2,1,66,0,1,1,0,100,0,0,0,http://content7.flixster.com/movie/10/92/68/10926893_det.jpg
4821,Joy Ride,2001,joy_ride,6.6,111,82,29,73,6.7,29,23,6,79,3.1,9370,63,http://content7.flixster.com/movie/27/21/272109_det.jpg
4822,Max Keeble's Big Move,2001,max_keebles_big_move,4.2,54,14,40,25,4,18,4,14,22,2.7,2400,42,http://content8.flixster.com/movie/26/15/261506_det.jpg
4823,Serendipity,2001,serendipity,5.7,128,74,54,57,5.8,31,19,12,61,3.4,43975,79,http://content6.flixster.com/movie/25/41/254100_det.jpg
4824,Grateful Dawg,2000,grateful_dawg,6.2,43,30,13,69,6.8,19,15,4,78,3.6,223,69,http://content7.flixster.com/movie/26/42/264217_det.jpg
4825,La ci√©naga,2001,cienaga,6.9,36,31,5,86,6.6,13,11,2,84,3.8,474,80,http://content7.flixster.com/movie/27/53/275329_det.jpg
4826,The Big Red One,1980,big_red_one,7.7,44,40,4,90,7.3,13,11,2,84,3.6,2424,74,http://content7.flixster.com/movie/10/93/85/10938557_det.jpg
4827,Boogeyman,2005,boogeyman,3.4,85,11,74,12,3.2,11,0,11,0,2.5,13866,38,http://content9.flixster.com/movie/97/10/26/9710267_det.jpg
4828,La boum,1980,,\N,\N,\N,\N,\N,\N,\N,\N,\N,\N,\N,\N,\N,\N
4829,Lady in a Cage,1964,lady_in_a_cage,4.3,5,1,4,20,0,0,0,0,0,0,0,0,http://content6.flixster.com/movie/30/28/302800_det.jpg
4830,Brubaker,1980,brubaker,6.9,18,15,3,83,0,1,0,1,0,3.5,1436,73,http://content8.flixster.com/movie/27/71/277114_det.jpg
4831,Can't Stop the Music,1980,cant_stop_the_music,2.3,13,1,12,7,0,2,0,2,0,2.7,850,38,http://content6.flixster.com/movie/10/91/54/10915476_det.jpg
4832,Carny,1980,1003617-carny,0,4,3,1,75,0,1,0,1,0,3.3,264,53,http://content6.flixster.com/movie/51/11/16/5111168_det.jpg
4833,Changeling,2008,1191742_changeling,6.3,190,117,73,61,5.6,39,17,22,43,3.8,63438,84,http://content7.flixster.com/movie/10/86/09/10860981_det.jpg
4834,Cheech & Chong's Next Movie,1980,cheech_and_chongs_next_movie,0,1,1,0,100,0,0,0,0,0,0,0,0,http://content6.flixster.com/movie/10/87/27/10872704_det.jpg
4835,Coal Miner's Daughter,1980,coal_miners_daughter,8.1,10,10,0,100,0,1,1,0,100,3.6,6330,80,http://content9.flixster.com/movie/10/95/33/10953379_det.jpg
4836,The Competition,1980,competition,6.6,5,4,1,80,0,1,1,0,100,3.5,116,56,http://content6.flixster.com/movie/10/55/45/10554592_det.jpg
4837,Cruising,1980,cruising,5.3,27,16,11,59,0,3,3,0,100,3.2,1790,52,http://content9.flixster.com/movie/10/84/08/10840855_det.jpg
4838,DOA: Dead or Alive,2006,doa_dead_or_alive,4.5,44,15,29,34,4.2,10,2,8,20,2.7,71044,43,http://content7.flixster.com/movie/10/93/50/10935009_det.jpg
4839,Death Ship,1980,death_ship,0,3,1,2,33,0,0,0,0,0,0,0,0,http://content9.flixster.com/movie/10/88/72/10887271_det.jpg
4840,Le dernier m√©tro,1980,last_metro,7.3,17,15,2,88,0,2,1,1,50,3.9,1300,82,http://content8.flixster.com/movie/11/15/11/11151122_det.jpg
4841,Divine Madness,1980,divine-madness,0,0,0,0,0,0,0,0,0,0,0,0,0,http://content9.flixster.com/movie/10/89/02/10890211_det.jpg
4842,The Dogs of War,1980,dogs_of_war,6.2,9,8,1,88,0,0,0,0,0,0,0,0,http://content6.flixster.com/movie/10/87/19/10871920_det.jpg
4843,The Learning Curve,2001,learning_curve,4.3,10,2,8,20,0,3,0,3,0,3.1,147,50,http://content6.flixster.com/movie/10/92/51/10925184_det.jpg
4844,Bandits,2001,bandits,6.1,136,86,50,63,5.9,34,20,14,58,3.1,9238,56,http://content8.flixster.com/movie/25/90/259014_det.jpg
4845,Corky Romano,2001,corky_romano,2.8,81,4,77,4,2.5,24,1,23,4,2.4,4219,42,http://content9.flixster.com/movie/26/10/261023_det.jpg
4846,Siu nin Wong Fei Hung ji: Tit Ma Lau,1993,1075984-iron_monkey,7.3,90,81,9,90,7.5,25,24,1,96,3.7,3899,83,http://content8.flixster.com/movie/10/88/14/10881430_det.jpg
4847,√Ä ma soeur!,2001,fat_girl,6.4,83,60,23,72,7.4,26,23,3,88,3.4,1800,63,http://content6.flixster.com/movie/28/72/287292_det.jpg
4848,Mulholland Dr.,2001,mulholland_dr,7.4,150,122,28,81,7.6,33,29,4,87,3.7,36399,88,http://content6.flixster.com/movie/26/74/267404_det.jpg
4849,My First Mister,2001,my_first_mister,5.6,79,42,37,53,5.1,24,11,13,45,3.6,1032,74,http://content9.flixster.com/movie/27/53/275327_det.jpg
4850,Spriggan,1998,spriggan,5.6,13,7,6,53,0,1,0,1,0,3.4,1591,67,http://content9.flixster.com/movie/28/28/282815_det.jpg
4851,Things Behind the Sun,2001,things_behind_the_sun,7,10,10,0,100,0,1,1,0,100,3.7,309,76,http://content7.flixster.com/movie/10/87/84/10878401_det.jpg
4852,Bones,2001,bones,3.8,65,14,51,21,3.8,22,5,17,22,2.7,3184,47,http://content8.flixster.com/movie/10/91/92/10919242_det.jpg
4853,Brannigan,1975,brannigan,4.6,5,1,4,20,0,1,0,1,0,3.1,1032,48,http://content8.flixster.com/movie/10/91/50/10915082_det.jpg
4854,Clambake,1967,clambake,0,0,0,0,0,0,0,0,0,0,0,0,0,http://content6.flixster.com/movie/24/90/15/2490156_det.jpg
4855,Dirty Harry,1971,dirty_harry,7.8,42,40,2,95,6.2,5,4,1,80,3.8,17350,86,http://content6.flixster.com/movie/10/91/46/10914688_det.jpg
4856,Destiny in Space,1994,destiny-in-space,0,0,0,0,0,0,0,0,0,0,0,0,0,http://content9.flixster.com/movie/10/87/45/10874571_det.jpg
4857,Fiddler on the Roof,1971,fiddler_on_the_roof,7.8,24,21,3,87,0,2,2,0,100,3.8,10462,87,http://content8.flixster.com/movie/10/91/67/10916742_det.jpg
4858,Hail Columbia!,1982,hail-columbia,0,0,0,0,0,0,0,0,0,0,0,0,0,http://content8.flixster.com/movie/30/89/308914_det.jpg
4859,Kansas City,1996,kansas_city,5.9,33,19,14,57,6.2,9,5,4,55,3,608,37,http://content8.flixster.com/movie/28/25/282598_det.jpg
4860,Making the Grade,1984,making_the_grade,0,1,0,1,0,0,0,0,0,0,0,0,0,http://content7.flixster.com/movie/10/91/49/10914993_det.jpg
4861,Mission to Mir,1997,mission-to-mir-imax,0,0,0,0,0,0,0,0,0,0,0,0,0,http://content9.flixster.com/movie/10/94/53/10945395_det.jpg
4862,Not Without My Daughter,1991,not_without_my_daughter,4.9,14,7,7,50,0,2,1,1,50,3.4,2771,72,http://content9.flixster.com/movie/10/92/22/10922283_det.jpg
4863,Female Trouble,1974,female_trouble,6.6,19,15,4,78,0,1,1,0,100,4,2218,84,http://content6.flixster.com/movie/71/88/718844_det.jpg
4864,Titanica,1995,titanica,6,5,3,2,60,0,1,1,0,100,3.2,184,49,http://content9.flixster.com/movie/30/66/306603_det.jpg
4865,From Hell,2001,from_hell,5.7,146,83,63,56,5.3,33,17,16,51,3.3,33233,70,http://content7.flixster.com/movie/27/45/274597_det.jpg
4866,The Last Castle,2001,last_castle,5.6,113,59,54,52,5.6,27,14,13,51,3.4,9259,73,http://content9.flixster.com/movie/10/83/84/10838491_det.jpg
4867,Riding in Cars with Boys,2001,riding_in_cars_with_boys,5.2,107,51,56,47,4.6,31,11,20,35,3.1,12761,63,http://content7.flixster.com/movie/10/92/19/10921973_det.jpg
4868,Bangkok Dangerous,2008,bangkok_dangerous,3.4,92,8,84,8,3.3,15,1,14,6,2.8,23793,33,http://content6.flixster.com/movie/10/84/27/10842740_det.jpg
4869,Plata quemada,2000,burnt_money,6.5,29,22,7,75,6.9,13,11,2,84,3.8,917,78,http://content6.flixster.com/movie/10/86/91/10869148_det.jpg
4870,Dancing at the Blue Iguana,2000,dancing_at_the_blue_iguana,4.6,22,5,17,22,5.6,5,2,3,40,3,698,44,http://content7.flixster.com/movie/27/11/271197_det.jpg
4871,Auto Focus,2002,auto_focus,6.7,155,112,43,72,6.9,37,28,9,75,3.2,1283,56,http://content8.flixster.com/movie/27/88/278806_det.jpg
4872,Intimacy,2001,1110561-intimacy,6.2,68,44,24,64,6.4,22,16,6,72,3.3,918,58,http://content7.flixster.com/movie/28/51/285105_det.jpg
4873,Waking Life,2001,waking_life,7.4,137,109,28,79,7.6,32,26,6,81,4,17715,87,http://content6.flixster.com/movie/26/70/267000_det.jpg
4874,K-PAX,2001,kpax,5.1,136,55,81,40,5.1,32,14,18,43,3.2,14543,73,http://content6.flixster.com/movie/10/65/42/10654272_det.jpg
4875,On the Line,2001,1110294-on_the_line,3.5,68,12,56,17,3.7,21,6,15,28,2.8,1493,50,http://content7.flixster.com/movie/26/31/263117_det.jpg
4876,Thir13en Ghosts,2001,thirteen_ghosts,3.4,89,11,78,12,3.4,22,3,19,13,3,20700,60,http://content8.flixster.com/movie/26/88/268814_det.jpg
4877,Better Than Sex,2000,love_and_sex,5.2,48,23,25,47,5.2,12,6,6,50,3.7,1847,76,http://content8.flixster.com/movie/34/99/64/3499646_det.jpg
4878,Donnie Darko,2001,donnie_darko,7.5,103,87,16,84,6.7,16,10,6,62,3.1,208768,77,http://content8.flixster.com/movie/16/90/54/1690546_det.jpg
4879,High Heels and Low Lifes,2001,high_heels_and_low_lifes,4.3,30,6,24,20,4.9,5,2,3,40,3.1,929,47,http://content6.flixster.com/movie/27/84/278428_det.jpg
4880,Life as a House,2001,life_as_a_house,5.2,102,47,55,46,4.5,30,9,21,30,3.8,11735,88,http://content7.flixster.com/movie/10/89/21/10892165_det.jpg
4881,The Man Who Wasn't There,2001,man_who_wasnt_there,7.1,152,122,30,80,6.8,32,23,9,71,3.7,10358,81,http://content7.flixster.com/movie/10/88/32/10883293_det.jpg
4883,La ville est tranquille,2000,town_is_quiet,6.7,35,25,10,71,6.7,11,7,4,63,3.7,242,71,http://content9.flixster.com/movie/10/88/23/10882395_det.jpg
4884,Trembling Before G-d,2001,trembling-before-gd,7.1,61,54,7,88,7.2,19,18,1,94,3.4,564,64,http://content6.flixster.com/movie/10/84/09/10840900_det.jpg
4885,Domestic Disturbance,2001,domestic_disturbance,4,97,23,74,23,4.1,25,5,20,20,2.9,4637,45,http://content9.flixster.com/movie/10/92/27/10922707_det.jpg
4886,"Monsters, Inc.",2001,monsters_inc,7.9,165,157,8,95,7.1,33,29,4,87,3.8,150109,83,http://content8.flixster.com/movie/10/94/43/10944358_det.jpg
4887,The One,2001,the-one,3.9,83,11,72,13,3.9,22,4,18,18,3.1,16192,60,http://content7.flixster.com/movie/10/87/41/10874149_det.jpg
4888,Tape,2001,tape,6.7,90,69,21,76,6.8,24,18,6,75,3.6,2260,75,http://content6.flixster.com/movie/27/77/277796_det.jpg
4889,Heist,2001,1109137-heist,6.2,125,82,43,65,6.3,30,18,12,60,3.2,3156,59,http://content8.flixster.com/movie/10/92/35/10923526_det.jpg
4890,Shallow Hal,2001,shallow_hal,5.4,118,59,59,50,5,29,13,16,44,3,34183,52,http://content7.flixster.com/movie/25/82/258221_det.jpg
4892,Maze,2000,,\N,\N,\N,\N,\N,\N,\N,\N,\N,\N,\N,\N,\N,\N
4893,When a Stranger Calls,2006,when_a_stranger_calls,3.2,88,8,80,9,3.1,14,1,13,7,3.1,53427,55,http://content9.flixster.com/movie/10/92/11/10921175_det.jpg
4894,Timerider: The Adventure of Lyle Swann,1982,timerider-the-adventure-of-lyle-swann,0,0,0,0,0,0,0,0,0,0,0,0,0,http://content6.flixster.com/movie/26/08/260896_det.jpg
4895,The Wash,2001,1110236-wash,2.9,50,4,46,8,2.7,16,1,15,6,3.4,3029,65,http://content8.flixster.com/movie/27/81/278130_det.jpg
4896,Harry Potter and the Sorcerer's Stone,2001,harry_potter_and_the_sorcerers_stone,7,183,143,40,78,6.7,40,30,10,75,3.6,181305,81,http://content8.flixster.com/movie/10/93/63/10936366_det.jpg
4897,The Fluffer,2001,,\N,\N,\N,\N,\N,\N,\N,\N,\N,\N,\N,\N,\N,\N
4898,Novocaine,2001,novocaine,4.6,105,39,66,37,4.5,29,9,20,31,2.8,1635,37,http://content7.flixster.com/movie/27/72/277205_det.jpg
4899,Black Knight,2001,black_knight,3.4,94,12,82,12,3.8,27,6,21,22,2.6,9124,46,http://content7.flixster.com/movie/18/68/31/1868317_det.jpg
4900,Out Cold,2001,out_cold,2.9,48,4,44,8,3,15,1,14,6,3.5,7234,84,http://content7.flixster.com/movie/18/78/38/1878389_det.jpg
4901,Spy Game,2001,spy_game,6.2,128,83,45,64,6.6,29,20,9,68,3.3,15479,70,http://content9.flixster.com/movie/74/09/11/7409119_det.jpg
4902,El espinazo del diablo,2001,devils_backbone,7.5,100,92,8,92,7.4,25,23,2,92,3.9,9276,89,http://content9.flixster.com/movie/57/45/36/5745363_det.jpg
4903,In the Bedroom,2001,in_the_bedroom,7.9,137,128,9,93,7.6,31,28,3,90,3.7,4252,79,http://content9.flixster.com/movie/27/07/270711_det.jpg
4905,Hell Up in Harlem,1973,hell_up_in_harlem,4.2,8,1,7,12,0,0,0,0,0,0,0,0,http://content6.flixster.com/movie/10/88/24/10882476_det.jpg
4907,Across 110th Street,1972,across_110th_street,0,4,4,0,100,0,0,0,0,0,0,0,0,http://content9.flixster.com/movie/27/93/279315_det.jpg
4908,Le petit soldat,1963,petit_soldat,6.4,10,7,3,70,0,2,1,1,50,3.7,817,76,http://content7.flixster.com/movie/10/87/79/10877917_det.jpg
4909,The Incredible Shrinking Woman,1981,incredible_shrinking_woman,4,5,0,5,0,0,3,0,3,0,3,943,51,http://content9.flixster.com/movie/20/86/01/2086011_det.jpg
4910,Keetje Tippel,1975,katie_tippel,0,3,2,1,66,0,1,0,1,0,2.9,32,29,http://content9.flixster.com/movie/10/86/29/10862935_det.jpg
4911,Jabberwocky,1977,jabberwocky,5.8,12,7,5,58,0,0,0,0,0,0,0,0,http://content6.flixster.com/movie/25/98/259800_det.jpg
4912,Funny Girl,1968,funny_girl,7.6,38,35,3,92,6.7,9,7,2,77,3.7,3850,81,http://content6.flixster.com/movie/25/11/251120_det.jpg
4914,√Ä bout de souffle,1960,breathless,8.6,48,46,2,95,8.1,12,11,1,91,4.2,10327,90,http://content7.flixster.com/movie/28/61/286193_det.jpg
4915,The Beastmaster,1982,beastmaster,5.3,10,5,5,50,0,0,0,0,0,0,0,0,http://content6.flixster.com/movie/25/87/258792_det.jpg
4916,Midway,1976,midway,5.9,11,6,5,54,0,1,0,1,0,3.6,1581,72,http://content8.flixster.com/movie/10/84/95/10849574_det.jpg
4917,MacArthur,1977,macarthur,5.4,8,5,3,62,0,0,0,0,0,0,0,0,http://content8.flixster.com/movie/10/92/97/10929706_det.jpg
4918,The Young Lions,1958,young_lions,7.6,5,4,1,80,0,0,0,0,0,0,0,0,http://content9.flixster.com/movie/10/88/89/10888951_det.jpg
4919,Subway,1985,subway,5.8,7,6,1,85,0,0,0,0,0,0,0,0,http://content6.flixster.com/movie/20/77/81/2077816_det.jpg
4920,"Now, Voyager",1942,now_voyager,8,19,17,2,89,0,0,0,0,0,0,0,0,http://content7.flixster.com/movie/98/96/27/9896273_det.jpg
4921,Little Women,1994,1190049-little_women,0,0,0,0,0,0,0,0,0,0,0,0,0,http://content7.flixster.com/movie/10/86/52/10865225_det.jpg
4922,Halls of Montezuma,1950,,6.6,6,5,1,83,0,0,0,0,0,0,0,0,http://content8.flixster.com/movie/30/21/302110_det.jpg
4923,Guadalcanal Diary,1943,guadalcanal_diary,0,2,1,1,50,0,0,0,0,0,0,0,0,http://content6.flixster.com/movie/29/58/295824_det.jpg
4924,Lo sbarco di Anzio,1968,anzio,6.1,6,4,2,66,0,1,1,0,100,3.1,972,43,http://content8.flixster.com/movie/26/42/264226_det.jpg
4925,The Cheap Detective,1978,cheap_detective,5.7,12,6,6,50,0,0,0,0,0,0,0,0,http://content9.flixster.com/movie/26/13/261395_det.jpg
4926,Iedereen beroemd!,2000,everybodys_famous,5.3,52,28,24,53,5,21,11,10,52,3.4,535,58,http://content8.flixster.com/movie/10/92/15/10921510_det.jpg
4927,The Last Wave,1977,last_wave,7.4,15,13,2,86,0,1,0,1,0,3.7,913,79,http://content7.flixster.com/movie/26/03/260313_det.jpg
4928,Cet obscur objet du d√©sir,1977,that_obscure_object_of_desire,9,25,25,0,100,0,3,3,0,100,4.1,2049,90,http://content8.flixster.com/movie/27/60/276014_det.jpg
4929,Toy Story,1995,toy_story,9,73,73,0,100,8.5,17,17,0,100,3.7,102338,81,http://content7.flixster.com/movie/10/93/63/10936393_det.jpg
4930,Funeral in Berlin,1966,funeral_in_berlin,5.9,7,5,2,71,0,0,0,0,0,0,0,0,http://content6.flixster.com/movie/10/88/80/10888032_det.jpg
4931,Don't Go in the House,1980,dont_go_in_the_house,0,3,0,3,0,0,0,0,0,0,0,0,0,http://content9.flixster.com/movie/61/10/66/6110667_det.jpg
4932,Dressed to Kill,1946,,6.2,5,4,1,80,0,0,0,0,0,0,0,0,http://content8.flixster.com/movie/30/82/308222_det.jpg
4933,The Earthling,1980,earthling,0,0,0,0,0,0,0,0,0,0,0,0,0,http://content6.flixster.com/movie/76/55/89/7655896_det.jpg
4934,The Exterminator,1980,exterminator,0,3,0,3,0,0,0,0,0,0,0,0,0,http://content6.flixster.com/movie/10/93/62/10936212_det.jpg
4935,Darkness Falls,2003,darkness_falls,3.2,124,10,114,8,3,25,1,24,4,2.8,11135,46,http://content6.flixster.com/movie/26/25/262512_det.jpg
4936,Fame,1980,fame,6.9,28,22,6,78,0,4,2,2,50,3.2,6724,67,http://content6.flixster.com/movie/26/83/268312_det.jpg
4937,Fatso,1980,fatso,0,3,2,1,66,0,0,0,0,0,0,0,0,http://content9.flixster.com/movie/89/73/69/8973691_det.jpg
4938,La femme de l'aviateur,1981,aviators_wife,7.3,6,6,0,100,0,3,3,0,100,3.6,300,79,http://content6.flixster.com/movie/10/93/85/10938552_det.jpg
4939,The Final Countdown,1980,final_countdown,5.5,10,5,5,50,0,1,0,1,0,3.4,1797,64,http://content7.flixster.com/movie/10/89/85/10898529_det.jpg
4940,The First Deadly Sin,1980,first_deadly_sin,5.9,7,4,3,57,0,1,1,0,100,3,424,33,http://content6.flixster.com/movie/10/88/62/10886240_det.jpg
4941,Flash Gordon,1980,1007517-flash_gordon,6.3,32,26,6,81,0,3,2,1,66,3.1,6492,64,http://content7.flixster.com/movie/25/73/257321_det.jpg
4942,The Angry Red Planet,1959,angry_red_planet,4,6,0,6,0,0,0,0,0,0,0,0,0,http://content8.flixster.com/movie/29/92/299214_det.jpg
4943,At the Earth's Core,1976,at_the_earths_core,4.4,6,2,4,33,0,1,0,1,0,2.9,800,35,http://content8.flixster.com/movie/26/43/264306_det.jpg
4944,Empire of the Ants,1977,empire_of_the_ants,2.4,16,0,16,0,0,2,0,2,0,2.7,618,29,http://content7.flixster.com/movie/26/53/265397_det.jpg
4945,The Enforcer,1976,1006646-enforcer,6.3,26,20,6,76,0,1,1,0,100,3.4,3350,61,http://content8.flixster.com/movie/27/65/276594_det.jpg
4946,Eye for an Eye,1996,1101753-eye,0,0,0,0,0,0,0,0,0,0,0,0,0,http://content8.flixster.com/movie/10/99/01/10990146_det.jpg
4947,The Gauntlet,1977,gauntlet,6.1,16,13,3,81,0,1,1,0,100,3.2,2342,53,http://content6.flixster.com/movie/27/28/272812_det.jpg
4948,I Bury the Living,1958,i_bury_the_living,6.3,10,6,4,60,0,0,0,0,0,0,0,0,http://content8.flixster.com/movie/10/87/46/10874634_det.jpg
4949,Invasion U.S.A.,1985,1010685-invasion_usa,4,10,3,7,30,0,1,0,1,0,3,1237,51,http://content8.flixster.com/movie/27/43/274310_det.jpg
4950,Lone Wolf McQuade,1983,lone_wolf_mcquade,0,3,2,1,66,0,1,1,0,100,3.4,1315,69,http://content8.flixster.com/movie/22/49/77/2249770_det.jpg
4951,Lord of the Flies,1990,,6.4,18,11,7,61,0,1,0,1,0,3.1,6608,54,http://content6.flixster.com/movie/10/91/65/10916588_det.jpg
4952,Morons from Outer Space,1985,morons_from_outer_space,0,3,1,2,33,0,0,0,0,0,0,0,0,http://content6.flixster.com/movie/44/00/59/4400596_det.jpg
4953,The People That Time Forgot,1977,people_that_time_forgot,0,3,1,2,33,0,0,0,0,0,0,0,0,http://content7.flixster.com/movie/10/89/77/10897713_det.gif
4954,Ocean's Eleven,2001,oceans_eleven,6.9,166,135,31,81,7.2,33,28,5,84,3.6,185259,76,http://content6.flixster.com/movie/11/15/10/11151032_det.jpg
4955,The Sicilian,1987,sicilian,4.2,8,1,7,12,0,1,0,1,0,2.9,708,42,http://content8.flixster.com/movie/28/05/280518_det.jpg
4956,The Fall Guy,1981,,\N,\N,\N,\N,\N,\N,\N,\N,\N,\N,\N,\N,\N,\N
4957,Sudden Impact,1983,sudden_impact,5.7,32,19,13,59,0,4,3,1,75,3.2,4154,56,http://content9.flixster.com/movie/10/88/98/10889867_det.jpg
4958,Behind Enemy Lines,2001,1111645-behind_enemy_lines,4.7,127,46,81,36,4.7,30,12,18,40,3.3,24612,65,http://content6.flixster.com/movie/10/88/69/10886948_det.jpg
4959,The Affair of the Necklace,2001,,3.7,61,9,52,14,4.4,20,5,15,25,3.1,984,45,http://content7.flixster.com/movie/10/92/66/10926633_det.jpg
4960,The Independent,2000,independent,6,48,29,19,60,6.3,13,9,4,69,3,404,46,http://content7.flixster.com/movie/10/87/46/10874673_det.jpg
4961,Porn Star: The Legend of Ron Jeremy,2001,porn_star_the_legend_of_ron_jeremy,6,47,32,15,68,5.5,17,8,9,47,3.3,1190,61,http://content9.flixster.com/movie/10/91/20/10912015_det.jpg
4962,"Walker, Texas Ranger",1993,,\N,\N,\N,\N,\N,\N,\N,\N,\N,\N,\N,\N,\N,\N
4963,Ocean's Eleven,2001,oceans_eleven,6.9,166,135,31,81,7.2,33,28,5,84,3.6,185259,76,http://content6.flixster.com/movie/11/15/10/11151032_det.jpg
4964,Baran,2001,baran,7.6,63,56,7,88,8,21,20,1,95,3.9,880,87,http://content8.flixster.com/movie/26/09/260902_det.jpg
4965,The Business of Strangers,2001,business_of_strangers,6.5,91,72,19,79,7.3,29,27,2,93,3.1,808,49,http://content9.flixster.com/movie/28/16/281615_det.jpg
4966,The Incredible Shrinking Man,1957,incredible_shrinking_man,7.6,16,14,2,87,0,2,1,1,50,3.7,997,80,http://content8.flixster.com/movie/34/46/85/3446858_det.jpg
4967,No Man's Land,2001,no_mans_land,7.8,97,90,7,92,8.2,24,23,1,95,4.1,3608,92,http://content9.flixster.com/movie/27/16/271623_det.jpg
4968,Pi√±ero,2001,pinero,5.4,61,26,35,42,5.3,22,10,12,45,3.7,301,70,http://content7.flixster.com/movie/27/76/277621_det.jpg
4969,And Then There Were None,1945,and_then_there_were_none,8,11,11,0,100,0,0,0,0,0,0,0,0,http://content9.flixster.com/movie/10/89/37/10893787_det.jpg
4970,Der blaue Engel,1930,1002681-blue_angel,8.3,32,30,2,93,7.9,9,9,0,100,4,1414,85,http://content9.flixster.com/movie/29/77/297703_det.jpg
4971,Moscow on the Hudson,1984,moscow_on_the_hudson,7,13,12,1,92,0,1,1,0,100,3,1498,48,http://content9.flixster.com/movie/10/87/17/10871763_det.jpg
4972,The Owl and the Pussycat,1970,1015844-owl_and_the_pussycat,6.5,10,8,2,80,0,0,0,0,0,0,0,0,http://content7.flixster.com/movie/11/13/14/11131429_det.jpg
4973,Le fabuleux destin d'Am√©lie Poulain,2001,amelie,7.9,140,126,14,90,7.5,28,24,4,85,4.2,149167,95,http://content7.flixster.com/movie/10/93/39/10933997_det.jpg
4974,Not Another Teen Movie,2001,not_another_teen_movie,4,94,26,68,27,4.4,22,7,15,31,3,48724,60,http://content6.flixster.com/movie/10/88/03/10880364_det.jpg
4975,Vanilla Sky,2001,vanilla_sky,5.2,160,63,97,39,4.4,33,8,25,24,3,44021,68,http://content7.flixster.com/movie/26/79/267997_det.jpg
4976,Iris,2001,1111227-iris,7.1,109,86,23,78,7.6,34,29,5,85,3.6,2908,73,http://content9.flixster.com/movie/10/89/08/10890895_det.jpg
4977,Safar e Ghandehar,2001,kandahar,7.6,96,85,11,88,8,31,31,0,100,3.6,1057,74,http://content8.flixster.com/movie/10/87/73/10877366_det.jpg
4978,Lantana,2001,lantana,7.4,103,93,10,90,7.8,30,28,2,93,3.8,1926,81,http://content9.flixster.com/movie/28/19/281923_det.jpg
4979,The Royal Tenenbaums,2001,royal_tenenbaums,7.2,170,135,35,79,6.7,36,27,9,75,3.6,56830,87,http://content6.flixster.com/movie/11/11/99/11119924_det.jpg
4980,Bill & Ted's Bogus Journey,1991,bill_and_teds_bogus_journey,6,33,19,14,57,6,6,4,2,66,3,17201,59,http://content9.flixster.com/movie/10/88/19/10881967_det.jpg
4981,Clockwise,1986,clockwise,0,4,3,1,75,0,0,0,0,0,0,0,0,http://content9.flixster.com/movie/26/20/262091_det.jpg
4982,The Trollenberg Terror,1958,crawling_eye,5.1,7,4,3,57,0,0,0,0,0,0,0,0,http://content6.flixster.com/movie/28/60/286004_det.jpg
4983,The Holcroft Covenant,1985,holcroft_covenant,0,2,1,1,50,0,0,0,0,0,0,0,0,http://content6.flixster.com/movie/49/84/59/4984596_det.jpg
4984,Morgan: A Suitable Case for Treatment,1966,morgan,7.3,6,6,0,100,0,0,0,0,0,0,0,0,http://content6.flixster.com/movie/30/58/305812_det.jpg
4985,Sheena,1984,sheena,4.2,8,3,5,37,0,0,0,0,0,0,0,0,http://content6.flixster.com/movie/26/03/260304_det.jpg
4986,Silent Rage,1982,,\N,\N,\N,\N,\N,\N,\N,\N,\N,\N,\N,\N,\N,\N
4987,Spacehunter: Adventures in the Forbidden Zone,1983,spacehunter_adventures_in_the_forbidden_zone,3.2,5,1,4,20,0,0,0,0,0,0,0,0,http://content8.flixster.com/movie/26/31/263126_det.jpg
4988,White Water Summer,1987,white_water_summer,4.5,6,2,4,33,0,0,0,0,0,0,0,0,http://content9.flixster.com/movie/26/34/263419_det.jpg
4989,How High,2001,how_high,3.8,56,15,41,26,4.4,19,7,12,36,3.5,15720,80,http://content8.flixster.com/movie/10/89/19/10891982_det.jpg
4990,Jimmy Neutron: Boy Genius,2001,jimmy_neutron_boy_genius,6.4,73,54,19,73,6.1,17,11,6,64,2.7,5010,42,http://content7.flixster.com/movie/11/13/42/11134217_det.jpg
4991,Joe Somebody,2001,some_body,4.5,30,12,18,40,5.5,11,6,5,54,0,0,0,http://content7.flixster.com/movie/10/88/79/10887945_det.jpg
4992,Kate & Leopold,2001,kate_and_leopold,5.2,116,55,61,47,5.2,30,13,17,43,3,23394,64,http://content9.flixster.com/movie/10/84/31/10843143_det.jpg
4993,The Lord of the Rings: The Fellowship of the Ring,2001,lord_of_the_rings_the_fellowship_of_the_ring,8.1,202,186,16,92,7.9,38,35,3,92,4.1,282006,92,http://content9.flixster.com/movie/26/65/266503_det.jpg
4994,The Majestic,2001,majestic,4.9,135,56,79,41,4,30,8,22,26,3.1,10091,60,http://content7.flixster.com/movie/25/85/258513_det.jpg
4995,A Beautiful Mind,2001,beautiful_mind,7.1,180,140,40,77,7.2,37,30,7,81,3.9,103150,91,http://content9.flixster.com/movie/10/93/45/10934587_det.jpg
4996,Otes√°nek,2000,little_otik,7,42,35,7,83,6.6,8,6,2,75,3.9,1648,84,http://content8.flixster.com/movie/30/25/302594_det.jpg
4997,The Convent,2000,1111079-convent,0,2,1,1,50,0,0,0,0,0,0,0,0,http://content7.flixster.com/movie/28/23/282397_det.jpg
4998,The Defiant Ones,1958,defiant_ones,7,14,12,2,85,0,2,2,0,100,3.7,1030,85,http://content8.flixster.com/movie/30/20/302006_det.jpg
4999,Dodsworth,1936,dodsworth,7.5,15,13,2,86,0,3,3,0,100,4,490,82,http://content9.flixster.com/movie/30/03/300395_det.jpg
5000,Medium Cool,1969,medium_cool,8.1,18,17,1,94,0,2,2,0,100,3.7,656,75,http://content8.flixster.com/movie/15/53/11/1553110_det.jpg
5001,Sahara,2005,1144274-sahara,5.2,171,66,105,38,5,34,15,19,44,3,24489,61,http://content6.flixster.com/movie/24/97/249732_det.jpg
5002,Fritz the Cat,1972,fritz_the_cat,5.4,18,10,8,55,0,2,1,1,50,3.3,1651,64,http://content6.flixster.com/movie/10/86/94/10869440_det.jpg
5003,The Nine Lives of Fritz the Cat,1974,nine_lives_of_fritz_the_cat,5.7,7,3,4,42,0,0,0,0,0,0,0,0,http://content7.flixster.com/movie/10/92/74/10927473_det.jpg
5004,24 Hour Party People,2002,manchester-fiesta-part-1,0,0,0,0,0,0,0,0,0,0,0,0,0,http://content9.flixster.com/movie/10/90/12/10901271_det.jpg
5005,Separate Tables,1958,1018587-separate_tables,8.1,11,10,1,90,0,0,0,0,0,0,0,0,http://content7.flixster.com/movie/29/56/295625_det.jpg
5006,Yu pu tuan zhi: Tou qing bao jian,1991,sex-and-zen,0,0,0,0,0,0,0,0,0,0,0,0,0,http://content8.flixster.com/movie/10/87/37/10873742_det.jpg
5007,Topkapi,1964,topkapi,7.4,18,15,3,83,0,3,3,0,100,0,0,0,http://content6.flixster.com/movie/28/69/286924_det.jpg
5008,Witness for the Prosecution,1982,,\N,\N,\N,\N,\N,\N,\N,\N,\N,\N,\N,\N,\N,\N
5009,Ali,2001,ali,6.3,145,97,48,66,6.5,34,25,9,73,3.3,18871,65,http://content6.flixster.com/movie/27/38/273808_det.jpg
5010,Black Hawk Down,2001,black_hawk_down,6.9,156,119,37,76,6.5,34,25,9,73,3.7,83816,85,http://content6.flixster.com/movie/10/64/95/10649564_det.jpg
5011,Charlotte Gray,2001,charlotte_gray,4.7,87,27,60,31,5,32,11,21,34,3.4,2092,62,http://content8.flixster.com/movie/26/30/263010_det.jpg
5012,Yentl,1983,yentl,6,14,10,4,71,0,1,1,0,100,3.4,1678,72,http://content8.flixster.com/movie/38/91/38/3891386_det.jpg
5013,Gosford Park,2001,gosford_park,7.5,141,121,20,85,8.1,30,29,1,96,3.5,10122,76,http://content6.flixster.com/movie/60/50/97/6050976_det.jpg
5014,I Am Sam,2001,i_am_sam,4.6,141,47,94,33,4.7,38,14,24,36,3.7,51459,87,http://content9.flixster.com/movie/10/09/07/10090791_det.jpg
5015,Monster's Ball,2001,monsters_ball,7.4,141,120,21,85,7.1,38,30,8,78,3.3,12025,65,http://content9.flixster.com/movie/26/94/269411_det.jpg
5016,The Shipping News,2001,shipping_news,5.8,128,71,57,55,5.8,32,18,14,56,3.2,4197,62,http://content9.flixster.com/movie/10/87/82/10878243_det.jpg
5017,The Big Heat,1953,1002332-big_heat,8.4,25,25,0,100,8.6,5,5,0,100,0,0,0,http://content9.flixster.com/movie/26/11/261103_det.jpg
5018,Motorama,1991,motorama,5.1,5,3,2,60,0,0,0,0,0,0,0,0,http://content6.flixster.com/movie/10/86/90/10869032_det.jpg
5019,Queen Bee,1955,queen_bee,0,4,2,2,50,0,0,0,0,0,0,0,0,http://content7.flixster.com/movie/29/70/297017_det.jpg
5020,Silent Trigger,1996,silent_trigger,0,4,1,3,25,0,0,0,0,0,0,0,0,http://content7.flixster.com/movie/27/94/279409_det.jpg
5021,Murder by Death,1976,murder_by_death,6.1,16,11,5,68,0,3,2,1,66,3.9,3635,84,http://content7.flixster.com/movie/25/43/254393_det.jpg
5022,The Servant,1963,servant,6.6,16,12,4,75,0,3,1,2,33,4.1,746,92,http://content7.flixster.com/movie/28/79/287921_det.jpg
5023,The Waterdance,1992,waterdance,7.2,13,12,1,92,0,2,2,0,100,3.3,417,56,http://content8.flixster.com/movie/27/58/275814_det.jpg
5024,Presque rien,2000,come_undone,0,0,0,0,0,0,0,0,0,0,0,0,0,http://images.rottentomatoescdn.com/images/defaults/poster_default.gif
5025,Orange County,2002,orange_county,5.2,119,56,63,47,5.2,29,13,16,44,3,12865,61,http://content7.flixster.com/movie/10/86/96/10869637_det.jpg
5026,Le pacte des loups,2001,brotherhood_of_the_wolf,6.2,115,82,33,71,6,30,21,9,70,3.5,10900,76,http://content7.flixster.com/movie/11/12/59/11125953_det.jpg
5027,Another 48 Hrs.,1990,another_48_hrs,3.8,20,4,16,20,0,2,0,2,0,2.9,6166,41,http://content9.flixster.com/movie/27/58/275803_det.jpg
5028,Ni na bian ji dian,2001,what_time_is_it_there,7.1,50,42,8,84,7.4,17,15,2,88,3.9,860,81,http://content6.flixster.com/movie/30/31/303108_det.jpg
5029,China Moon,1994,china_moon,5.6,9,4,5,44,0,1,0,1,0,3,535,35,http://content9.flixster.com/movie/27/86/278615_det.jpg
5030,The Umbrella Woman,1987,good_wife,0,4,2,2,50,0,1,0,1,0,2.9,207,23,http://content8.flixster.com/movie/10/88/71/10887122_det.jpg
5031,Maria's Lovers,1984,,0,3,1,2,33,0,0,0,0,0,0,0,0,http://content7.flixster.com/movie/91/37/95/9137957_det.jpg
5032,Failure to Launch,2006,failure_to_launch,4.6,147,37,110,25,5.2,33,13,20,39,3.2,86609,60,http://content6.flixster.com/movie/31/28/312892_det.jpg
5033,The Russia House,1990,russia_house,6.6,14,10,4,71,0,2,1,1,50,3,1792,42,http://content7.flixster.com/movie/27/11/271101_det.jpg
5034,Truly Madly Deeply,1990,truly_madly_deeply,6.6,32,23,9,71,6.9,6,5,1,83,3.9,3004,82,http://content8.flixster.com/movie/25/81/258102_det.jpg
5035,Wuthering Heights,1939,1024192-wuthering_heights,7.9,16,16,0,100,0,1,1,0,100,3.9,2525,84,http://content7.flixster.com/movie/31/37/313797_det.jpg
5036,California Suite,1978,california_suite,5.2,19,11,8,57,0,2,0,2,0,3.1,671,47,http://content8.flixster.com/movie/26/28/262810_det.jpg
5037,The Long Gray Line,1955,long_gray_line,7.1,5,5,0,100,0,0,0,0,0,0,0,0,http://content6.flixster.com/movie/29/43/294304_det.jpg
5038,The Flight of Dragons,1982,flight_of_dragons,0,0,0,0,0,0,0,0,0,0,0,0,0,http://content7.flixster.com/movie/24/89/97/2489973_det.jpg
5039,Dragonslayer,1981,dragonslayer,6.1,22,18,4,81,0,1,1,0,100,3.2,8214,59,http://content6.flixster.com/movie/25/58/255808_det.jpg
5040,Conan the Destroyer,1984,the-destroyer,0,0,0,0,0,0,0,0,0,0,0,0,0,http://content8.flixster.com/movie/10/84/32/10843262_det.jpg
5041,Fire & Ice,2008,fire-ice-the-dragon-chronicles,0,0,0,0,0,0,0,0,0,0,0,0,0,http://content8.flixster.com/movie/11/12/81/11128158_det.jpg
5042,Spacehunter: Adventures in the Forbidden Zone,1983,spacehunter_adventures_in_the_forbidden_zone,3.2,5,1,4,20,0,0,0,0,0,0,0,0,http://content8.flixster.com/movie/26/31/263126_det.jpg
5043,17 sui de tian kong,2004,formula_17,4.8,9,2,7,22,5.2,5,2,3,40,3.6,656,70,http://content7.flixster.com/movie/10/89/31/10893137_det.jpg
5044,Foxes,1980,foxes,5.9,9,6,3,66,0,1,1,0,100,3.3,658,55,http://content9.flixster.com/movie/27/51/275111_det.jpg
5045,Galaxina,1980,galaxina,3.6,5,1,4,20,0,0,0,0,0,0,0,0,http://content6.flixster.com/movie/39/90/26/3990268_det.jpg
5046,Impostor,2001,impostor,3.9,91,19,72,20,3.6,25,4,21,16,3,1418,46,http://content6.flixster.com/movie/10/86/93/10869340_det.jpg
5047,Kung Pow: Enter the Fist,2002,kung_pow,2.8,53,6,47,11,2.8,12,0,12,0,3,15128,64,http://content7.flixster.com/movie/10/87/79/10877913_det.jpg
5048,Snow Dogs,2002,snow_dogs,3.9,79,18,61,22,3.5,18,3,15,16,2.8,11502,55,http://content9.flixster.com/movie/10/88/66/10886639_det.jpg
5049,48 Hrs.,1982,48_hrs,7.4,33,31,2,93,0,4,3,1,75,3.2,10471,61,http://content8.flixster.com/movie/26/94/269494_det.jpg
5050,Abschied - Brechts letzter Sommer,2000,farewell,6.5,14,10,4,71,0,4,4,0,100,2.8,129,30,http://content7.flixster.com/movie/10/90/60/10906009_det.jpg
5051,Italiensk for begyndere,2000,italian_for_beginners,7.2,81,71,10,87,7.5,26,23,3,88,3.7,1581,77,http://content6.flixster.com/movie/10/88/93/10889388_det.jpg
5052,Ha-Hesder,2000,time-of-favor,6.1,24,14,10,58,6.9,11,9,2,81,3.6,197,71,http://content8.flixster.com/movie/29/69/296914_det.jpg
5053,Blankman,1994,blankman,3.3,15,2,13,13,0,3,1,2,33,2.3,2988,32,http://content6.flixster.com/movie/26/04/260492_det.jpg
5054,Brainstorm,1983,1003017-brainstorm,5.8,14,9,5,64,0,1,0,1,0,3.1,1295,54,http://content8.flixster.com/movie/25/78/257898_det.jpg
5055,Dragon: The Bruce Lee Story,1993,dragon_the_bruce_lee_story,6.8,17,14,3,82,0,3,1,2,33,3.4,7771,76,http://content8.flixster.com/movie/25/75/257594_det.jpg
5056,Jeder f√ºr sich und Gott gegen alle,1974,mystery-of-kaspar-hauser-jeder-fur-sich-und-gott-gegen-alle,0,0,0,0,0,0,0,0,0,0,0,0,0,http://images.rottentomatoescdn.com/images/defaults/poster_default.gif
5057,4 for Texas,1963,4_for_texas,4.1,8,1,7,12,0,0,0,0,0,0,0,0,http://content8.flixster.com/movie/10/88/50/10885034_det.jpg
5058,Herz aus Glas,1976,heart-of-glass,7.2,7,6,1,85,0,2,1,1,50,3.7,892,71,http://content9.flixster.com/movie/33/17/18/3317183_det.jpg
5059,Little Dieter Needs to Fly,1997,little_dieter_needs_to_fly,7.8,14,13,1,92,0,4,3,1,75,4.1,1132,93,http://content8.flixster.com/movie/10/93/08/10930826_det.jpg
5060,MASH,1970,mash,8.2,35,31,4,88,0,4,3,1,75,3.7,10200,81,http://content9.flixster.com/movie/26/91/269123_det.jpg
5061,Mrs. Soffel,1984,1014352-mrs_soffel,5.6,9,5,4,55,0,2,0,2,0,3.1,791,41,http://content8.flixster.com/movie/26/41/264102_det.jpg
5062,Gone in Sixty Seconds,2000,1097865-gone_in_60_seconds,4.4,133,32,101,24,4,35,8,27,22,3.5,92563,79,http://content8.flixster.com/movie/10/86/23/10862358_det.jpg
5063,One-Eyed Jacks,1961,oneeyed_jacks,6.3,12,7,5,58,0,0,0,0,0,0,0,0,http://content8.flixster.com/movie/10/88/13/10881362_det.jpg
5064,The Count of Monte Cristo,2002,1110288-count_of_monte_cristo,6.6,134,99,35,73,6.3,27,18,9,66,3.6,29907,85,http://content7.flixster.com/movie/11/12/83/11128345_det.jpg
5065,The Mothman Prophecies,2002,mothman_prophecies,5.5,133,69,64,51,4.8,31,9,22,29,3,8350,58,http://content9.flixster.com/movie/25/93/259315_det.jpg
5066,A Walk to Remember,2002,walk_to_remember,4.1,101,28,73,27,4.1,25,6,19,24,3.3,243778,79,http://content6.flixster.com/movie/16/90/40/1690408_det.jpg
5067,American Adobo,2001,american_adobo,4.6,23,7,16,30,5,9,4,5,44,3.8,502,71,http://content9.flixster.com/movie/27/49/274927_det.jpg
5068,Shiqi sui de dan che,2001,beijing_bicycle,6.4,58,36,22,62,6.3,18,11,7,61,3.6,1036,75,http://content6.flixster.com/movie/26/26/262692_det.jpg
5069,Escaflowne,2000,escaflowne_the_movie,5.3,14,6,8,42,0,4,3,1,75,3.6,2839,73,http://content8.flixster.com/movie/26/41/264114_det.jpg
5071,Maelstr√∂m,2000,maelstroem,6.7,35,28,7,80,6.6,11,9,2,81,4,14,100,http://content9.flixster.com/movie/10/99/67/10996707_det.jpg
5072,Metropolis,1927,1013775-metropolis,8.9,98,97,1,98,8.8,23,23,0,100,4.1,17640,90,http://content8.flixster.com/movie/10/93/38/10933866_det.jpg
5073,La stanza del figlio,2001,sons_room,7.3,81,68,13,83,7.6,28,25,3,89,3.8,1513,80,http://content9.flixster.com/movie/27/52/275207_det.jpg
5074,Storytelling,2001,storytelling,5.6,89,47,42,52,5.8,27,15,12,55,3.5,3033,69,http://content7.flixster.com/movie/28/71/287121_det.jpg
5075,Waydowntown,2000,waydowntown,6.4,33,23,10,69,6.4,7,5,2,71,3.5,496,70,http://content7.flixster.com/movie/15/28/51/1528517_det.jpg
5076,The Adventures of Huck Finn,1993,adventures_of_huck_finn,5.9,13,8,5,61,0,4,3,1,75,2.9,2408,47,http://content7.flixster.com/movie/25/77/257717_det.jpg
5077,Cousins,1989,cousins,5.8,8,4,4,50,0,1,1,0,100,3.1,644,57,http://content6.flixster.com/movie/25/95/259516_det.jpg
5078,Falling in Love,1984,falling_in_love,5.4,10,6,4,60,0,1,0,1,0,3.5,2067,67,http://content9.flixster.com/movie/10/88/46/10884611_det.jpg
5079,Young @ Heart,2007,youngheart,7.5,97,85,12,87,7.7,23,21,2,91,4.2,3340,91,http://content9.flixster.com/movie/10/87/95/10879511_det.jpg
5080,Slackers,2002,slackers,3.1,104,11,93,10,2.4,30,1,29,3,2.8,4294,52,http://content6.flixster.com/movie/10/93/77/10937732_det.jpg
5081,Birthday Girl,2001,birthday_girl,5.7,120,69,51,57,5.5,30,16,14,53,2.8,4145,40,http://content8.flixster.com/movie/10/91/57/10915754_det.jpg
5082,A Rumor of Angels,2000,a-rumor-of-angels,4.7,29,10,19,34,4.7,9,3,6,33,3.6,355,74,http://content8.flixster.com/movie/26/48/264802_det.jpg
5083,Rare Birds,2001,rare_birds,5.9,12,7,5,58,0,4,1,3,25,3.4,569,61,http://content6.flixster.com/movie/10/92/06/10920616_det.jpg
5084,Caged Heat,1974,caged_heat,6.4,9,7,2,77,0,1,0,1,0,2.9,988,37,http://content9.flixster.com/movie/21/00/15/2100151_det.jpg
5085,Carmen Jones,1954,carmen_jones,6.1,18,13,5,72,0,3,2,1,66,3.9,1003,80,http://content9.flixster.com/movie/29/22/292295_det.jpg
5086,The Five Heartbeats,1991,five_heartbeats,4.9,14,6,8,42,0,2,1,1,50,4.2,4599,93,http://content8.flixster.com/movie/11/14/70/11147026_det.jpg
5087,Pr√©parez vos mouchoirs,1978,get_out_your_handkerchiefs,6.6,9,8,1,88,0,0,0,0,0,0,0,0,http://content7.flixster.com/movie/10/92/54/10925425_det.jpg
5088,Les valseuses,1974,going_places,6.9,6,5,1,83,0,0,0,0,0,0,0,0,http://content7.flixster.com/movie/10/92/32/10923289_det.jpg
5089,Honky Tonk Freeway,1981,honky_tonk_freeway,0,2,2,0,100,0,0,0,0,0,0,0,0,http://content9.flixster.com/movie/54/86/79/5486791_det.jpg
5090,Notre-Dame de Paris,1956,1073312-hunchback_of_notre_dame,0,0,0,0,0,0,0,0,0,0,0,0,0,http://content7.flixster.com/movie/10/89/25/10892517_det.jpg
5091,Le magnifique,1973,le-magnifique,0,0,0,0,0,0,0,0,0,0,0,0,0,http://content9.flixster.com/movie/29/94/299423_det.jpg
5092,Big Fat Liar,2002,big_fat_liar,4.9,88,38,50,43,4.5,21,7,14,33,2.9,23120,52,http://content9.flixster.com/movie/55/35/55/5535555_det.jpg
5093,Collateral Damage,2002,1110242-collateral_damage,4,139,24,115,17,3.9,30,6,24,20,2.8,10885,34,http://content7.flixster.com/movie/11/15/17/11151709_det.jpg
5094,Rollerball,1975,1017814-rollerball,6,25,17,8,68,0,4,1,3,25,3.2,2655,61,http://content8.flixster.com/movie/27/22/272218_det.jpg
5095,"Scotland, Pa.",2001,scotland_pa,6,74,44,30,59,5.3,27,11,16,40,3.6,1222,74,http://content7.flixster.com/movie/27/57/275701_det.jpg
5096,Baby's Day Out,1994,babys_day_out,3.9,14,3,11,21,0,3,0,3,0,2.7,10709,54,http://content7.flixster.com/movie/25/86/258617_det.jpg
5097,Bright Eyes,1934,bright_eyes,6.4,8,6,2,75,0,0,0,0,0,0,0,0,http://content9.flixster.com/movie/10/88/86/10888619_det.jpg
5098,Dimples,1936,1005868-dimples,0,2,1,1,50,0,0,0,0,0,0,0,0,http://content9.flixster.com/movie/26/54/265491_det.jpg
5099,Heidi,1968,1009439-heidi,0,0,0,0,0,0,0,0,0,0,0,0,0,http://content6.flixster.com/movie/95/87/09/9587096_det.jpg
5100,L'homme qui aimait les femmes,1977,1040103-man_who_loved_women,7,9,8,1,88,0,2,2,0,100,3.9,1035,83,http://content7.flixster.com/movie/10/88/65/10886553_det.gif
5101,Richard Pryor... Here and Now,1983,richard_pryor_here_and_now,7.5,6,5,1,83,0,1,1,0,100,3.7,646,83,http://content9.flixster.com/movie/27/40/274091_det.jpg
5102,Rookie of the Year,1993,rookie_of_the_year,4.7,17,6,11,35,0,2,1,1,50,0,0,0,http://content7.flixster.com/movie/11/14/06/11140605_det.jpg
5103,The Sandlot,1993,sandlot,5.8,22,13,9,59,0,3,2,1,66,3.6,28919,86,http://content8.flixster.com/movie/10/84/98/10849850_det.jpg
5104,Vacas,1992,vacas,0,2,0,2,0,0,0,0,0,0,0,0,0,http://content7.flixster.com/movie/24/53/40/2453405_det.jpg
5105,Don't Look Now,1973,dont_look_now,8.2,37,35,2,94,6.6,8,7,1,87,3.8,4354,80,http://content9.flixster.com/movie/10/90/56/10905635_det.jpg
5106,Crossroads,2002,1112549-crossroads,3.9,101,14,87,13,3.9,24,3,21,12,2.2,15071,41,http://content7.flixster.com/movie/10/94/50/10945037_det.jpg
5107,Hart's War,2002,harts_war,5.9,117,68,49,58,5.6,32,17,15,53,3,6114,52,http://content9.flixster.com/movie/27/45/274527_det.jpg
5108,John Q,2002,john_q,4.4,127,28,99,22,4,33,4,29,12,3.6,18865,83,http://content9.flixster.com/movie/60/25/21/6025215_det.jpg
5109,Return to Never Land,2002,return_to_never_land,5.4,89,41,48,46,6.3,22,15,7,68,3.2,4974,54,http://content7.flixster.com/movie/23/30/99/2330993_det.jpg
5110,Super Troopers,2001,super_troopers,5,86,31,55,36,5.1,20,8,12,40,3.7,49372,89,http://content6.flixster.com/movie/49/16/491640_det.jpg
5111,The Good Son,1993,good_son,4.2,24,6,18,25,3.9,8,2,6,25,3,6435,58,http://content6.flixster.com/movie/27/20/272092_det.jpg
5112,Last Orders,2001,last_orders,7,88,69,19,78,7.4,28,23,5,82,3.4,644,64,http://content6.flixster.com/movie/27/80/278000_det.jpg
5113,Caccia alla volpe,1966,after_the_fox,5.4,7,5,2,71,0,0,0,0,0,0,0,0,http://content9.flixster.com/movie/28/68/286891_det.jpg
5114,The Bad and the Beautiful,1952,bad_and_the_beautiful,7.7,13,13,0,100,0,1,1,0,100,3.8,1035,83,http://content7.flixster.com/movie/30/00/300093_det.jpg
5115,Cast a Giant Shadow,1966,cast_a_giant_shadow,0,3,1,2,33,0,0,0,0,0,0,0,0,http://content8.flixster.com/movie/29/46/294622_det.jpg
5116,Designing Woman,1957,designing_woman,7,8,6,2,75,0,0,0,0,0,0,0,0,http://content6.flixster.com/movie/10/86/98/10869808_det.jpg
5117,Funny Lady,1975,funny_lady,4.4,7,2,5,28,0,1,0,1,0,3.2,1039,59,http://content6.flixster.com/movie/10/88/03/10880352_det.jpg
5118,The Heartbreak Kid,2007,the_heartbreak_kid,4.7,153,47,106,30,4.6,32,9,23,28,2.9,91228,41,http://content7.flixster.com/movie/96/50/75/9650753_det.jpg
5119,Saturday Night and Sunday Morning,1960,saturday_night_and_sunday_morning,8,10,10,0,100,0,0,0,0,0,0,0,0,http://content8.flixster.com/movie/30/32/303206_det.jpg
5120,Sleuth,2007,sleuth,5.1,118,42,76,35,5.1,30,10,20,33,3.2,9724,53,http://content8.flixster.com/movie/99/66/35/9966350_det.jpg
5121,Stroszek,1977,stroszek,8.2,13,13,0,100,0,3,3,0,100,4.3,1933,93,http://content7.flixster.com/movie/29/96/299617_det.jpg
5122,Summer of '42,1971,summer_of_42,6.7,16,13,3,81,0,1,0,1,0,3.6,580,78,http://content7.flixster.com/movie/27/12/271201_det.jpg
5123,A Touch of Class,1973,touch_of_class,6.8,10,9,1,90,0,1,1,0,100,3,669,46,http://content9.flixster.com/movie/10/89/54/10895455_det.jpg
5124,Town Without Pity,1961,town_without_pity,6,5,3,2,60,0,0,0,0,0,0,0,0,http://content7.flixster.com/movie/90/21/45/9021457_det.jpg
5125,Used Cars,1980,used_cars,6.5,17,13,4,76,0,1,0,1,0,3.3,1611,63,http://content8.flixster.com/movie/10/92/20/10922018_det.jpg
5126,The Deadly Mantis,1957,deadly_mantis,4.2,8,2,6,25,0,0,0,0,0,0,0,0,http://content7.flixster.com/movie/11/15/17/11151769_det.jpg
5127,Dragonfly,2002,dragonfly,3.6,121,8,113,6,3.5,30,1,29,3,3.1,9426,65,http://content7.flixster.com/movie/25/83/258321_det.jpg
5128,Queen of the Damned,2002,queen_of_the_damned,3.9,126,21,105,16,3.9,31,5,26,16,3.1,36894,70,http://content6.flixster.com/movie/10/91/48/10914808_det.jpg
5129,Big Bad Love,2001,big_bad_love,5.4,58,24,34,41,5.3,20,7,13,35,3.7,279,74,http://content6.flixster.com/movie/10/88/84/10888440_det.jpg
5130,Green Dragon,2001,green_dragon,5.9,28,17,11,60,6.3,9,6,3,66,3.1,559,40,http://content7.flixster.com/movie/10/91/52/10915241_det.jpg
5131,How to Kill Your Neighbor's Dog,2000,how_to_kill_your_neighbors_dog,6,31,18,13,58,5.5,9,4,5,44,3.7,569,70,http://content9.flixster.com/movie/11/12/32/11123279_det.jpg
5132,The Last Man on Earth,1964,1050388-last_man_on_earth,6.3,15,11,4,73,0,1,0,1,0,3.6,4886,69,http://content7.flixster.com/movie/18/68/33/1868337_det.jpg
5133,Maryam,2002,maryam,6.8,34,26,8,76,7.1,12,10,2,83,3.8,36,83,http://content6.flixster.com/movie/10/84/77/10847700_det.jpg
5134,Mean Machine,2001,1114210-mean_machine,4.9,56,19,37,33,5.4,21,9,12,42,3.5,6547,76,http://content7.flixster.com/movie/27/46/274621_det.jpg
5135,Monsoon Wedding,2001,monsoon_wedding,7.9,116,110,6,94,8,35,33,2,94,3.8,5868,85,http://content9.flixster.com/movie/26/72/267295_det.jpg
5136,Wendigo,2001,wendigo,6.2,50,29,21,58,5.9,13,6,7,46,2.4,773,27,http://content6.flixster.com/movie/10/89/98/10899808_det.jpg
5137,Scratch,2001,,\N,\N,\N,\N,\N,\N,\N,\N,\N,\N,\N,\N,\N,\N
5138,State Property,2002,state_property,2,12,0,12,0,0,3,0,3,0,3.7,1134,75,http://content8.flixster.com/movie/10/84/01/10840142_det.jpg
5139,Bad News Bears,2005,interlude,0,0,0,0,0,0,0,0,0,0,0,0,0,http://content8.flixster.com/movie/10/89/52/10895218_det.jpg
5140,The Bad News Bears Go to Japan,1978,bad_news_bears_go_to_japan,2.9,10,0,10,0,0,0,0,0,0,0,0,0,http://content9.flixster.com/movie/10/91/43/10914339_det.jpg
5141,The Bad News Bears in Breaking Training,1977,bad_news_bears_in_breaking_training,6,8,4,4,50,0,0,0,0,0,0,0,0,http://content7.flixster.com/movie/10/91/83/10918357_det.jpg
5142,"Hor√≠, m√° panenko",1967,firemens_ball,7.7,16,14,2,87,0,1,1,0,100,3.9,578,83,http://content9.flixster.com/movie/30/27/302727_det.jpg
5143,The Lone Ranger,1949,,\N,\N,\N,\N,\N,\N,\N,\N,\N,\N,\N,\N,\N,\N
5144,The Lone Ranger and the Lost City of Gold,1958,lone_ranger_and_the_lost_city_of_gold,0,4,2,2,50,0,0,0,0,0,0,0,0,http://content6.flixster.com/movie/11/14/23/11142388_det.jpg
5145,L√°sky jedn√© plavovl√°sky,1965,loves_of_a_blonde,8,13,12,1,92,0,0,0,0,0,0,0,0,http://content8.flixster.com/movie/10/92/34/10923406_det.jpg
5146,Vampire Hunter D: Bloodlust,2000,vampire_hunter_d_bloodlust,6.4,32,23,9,71,6.3,12,8,4,66,3.8,11019,83,http://content7.flixster.com/movie/26/95/269509_det.jpg
5147,Smultronst√§llet,1957,wild_strawberries,8.8,31,29,2,93,0,2,1,1,50,4.4,6409,94,http://content7.flixster.com/movie/28/55/04/2855041_det.jpg
5148,Black Like Me,1964,black_like_me,0,0,0,0,0,0,0,0,0,0,0,0,0,http://content9.flixster.com/movie/88/16/34/8816343_det.jpg
5149,Cattle Queen of Montana,1954,cattle_queen_of_montana,0,1,1,0,100,0,0,0,0,0,0,0,0,http://content9.flixster.com/movie/10/85/30/10853007_det.jpg
5150,Under the Skin,1997,under_the_skin,6.8,22,19,3,86,7.7,9,9,0,100,3.4,239,67,http://content8.flixster.com/movie/30/66/306694_det.jpg
5151,40 Days and 40 Nights,2002,40_days_and_40_nights,4.8,134,51,83,38,4.5,34,9,25,26,3.1,33188,53,http://content6.flixster.com/movie/27/17/271796_det.jpg
5152,We Were Soldiers,2002,we_were_soldiers,6.4,141,88,53,62,6.9,36,27,9,75,3.6,36901,84,http://content6.flixster.com/movie/10/92/29/10922992_det.jpg
5153,Trouble Every Day,2001,trouble_every_day,5.6,45,20,25,44,4.5,11,3,8,27,3.5,756,63,http://content8.flixster.com/movie/10/92/12/10921254_det.jpg
5154,Arena,1989,1033999-arena,0,0,0,0,0,0,0,0,0,0,0,0,0,http://content7.flixster.com/movie/58/87/55/5887557_det.jpg
5155,The Big Bird Cage,1972,big_bird_cage,0,3,3,0,100,0,0,0,0,0,0,0,0,http://content8.flixster.com/movie/28/06/31/2806318_det.jpg
5156,The Big Doll House,1971,big_doll_house,0,4,4,0,100,0,0,0,0,0,0,0,0,http://content8.flixster.com/movie/11/12/68/11126842_det.jpg
5157,La chiesa,1989,1029529-church,5.8,9,6,3,66,0,0,0,0,0,0,0,0,http://content6.flixster.com/movie/10/89/20/10892036_det.jpg
5158,Cross Creek,1983,cross_creek,5.4,10,6,4,60,0,2,1,1,50,3.4,269,59,http://content9.flixster.com/movie/10/87/31/10873143_det.jpg
5159,FernGully: The Last Rainforest,1992,ferngully_the_last_rainforest,6.3,13,9,4,69,0,1,1,0,100,3.1,10187,62,http://content9.flixster.com/movie/25/10/251011_det.jpg
5160,Night of the Zombies,1981,night-of-the-zombies-battalion-of-the-living-deadgamma-693the-chillingsister-of-death,0,0,0,0,0,0,0,0,0,0,0,0,0,http://content6.flixster.com/movie/11/15/23/11152352_det.jpg
5161,Intersection,1994,intersection,3.4,27,2,25,7,3.1,8,0,8,0,2.8,1105,40,http://content8.flixster.com/movie/10/84/58/10845818_det.jpg
5162,"Jo Jo Dancer, Your Life Is Calling",1986,jo_jo_dancer_your_life_is_calling,5.6,11,6,5,54,0,1,1,0,100,3.4,747,66,http://content6.flixster.com/movie/27/41/274116_det.jpg
5163,Deliria,1987,deliria-bloody-birdsound-stage-massacrestage-fright,0,2,1,1,50,0,0,0,0,0,0,0,0,http://content7.flixster.com/movie/10/91/56/10915673_det.jpg
5164,A Troll in Central Park,1994,a-troll-in-central-park,3.1,5,0,5,0,0,0,0,0,0,0,0,0,http://content6.flixster.com/movie/10/87/55/10875568_det.jpg
5165,Zombi 2,1979,zombie,4.6,14,5,9,35,0,0,0,0,0,0,0,0,http://content7.flixster.com/movie/11/15/11/11151165_det.jpg
5167,My Favorite Brunette,1947,my_favorite_brunette,5.9,7,5,2,71,0,0,0,0,0,0,0,0,http://content6.flixster.com/movie/95/84/09/9584092_det.jpg
5168,Royal Wedding,1951,royal_wedding,6.7,14,12,2,85,0,0,0,0,0,0,0,0,http://content9.flixster.com/movie/30/76/307615_det.jpg
5169,Scarlet Street,1945,scarlet_street,8,11,11,0,100,0,0,0,0,0,0,0,0,http://content9.flixster.com/movie/29/87/298707_det.jpg
5170,All About the Benjamins,2002,all_about_the_benjamins,4.3,75,22,53,29,4.2,21,6,15,28,3.4,6169,77,http://content6.flixster.com/movie/60/26/38/6026384_det.jpg
5171,The Time Machine,2002,1112951-time_machine,4.8,146,41,105,28,5,32,6,26,18,2.7,10389,45,http://content6.flixster.com/movie/10/91/76/10917636_det.jpg
5172,Full Frontal,2002,full_frontal,5.2,140,52,88,37,5.2,35,12,23,34,2.6,1893,27,http://content9.flixster.com/movie/15/52/67/1552671_det.jpg
5173,Divorcing Jack,1998,divorcing-jack,0,0,0,0,0,0,0,0,0,0,0,0,0,http://content8.flixster.com/movie/34/83/18/3483186_det.jpg
5174,The Field,1990,1034131-field,5.2,14,6,8,42,3.3,6,1,5,16,3.8,615,80,http://content7.flixster.com/movie/26/62/266209_det.jpg
5175,Hidden Agenda,1990,1032750-hidden_agenda,6.6,18,14,4,77,6.5,5,4,1,80,3.7,279,75,http://content7.flixster.com/movie/88/97/56/8897565_det.jpg
5176,Luminarias,2000,luminarias,6.1,15,10,5,66,0,2,0,2,0,3.1,147,43,http://content9.flixster.com/movie/10/91/81/10918191_det.jpg
5177,The Magnificent Ambersons,1942,1013071-magnificent_ambersons,8.4,23,22,1,95,7.6,6,6,0,100,4.1,1662,86,http://content7.flixster.com/movie/10/91/93/10919377_det.jpg
5178,He's Just Not That Into You,2009,hes_just_not_that_into_you,5.2,152,64,88,42,5,37,12,25,32,3.4,219066,60,http://content6.flixster.com/movie/10/92/12/10921224_det.jpg
5179,Gloria,1999,1085275-gloria,4.1,27,5,22,18,5.1,6,1,5,16,2.7,660,31,http://content8.flixster.com/movie/28/25/282502_det.jpg
5180,The Great Rock 'n' Roll Swindle,1980,the-great-rocknroll-swindle,6.9,6,6,0,100,0,0,0,0,0,0,0,0,http://content6.flixster.com/movie/43/88/88/4388884_det.jpg
5181,Hangar 18,1980,hangar_18,0,3,1,2,33,0,0,0,0,0,0,0,0,http://content9.flixster.com/movie/10/95/76/10957627_det.jpg
5182,Hawk the Slayer,1980,hawk_the_slayer,0,3,1,2,33,0,0,0,0,0,0,0,0,http://content7.flixster.com/movie/10/87/51/10875129_det.jpg
5183,He Knows You're Alone,1980,he_knows_youre_alone,4.8,5,1,4,20,0,0,0,0,0,0,0,0,http://content8.flixster.com/movie/95/35/11/9535118_det.jpg
5184,Heaven's Gate,1980,heavens_gate,5,20,9,11,45,0,3,1,2,33,3.1,1241,52,http://content7.flixster.com/movie/27/30/273013_det.jpg
5185,Hero at Large,1980,hero_at_large,0,0,0,0,0,0,0,0,0,0,0,0,0,http://content9.flixster.com/movie/91/45/98/9145987_det.jpg
5186,Honeysuckle Rose,1980,honeysuckle_rose,0,4,3,1,75,0,1,1,0,100,3.9,189,78,http://content7.flixster.com/movie/67/88/40/6788401_det.jpg
5187,Hopscotch,1980,hopscotch,6.1,12,9,3,75,0,1,1,0,100,3.6,761,72,http://content9.flixster.com/movie/26/81/268111_det.jpg
5188,How to Beat the High Co$t of Living,1980,,\N,\N,\N,\N,\N,\N,\N,\N,\N,\N,\N,\N,\N,\N
5189,Humanoids from the Deep,1980,,4.9,8,4,4,50,0,0,0,0,0,0,0,0,http://content8.flixster.com/movie/28/19/281910_det.jpg
5190,Inside Moves,1980,inside_moves,0,2,1,1,50,0,0,0,0,0,0,0,0,http://content6.flixster.com/movie/10/83/93/10839300_det.jpg
5192,The Island,2005,island,5.4,184,74,110,40,5.2,36,14,22,38,3.3,41199,67,http://content7.flixster.com/movie/85/25/14/8525141_det.jpg
5193,The Jazz Singer,1980,1010979-jazz_singer,3.7,20,3,17,15,0,3,1,2,33,3.4,857,71,http://content6.flixster.com/movie/10/92/52/10925292_det.jpg
5194,Ko to tamo peva,1980,ko-to-tamo-peva-who-sings-over-there,0,0,0,0,0,0,0,0,0,0,0,0,0,http://content9.flixster.com/movie/79/04/12/7904127_det.jpg
5195,Le lac des morts vivants,1981,zombie_lake,0,2,0,2,0,0,0,0,0,0,0,0,0,http://content7.flixster.com/movie/27/90/279001_det.jpg
5196,Lion of the Desert,1981,lion_of_the_desert,0,4,3,1,75,0,0,0,0,0,0,0,0,http://content8.flixster.com/movie/10/88/84/10888490_det.jpg
5197,Little Darlings,1980,little_darlings,0,4,3,1,75,0,1,0,1,0,3.4,1497,71,http://content6.flixster.com/movie/71/89/718928_det.jpg
5198,The Long Good Friday,1980,long_good_friday,8.1,20,19,1,95,0,3,3,0,100,4.1,2936,88,http://content7.flixster.com/movie/10/93/46/10934629_det.jpg
5199,The Long Riders,1980,long_riders,6.4,19,15,4,78,0,2,0,2,0,3.5,1258,71,http://content6.flixster.com/movie/10/87/12/10871244_det.jpg
5200,The Man Who Saw Tomorrow,1981,the-man-who-saw-tomorrow,0,0,0,0,0,0,0,0,0,0,0,0,0,http://content6.flixster.com/movie/11/12/33/11123348_det.jpg
5201,Mangiati vivi!,1980,1006583-eaten_alive,0,2,0,2,0,0,0,0,0,0,0,0,0,http://content9.flixster.com/movie/10/91/88/10918847_det.jpg
5202,Mon oncle d'Am√©rique,1980,mon_oncle_damerique,8.1,9,9,0,100,0,2,2,0,100,3.9,640,84,http://content7.flixster.com/movie/11/15/03/11150361_det.jpg
5203,The Monster Club,1980,monster_club,5.9,7,5,2,71,0,0,0,0,0,0,0,0,http://content8.flixster.com/movie/10/86/03/10860390_det.jpg
5204,La mort en direct,1980,la-mort-en-direct-death-watch-death-in-full-view,0,0,0,0,0,0,0,0,0,0,0,0,0,http://content6.flixster.com/movie/90/49/07/9049076_det.jpg
5205,Motel Hell,1980,motel_hell,5.7,16,11,5,68,0,1,1,0,100,3.1,1573,52,http://content9.flixster.com/movie/10/89/54/10895499_det.jpg
5206,Mother's Day,1980,mothers_day,5.2,7,3,4,42,0,0,0,0,0,0,0,0,http://content9.flixster.com/movie/28/75/287503_det.jpg
5207,The Mountain Men,1980,mountain_men,4.9,6,3,3,50,0,0,0,0,0,0,0,0,http://content7.flixster.com/movie/26/90/269001_det.jpg
5208,The Ninth Configuration,1980,ninth_configuration,6.3,9,6,3,66,0,0,0,0,0,0,0,0,http://content6.flixster.com/movie/27/39/273908_det.jpg
5209,North Sea Hijack,1979,ffolkes,0,4,1,3,25,0,0,0,0,0,0,0,0,http://content9.flixster.com/movie/26/06/260695_det.jpg
5210,Le notti del terrore,1981,le-notti-del-terrore,0,2,1,1,50,0,0,0,0,0,0,0,0,http://content8.flixster.com/movie/10/89/54/10895410_det.jpg
5211,The Nude Bomb,1980,nude_bomb,3.2,16,3,13,18,0,1,0,1,0,3,745,40,http://content8.flixster.com/movie/11/12/69/11126982_det.gif
5212,The Octagon,1980,octagon,3.6,5,1,4,20,0,0,0,0,0,0,0,0,http://content8.flixster.com/movie/29/44/294410_det.jpg
5213,"Oh, God! Book II",1980,oh_god_book_2,5.1,6,3,3,50,0,1,0,1,0,2.8,490,44,http://content7.flixster.com/movie/10/89/42/10894217_det.jpg
5214,"Oh, God! You Devil",1984,oh_god_you_devil,5.1,7,2,5,28,0,0,0,0,0,0,0,0,http://content7.flixster.com/movie/10/78/71/10787105_det.jpg
5215,Oh Heavenly Dog,1980,oh_heavenly_dog,0,4,0,4,0,0,2,0,2,0,2.8,693,42,http://content8.flixster.com/movie/10/90/75/10907558_det.jpg
5216,"Pepi, Luci, Bom y otras chicas del mont√≥n",1980,pepi-luci-bom-y-otras-chicas-del-monton-pepi-luci-bom-and-other-girls-like-mom,4.3,6,2,4,33,0,3,0,3,0,0,0,0,http://content6.flixster.com/movie/89/59/30/8959304_det.jpg
5217,Poliziotto superpi√π,1980,super_fuzz,3.5,6,0,6,0,0,1,0,1,0,3.2,682,52,http://content7.flixster.com/movie/10/89/16/10891645_det.jpg
5218,Ice Age,2002,ice_age,6.8,161,124,37,77,7.3,32,25,7,78,3.7,146598,81,http://content8.flixster.com/movie/10/93/89/10938906_det.jpg
5219,Resident Evil,2002,resident_evil,4.5,120,41,79,34,3.8,23,4,19,17,3.4,69489,73,http://content6.flixster.com/movie/10/93/47/10934792_det.jpg
5220,Showtime,2002,1113375-showtime,4.7,120,29,91,24,4,31,4,27,12,2.5,5638,30,http://content6.flixster.com/movie/10/93/54/10935488_det.jpg
5221,Harrison's Flowers,2000,harrisons_flowers,5.6,83,40,43,48,5.4,27,12,15,44,3.6,1213,75,http://content8.flixster.com/movie/27/45/274522_det.jpg
5222,Kissing Jessica Stein,2001,kissing_jessica_stein,7,115,97,18,84,7.6,30,27,3,90,3.2,3869,61,http://content6.flixster.com/movie/26/99/269904_det.jpg
5223,Pauline & Paulette,2001,pauline_and_paulette,6.9,53,44,9,83,7.5,15,14,1,93,3.8,211,80,http://content8.flixster.com/movie/48/47/24/4847242_det.jpg
5224,Eastern Promises,2007,eastern_promises,7.6,190,169,21,88,7.4,35,30,5,85,3.8,66267,82,http://content6.flixster.com/movie/95/78/52/9578528_det.jpg
5225,Y tu mam√° tambi√©n,2001,y-tu-mama-tambien,8,126,115,11,91,8.8,29,28,1,96,3.9,22998,87,http://content6.flixster.com/movie/10/87/33/10873384_det.jpg
5226,All the Right Moves,1983,all_the_right_moves,4.9,19,10,9,52,0,3,2,1,66,2.9,2666,39,http://content9.flixster.com/movie/27/13/271315_det.jpg
5227,Barabba,1961,barabbas,6.8,6,6,0,100,0,0,0,0,0,0,0,0,http://content8.flixster.com/movie/29/41/294194_det.jpg
5228,The Ghost Breakers,1940,,7.7,5,5,0,100,0,0,0,0,0,0,0,0,http://content7.flixster.com/movie/28/63/286305_det.jpg
5229,I Think I Do,1997,i_think_i_do,0,4,1,3,25,0,1,0,1,0,3.5,349,64,http://content9.flixster.com/movie/29/92/299223_det.jpg
5230,The Paleface,1948,paleface,6.9,7,7,0,100,0,0,0,0,0,0,0,0,http://content9.flixster.com/movie/29/33/293323_det.jpg
5231,Road to Morocco,1942,road_to_morocco,7.8,12,11,1,91,0,0,0,0,0,0,0,0,http://content7.flixster.com/movie/10/90/94/10909409_det.jpg
5232,Road to Singapore,1940,road_to_singapore,6.4,9,9,0,100,0,0,0,0,0,0,0,0,http://content7.flixster.com/movie/30/03/300393_det.jpg
5233,Road to Utopia,1946,road_to_utopia,7.5,6,6,0,100,0,0,0,0,0,0,0,0,http://content8.flixster.com/movie/12/29/45/1229450_det.jpg
5234,Road to Zanzibar,1941,,7,6,6,0,100,0,0,0,0,0,0,0,0,http://content6.flixster.com/movie/12/29/42/1229424_det.jpg
5235,Split Second,1992,1038419-split_second,0,2,0,2,0,0,0,0,0,0,0,0,0,http://content9.flixster.com/movie/10/87/40/10874075_det.jpg
5236,Conte de printemps,1990,tale_of_springtime,6.9,11,10,1,90,0,4,4,0,100,3.6,251,72,http://content9.flixster.com/movie/10/09/15/10091583_det.jpg
5237,Taps,1981,taps,6,14,11,3,78,0,1,1,0,100,3.4,2747,63,http://content6.flixster.com/movie/26/05/260596_det.jpg
5238,Return of the Secaucus Seven,1979,return-of-the-secaucus-seven,6.7,15,12,3,80,0,1,1,0,100,3.5,323,73,http://content8.flixster.com/movie/27/58/275898_det.jpg
5239,Rude Boy,1980,rude-boy2003,0,0,0,0,0,0,0,0,0,0,0,0,0,http://content6.flixster.com/movie/10/91/31/10913120_det.jpg
5240,Running Scared,2006,10004288-running_scared,4.5,128,51,77,39,4.4,31,10,21,32,3.6,35992,77,http://content8.flixster.com/movie/31/27/312798_det.jpg
5241,Seems Like Old Times,1980,seems_like_old_times,6,11,8,3,72,0,1,0,1,0,3.3,1129,62,http://content9.flixster.com/movie/25/58/255819_det.jpg
5242,Serial,1980,,\N,\N,\N,\N,\N,\N,\N,\N,\N,\N,\N,\N,\N,\N
5243,Shi di chu ma,1980,young_master,0,1,1,0,100,0,0,0,0,0,0,0,0,http://content9.flixster.com/movie/10/90/31/10903167_det.jpg
5244,Shogun Assassin,1980,shogun_assassin,0,3,3,0,100,0,0,0,0,0,0,0,0,http://content7.flixster.com/movie/95/37/953797_det.jpg
5245,Simon,2004,1157813-simon,5.6,5,3,2,60,0,4,2,2,50,4.1,338,87,http://content7.flixster.com/movie/24/84/66/2484669_det.jpg
5246,Smokey and the Bandit II,1980,smokey_and_the_bandit_ii,4,5,1,4,20,0,1,0,1,0,2.8,3299,55,http://content9.flixster.com/movie/26/56/265607_det.jpg
5247,Smokey and the Bandit,1977,smokey_and_the_bandit,6.2,22,17,5,77,0,1,0,1,0,3.4,8794,80,http://content7.flixster.com/movie/25/90/259021_det.jpg
5248,Smokey and the Bandit Part 3,1983,,\N,\N,\N,\N,\N,\N,\N,\N,\N,\N,\N,\N,\N,\N
5249,Spetters,1980,spetters,6.8,5,4,1,80,0,0,0,0,0,0,0,0,http://content8.flixster.com/movie/28/73/287326_det.jpg
5250,Stir Crazy,1980,stir_crazy,6.2,14,10,4,71,0,1,0,1,0,3.4,3164,77,http://content6.flixster.com/movie/10/93/72/10937292_det.jpg
5251,S√§llskapsresan eller Finns det svenskt kaffe p√• grisfesten,1980,sallskapsresan-the-charter-trip,0,0,0,0,0,0,0,0,0,0,0,0,0,http://content6.flixster.com/movie/37/41/71/3741716_det.jpg
5252,Tegeran-43,1981,,\N,\N,\N,\N,\N,\N,\N,\N,\N,\N,\N,\N,\N,\N
5253,Cousins,1989,cousins,5.8,8,4,4,50,0,1,1,0,100,3.1,644,57,http://content6.flixster.com/movie/25/95/259516_det.jpg
5254,Blade II,2002,blade_2_bloodhunt,6,134,78,56,58,5.5,27,13,14,48,3.4,60022,72,http://content9.flixster.com/movie/10/93/34/10933451_det.jpg
5255,Sorority Boys,2002,sorority_boys,3.2,62,8,54,12,3.2,16,2,14,12,2.8,5444,57,http://content9.flixster.com/movie/10/88/60/10886079_det.jpg
5256,Stolen Summer,2002,,5,57,20,37,35,4.7,21,8,13,38,3.5,439,69,http://content9.flixster.com/movie/10/87/96/10879691_det.jpg
5258,George Washington,2000,1097991-george_washington,7.3,56,46,10,82,7.4,12,10,2,83,4,1443,86,http://content8.flixster.com/movie/28/81/288122_det.jpg
5259,Homicide: The Movie,2000,homicide_the_movie,0,1,1,0,100,0,0,0,0,0,0,0,0,http://content9.flixster.com/movie/10/86/37/10863767_det.jpg
5260,La vida es silbar,1998,life_is_to_whistle,0,3,1,2,33,0,0,0,0,0,0,0,0,http://content8.flixster.com/movie/10/92/40/10924046_det.jpg
5262,Mr. Sardonicus,1961,mr_sardonicus,4.6,8,3,5,37,0,0,0,0,0,0,0,0,http://content6.flixster.com/movie/29/74/297496_det.jpg
5263,Strait-Jacket,1964,straitjacket,6.4,5,4,1,80,0,0,0,0,0,0,0,0,http://content8.flixster.com/movie/10/89/92/10899230_det.jpg
5264,Clockstoppers,2002,clockstoppers,4.7,83,23,60,27,4.5,20,4,16,20,2.6,4856,35,http://content6.flixster.com/movie/10/84/11/10841188_det.jpg
5265,Death to Smoochy,2002,death_to_smoochy,5.3,119,50,69,42,4,26,3,23,11,3,10569,61,http://content6.flixster.com/movie/27/11/271124_det.jpg
5266,Panic Room,2002,panic_room,6.9,178,136,42,76,6.6,34,24,10,70,3,19615,61,http://content9.flixster.com/movie/10/91/39/10913971_det.jpg
5267,The Rookie,2002,1112954-rookie,7.2,140,115,25,82,7.4,32,29,3,90,3.3,10597,68,http://content7.flixster.com/movie/25/13/251397_det.jpg
5268,No Such Thing,2001,no_such_thing,5,42,12,30,28,4.9,15,4,11,26,3.3,777,60,http://content8.flixster.com/movie/27/95/279502_det.jpg
5269,La pianiste,2001,piano_teacher,6.9,81,59,22,72,7.7,25,21,4,84,3.8,5369,81,http://content9.flixster.com/movie/11/15/13/11151355_det.jpg
5272,L'emploi du temps,2001,time-out-l-emploi-du-temps,8,82,79,3,96,8.2,25,23,2,92,3.8,613,76,http://content8.flixster.com/movie/29/81/39/2981398_det.jpg
5273,Very Annie Mary,2001,very_annie_mary,4.9,27,8,19,29,4.8,9,2,7,22,3.8,488,75,http://content7.flixster.com/movie/10/88/94/10889493_det.jpg
5274,Bar Girls,1994,bar_girls,5,6,1,5,16,0,2,0,2,0,3,635,46,http://content8.flixster.com/movie/28/33/283398_det.jpg
5275,Boxcar Bertha,1972,boxcar_bertha,4.9,20,9,11,45,0,4,2,2,50,2.9,1317,34,http://content9.flixster.com/movie/28/00/280091_det.jpg
5276,Crimes of Passion,1984,crimes_of_passion,4.9,9,3,6,33,0,1,0,1,0,3.2,217,54,http://content6.flixster.com/movie/10/85/42/10854292_det.jpg
5277,The Evil That Men Do,1984,evil_that_men_do,4.8,5,2,3,40,0,0,0,0,0,0,0,0,http://content6.flixster.com/movie/27/70/277096_det.jpg
5278,Fraternity Vacation,1985,fraternity_vacation,0,3,0,3,0,0,2,0,2,0,3,279,47,http://content9.flixster.com/movie/27/76/277695_det.jpg
5279,Impromptu,1991,impromptu,6.2,15,12,3,80,5.7,6,4,2,66,3.6,1242,73,http://content7.flixster.com/movie/10/84/99/10849957_det.jpg
5280,Salmonberries,1991,salmonberries,6.2,7,5,2,71,0,0,0,0,0,0,0,0,http://content9.flixster.com/movie/10/87/71/10877171_det.jpg
5281,The Wrong Guy,1997,wrong_guy,0,3,0,3,0,0,1,0,1,0,3.6,826,81,http://content7.flixster.com/movie/10/92/04/10920477_det.jpg
5282,High Crimes,2002,crimes,0,0,0,0,0,0,0,0,0,0,0,0,0,http://content7.flixster.com/movie/10/90/14/10901421_det.jpg
5283,Van Wilder,2002,national_lampoons_van_wilder,3.5,86,16,70,18,3.1,21,2,19,9,3.3,23872,78,http://content6.flixster.com/movie/10/93/95/10939576_det.jpg
5284,Crush,2001,,\N,\N,\N,\N,\N,\N,\N,\N,\N,\N,\N,\N,\N,\N
5285,Lucky Break,2001,lucky_break,5.6,44,21,23,47,5.6,17,8,9,47,3.2,389,53,http://content9.flixster.com/movie/10/91/98/10919819_det.jpg
5286,Les destin√©es sentimentales,2000,les-destinees,6,49,30,19,61,6.1,18,11,7,61,3.1,243,41,http://content9.flixster.com/movie/30/81/308107_det.jpg
5287,"After Dark, My Sweet",1990,after_dark_my_sweet,6.7,15,13,2,86,6.9,5,4,1,80,3.3,506,57,http://content7.flixster.com/movie/10/89/53/10895385_det.jpg
5288,The Atomic Cafe,1982,atomic_cafe,7.4,14,14,0,100,0,0,0,0,0,0,0,0,http://content8.flixster.com/movie/29/23/292318_det.jpg
5289,Body and Soul,1947,1002820-body_and_soul,7.7,8,8,0,100,0,2,2,0,100,4,268,88,http://content7.flixster.com/movie/99/15/14/9915145_det.jpg
5290,First Men in the Moon,1964,first_men_in_the_moon,6.1,6,4,2,66,0,0,0,0,0,0,0,0,http://content9.flixster.com/movie/29/25/292507_det.jpg
5291,Rash√¥mon,1950,kurosawa-a-documentary-on-the-acclaimed-director,0,0,0,0,0,0,0,0,0,0,0,0,0,http://content7.flixster.com/movie/10/84/93/10849357_det.jpg
5292,Slap Shot,1977,slap_shot,6.8,24,20,4,83,0,3,1,2,33,0,0,0,http://content8.flixster.com/movie/10/89/45/10894538_det.jpg
5293,Changing Lanes,2002,changing_lanes,7,149,115,34,77,6.7,30,22,8,73,3,7920,49,http://content6.flixster.com/movie/10/28/31/10283104_det.jpg
5294,Frailty,2001,frailty,6.9,133,98,35,73,6.6,31,22,9,70,3.5,8605,78,http://content6.flixster.com/movie/26/90/269096_det.jpg
5295,New Best Friend,2002,new_best_friend,2.9,38,2,36,5,2.6,10,1,9,10,3,636,42,http://content9.flixster.com/movie/28/01/280199_det.jpg
5296,The Sweetest Thing,2002,sweetest_thing,4.2,104,26,78,25,4.2,26,7,19,26,3,21858,68,http://content9.flixster.com/movie/58/56/24/5856247_det.jpg
5297,The Cat's Meow,2001,cats_meow,6.5,119,89,30,74,7.1,33,28,5,84,3.1,1938,48,http://content9.flixster.com/movie/26/39/263991_det.jpg
5298,Human Nature,2001,1113402-human_nature,5.8,94,46,48,48,5.4,25,9,16,36,3.3,3892,62,http://content6.flixster.com/movie/10/90/20/10902080_det.jpg
5299,My Big Fat Greek Wedding,2002,my_big_fat_greek_wedding,6.7,121,91,30,75,6.3,25,18,7,72,3.2,49673,69,http://content8.flixster.com/movie/55/35/49/5535498_det.jpg
5300,3:10 to Yuma,2007,310_to_yuma,7.5,205,182,23,88,7.3,42,36,6,85,3.9,139372,85,http://content7.flixster.com/movie/10/92/16/10921673_det.jpg
5301,Bite the Bullet,1975,bite_the_bullet,6.6,14,10,4,71,0,3,2,1,66,3.2,558,50,http://content6.flixster.com/movie/10/92/33/10923396_det.jpg
5302,Breakout,1975,1003060-breakout,5.3,7,3,4,42,0,1,0,1,0,0,0,0,http://content7.flixster.com/movie/26/45/264505_det.jpg
5303,Joe Versus the Volcano,1990,joe_versus_the_volcano,5.4,24,14,10,58,0,3,2,1,66,2.7,6794,45,http://content7.flixster.com/movie/10/87/53/10875305_det.jpg
5304,"Roma, citt√† aperta",1945,open_city,8.8,22,22,0,100,0,4,4,0,100,4.2,1681,90,http://content6.flixster.com/movie/29/58/295828_det.jpg
5305,Return of the Killer Tomatoes!,1988,return_of_the_killer_tomatoes_the_sequel,2.8,5,0,5,0,0,0,0,0,0,0,0,0,http://content9.flixster.com/movie/25/87/258715_det.jpg
5306,Return to Horror High,1987,return_to_horror_high,0,4,0,4,0,0,0,0,0,0,0,0,0,http://content6.flixster.com/movie/20/85/95/2085952_det.jpg
5307,Taking Care of Business,1990,taking_care_of_business,2.6,5,0,5,0,0,1,0,1,0,2.8,695,48,http://content7.flixster.com/movie/10/88/15/10881513_det.jpg
5308,3 Men and a Baby,1987,three_men_and_a_baby,5.7,24,17,7,70,0,4,3,1,75,2.9,11309,51,http://content9.flixster.com/movie/25/71/257115_det.jpg
5309,3 Men and a Little Lady,1990,three_men_and_a_little_lady,3.9,13,3,10,23,0,1,1,0,100,2.8,6348,48,http://content8.flixster.com/movie/25/78/257802_det.jpg
5310,Transylvania 6-5000,1985,transylvania_65000,4.2,10,2,8,20,0,0,0,0,0,0,0,0,http://content7.flixster.com/movie/25/84/258493_det.jpg
5311,The Watcher in the Woods,1980,watcher_in_the_woods,4.9,13,6,7,46,0,1,0,1,0,0,0,0,http://content9.flixster.com/movie/26/33/263327_det.jpg
5312,Murder by Numbers,2002,com_for_murder,0,0,0,0,0,0,0,0,0,0,0,0,0,http://content9.flixster.com/movie/28/77/287799_det.jpg
5313,The Scorpion King,2002,scorpion_king,4.9,130,52,78,40,4.5,27,8,19,29,2.9,30398,53,http://content8.flixster.com/movie/26/12/261218_det.jpg
5314,Abril Despeda√ßado,2001,behind_the_sun,6.7,46,34,12,73,6.7,18,13,5,72,3.9,968,86,http://content7.flixster.com/movie/26/34/263413_det.jpg
5315,Chelsea Walls,2001,chelsea_walls,4.1,46,12,34,26,4.5,15,5,10,33,3,515,43,http://content6.flixster.com/movie/10/89/50/10895008_det.jpg
5316,Enigma,2001,1113649-enigma,6.6,104,75,29,72,6.8,29,22,7,75,3.2,2061,52,http://content6.flixster.com/movie/27/95/279508_det.jpg
5317,Les filles ne savent pas nager,2000,girls-cant-swim,5.9,34,24,10,70,6.5,14,11,3,78,2.9,255,37,http://content6.flixster.com/movie/30/20/302000_det.jpg
5318,Joshua,2007,joshua,6.3,97,61,36,62,6.9,31,24,7,77,2.9,13913,40,http://content6.flixster.com/movie/10/85/48/10854820_det.jpg
5319,Nueve reinas,2000,nine_queens,7.5,91,84,7,92,8,27,26,1,96,4.2,4937,93,http://content9.flixster.com/movie/10/91/49/10914947_det.jpg
5321,The Triumph of Love,2001,triumph_of_love,5.5,70,33,37,47,5.7,27,13,14,48,3.1,452,49,http://content8.flixster.com/movie/26/48/264818_det.jpg
5322,World Traveler,2001,world_traveler,4.9,66,23,43,34,4.8,23,8,15,34,2.8,516,26,http://content7.flixster.com/movie/28/18/281801_det.jpg
5323,Jason X,2001,jason_x,3.6,101,21,80,20,3.1,20,2,18,10,2.5,10745,38,http://content6.flixster.com/movie/55/35/39/5535396_det.jpg
5324,Life or Something Like It,2002,life_or_something_like_it,4.5,117,32,85,27,4.4,30,7,23,23,2.8,6498,48,http://content7.flixster.com/movie/10/88/37/10883721_det.jpg
5325,Dogtown and Z-Boys,2001,dogtown_and_zboys,7.5,93,85,8,91,7.5,29,27,2,93,3.9,3418,86,http://content6.flixster.com/movie/10/91/74/10917488_det.jpg
5326,"Frank McKlusky, C.I.",2002,frank_mcklusky_ci,0,3,0,3,0,0,0,0,0,0,0,0,0,http://content9.flixster.com/movie/26/51/265107_det.jpg
5327,√âloge de l'amour,2001,in_praise_of_love,5.7,72,37,35,51,6.1,26,15,11,57,3.4,600,59,http://content7.flixster.com/movie/26/40/264017_det.jpg
5328,Singin' in the Rain,1952,singin_in_the_rain,9.2,44,44,0,100,8.8,9,9,0,100,3.9,28033,91,http://content7.flixster.com/movie/10/93/77/10937761_det.jpg
5329,The Salton Sea,2002,salton_sea,5.8,84,53,31,63,5.5,25,14,11,56,3.7,4972,81,http://content8.flixster.com/movie/10/92/75/10927510_det.jpg
5331,Vulgar,2000,vulgar,3.2,26,6,20,23,2.2,7,1,6,14,2.8,944,40,http://content7.flixster.com/movie/28/80/288013_det.jpg
5332,The Aviator,2004,aviator,7.8,212,185,27,87,7.5,44,36,8,81,3.4,27084,73,http://content7.flixster.com/movie/10/93/85/10938553_det.jpg
5333,Bob le flambeur,1956,bob_le_flambeur,8.1,29,28,1,96,7.2,6,5,1,83,4,1464,88,http://content7.flixster.com/movie/10/92/42/10924269_det.jpg
5334,Cadillac Man,1990,cadillac_man,5.3,10,5,5,50,0,2,1,1,50,2.7,1895,29,http://content6.flixster.com/movie/28/11/281112_det.jpg
5335,The Coca-Cola Kid,1985,the-coca-cola-kid,5.1,16,7,9,43,0,4,1,3,25,2.9,374,35,http://content6.flixster.com/movie/97/32/02/9732020_det.jpg
5336,Soy Cuba,1964,i_am_cuba,8.6,31,31,0,100,8.9,7,7,0,100,4.2,1082,91,http://content8.flixster.com/movie/29/69/296918_det.jpg
5337,Delirious,2006,10007902-delirious,6.8,56,47,9,83,6.9,20,17,3,85,3.2,2792,52,http://content8.flixster.com/movie/51/24/50/5124506_det.jpg
5338,Full Moon in Blue Water,1988,full_moon_in_blue_water,4.2,6,1,5,16,0,1,0,1,0,2.9,281,30,http://content9.flixster.com/movie/28/37/283791_det.jpg
5339,Husbands and Wives,1992,1040798-husbands_and_wives,8.3,35,35,0,100,7.9,9,9,0,100,3.8,3905,83,http://content6.flixster.com/movie/32/02/86/3202860_det.jpg
5340,G.I. Joe: The Rise of Cobra,2009,gi_joe,4.6,153,52,101,33,3.8,25,6,19,24,3.3,302453,62,http://content6.flixster.com/movie/11/12/33/11123308_det.jpg
5341,Lenny,1974,lenny,8.1,16,16,0,100,0,0,0,0,0,0,0,0,http://content8.flixster.com/movie/27/47/274798_det.jpg
5342,Nomads,2001,,\N,\N,\N,\N,\N,\N,\N,\N,\N,\N,\N,\N,\N,\N
5343,The Temp,1993,temp,4,19,6,13,31,0,4,0,4,0,2.6,338,16,http://content6.flixster.com/movie/10/84/57/10845772_det.jpg
5344,Thief of Hearts,1984,thief_of_hearts,3.2,6,0,6,0,0,0,0,0,0,0,0,0,http://content6.flixster.com/movie/10/88/20/10882048_det.jpg
5345,Triumph of the Spirit,1989,triumph_of_the_spirit,4.9,6,3,3,50,0,1,0,1,0,3.2,317,53,http://content9.flixster.com/movie/27/58/275827_det.jpg
5346,Wild Orchid,1989,wild_orchid,3,13,1,12,7,0,1,0,1,0,0,0,0,http://content8.flixster.com/movie/26/83/268310_det.jpg
5347,Deuces Wild,2002,deuces_wild,2.9,65,2,63,3,2.9,17,0,17,0,3,2133,52,http://content6.flixster.com/movie/27/95/279528_det.jpg
5348,Hollywood Ending,2002,hollywood_ending,5.4,130,60,70,46,5.3,35,13,22,37,3.2,3322,50,http://content8.flixster.com/movie/26/38/263898_det.jpg
5349,Spider-Man,2002,citizen-pinoy-the-basic-questions,0,0,0,0,0,0,0,0,0,0,0,0,0,http://content6.flixster.com/movie/10/89/27/10892728_det.jpg
5350,The Mystic Masseur,2001,mystic_masseur,5.8,64,33,31,51,6.1,23,14,9,60,3,60,36,http://content6.flixster.com/movie/10/84/35/10843504_det.jpg
5351,Akai hashi no shita no nurui mizu,2001,warm_water_under_a_red_bridge,6.9,42,33,9,78,6.6,10,7,3,70,3.6,563,72,http://content9.flixster.com/movie/10/87/94/10879495_det.jpg
5352,The Big Sleep,1946,1002352-big_sleep,8.6,43,41,2,95,7.5,8,7,1,87,4.1,7772,91,http://content9.flixster.com/movie/10/89/25/10892543_det.jpg
5353,Butterflies Are Free,1972,butterflies_are_free,6.1,7,5,2,71,0,0,0,0,0,0,0,0,http://content8.flixster.com/movie/26/17/261710_det.jpg
5354,Cactus Flower,1969,cactus_flower,7.1,10,10,0,100,0,1,1,0,100,3.6,1005,73,http://content7.flixster.com/movie/10/91/64/10916493_det.jpg
5355,The Cassandra Crossing,1976,cassandra_crossing,4.9,7,2,5,28,0,0,0,0,0,0,0,0,http://content6.flixster.com/movie/10/95/41/10954148_det.jpg
5356,The Giant Spider Invasion,1975,giant_spider_invasion,0,1,0,1,0,0,0,0,0,0,0,0,0,http://content9.flixster.com/movie/10/89/12/10891219_det.jpg
5357,Iron Will,1994,iron_will,5.8,12,7,5,58,0,2,0,2,0,3.1,3444,61,http://content8.flixster.com/movie/25/84/258402_det.jpg
5358,Mountains of the Moon,1990,mountains_of_the_moon,6.6,12,9,3,75,0,2,1,1,50,3.7,432,74,http://content8.flixster.com/movie/27/88/278822_det.jpg
5359,Rambling Rose,1991,rambling_rose,7.2,17,17,0,100,7.4,5,5,0,100,3,541,40,http://content9.flixster.com/movie/27/69/276991_det.jpg
5360,Soul Survivors,2001,soul_survivors,2.6,47,2,45,4,2.3,11,0,11,0,2.6,2441,34,http://content9.flixster.com/movie/27/72/277227_det.jpg
5361,White Fang,1991,1032182-white_fang,5.9,18,12,6,66,0,4,3,1,75,3.1,4170,62,http://content9.flixster.com/movie/11/13/55/11135575_det.jpg
5362,White Fang 2: Myth of the White Wolf,1994,white_fang_2_myth_of_the_white_wolf,6.4,6,4,2,66,0,2,2,0,100,3.2,1366,56,http://content8.flixster.com/movie/11/13/55/11135570_det.jpg
5363,The New Guy,2002,1112617-new_guy,3.1,91,6,85,6,3.5,22,3,19,13,3,9884,60,http://content7.flixster.com/movie/26/07/260721_det.jpg
5364,Unfaithful,2002,unfaithful,5.7,159,77,82,48,5.8,35,16,19,45,3.3,12656,70,http://content7.flixster.com/movie/10/89/39/10893961_det.jpg
5365,L'anglaise et le duc,2001,lady_and_the_duke,6.6,70,50,20,71,7,25,21,4,84,3.4,337,55,http://content7.flixster.com/movie/26/56/265617_det.jpg
5366,Whore,2008,10010418-whore,0,1,0,1,0,0,0,0,0,0,0,0,0,http://content9.flixster.com/movie/10/89/55/10895571_det.jpg
5367,My Beautiful Laundrette,1985,my_beautiful_laundrette,8.1,18,18,0,100,0,1,1,0,100,3.7,1973,75,http://content6.flixster.com/movie/27/41/274120_det.jpg
5368,Ballada o soldate,1959,ballad_of_a_soldier,8.5,12,12,0,100,0,1,1,0,100,4.2,814,91,http://content9.flixster.com/movie/30/03/300391_det.jpg
5369,Big Bad Mama,1974,big_bad_mama,5.5,11,7,4,63,0,0,0,0,0,0,0,0,http://content9.flixster.com/movie/11/13/64/11136407_det.jpg
5370,Big Bad Mama II,1987,big_bad_mama_ii,0,0,0,0,0,0,0,0,0,0,0,0,0,http://content7.flixster.com/movie/11/13/64/11136405_det.jpg
5371,Buio Omega,1979,beyond_the_darkness,0,0,0,0,0,0,0,0,0,0,0,0,0,http://content8.flixster.com/movie/10/99/70/10997042_det.jpg
5372,Calamity Jane,1953,1003399-calamity_jane,5.7,9,6,3,66,0,0,0,0,0,0,0,0,http://content8.flixster.com/movie/10/20/45/10204554_det.jpg
5373,Letyat zhuravli,1957,the-cranes-are-flying,8.1,17,16,1,94,0,2,1,1,50,4.2,1056,93,http://content6.flixster.com/movie/29/67/296796_det.jpg
5374,The Devil-Doll,1936,the-devildoll-the-witch-of-timbuctoo,0,0,0,0,0,0,0,0,0,0,0,0,0,http://content6.flixster.com/movie/10/87/02/10870292_det.jpg
5375,The Harvey Girls,1946,harvey_girls,7.5,6,6,0,100,0,0,0,0,0,0,0,0,http://content8.flixster.com/movie/29/62/296226_det.jpg
5376,The Lady in Red,1979,lady_in_red,0,2,1,1,50,0,0,0,0,0,0,0,0,http://content9.flixster.com/movie/10/86/04/10860423_det.jpg
5377,About a Boy,2002,about_a_boy,7.7,159,148,11,93,7.5,35,32,3,91,2.8,137687,51,http://content7.flixster.com/movie/10/89/01/10890129_det.jpg
5378,Star Wars: Episode II - Attack of the Clones,2002,star_wars_episode_ii_attack_of_the_clones,6.5,215,142,73,66,5.5,40,16,24,40,3.3,108730,69,http://content7.flixster.com/movie/10/94/47/10944721_det.jpg
5379,Believers,2007,1183429-believers,0,3,0,3,0,0,0,0,0,0,0,0,0,http://content9.flixster.com/movie/10/14/14/10141427_det.jpg
5380,The Importance of Being Earnest,2002,,\N,\N,\N,\N,\N,\N,\N,\N,\N,\N,\N,\N,\N,\N
5381,The Charge of the Light Brigade,1968,balaclava-1854,0,0,0,0,0,0,0,0,0,0,0,0,0,http://content8.flixster.com/movie/10/84/10/10841014_det.jpg
5382,Every Which Way But Loose,1978,every_which_way_but_loose,4.5,13,4,9,30,0,0,0,0,0,0,0,0,http://content8.flixster.com/movie/25/75/257522_det.jpg
5383,The Hound of the Baskervilles,1959,1010004-hound_of_the_baskervilles,7.8,11,11,0,100,0,0,0,0,0,0,0,0,http://content6.flixster.com/movie/11/13/75/11137592_det.jpg
5384,I Want to Live!,1958,i_want_to_live,7.9,11,11,0,100,0,0,0,0,0,0,0,0,http://content7.flixster.com/movie/10/89/10/10891013_det.jpg
5385,The Last Waltz,1978,last_waltz,8.4,39,38,1,97,8.1,12,11,1,91,4.3,3891,92,http://content8.flixster.com/movie/12/87/75/1287750_det.jpg
5386,The Pride and the Passion,1957,pride_and_the_passion,4.8,7,1,6,14,0,1,1,0,100,3,672,35,http://content9.flixster.com/movie/10/87/46/10874635_det.jpg
5387,Enough,2002,1114051-enough,4,121,26,95,21,3.9,30,5,25,16,3.1,15185,71,http://content6.flixster.com/movie/10/88/19/10881972_det.jpg
5388,Insomnia,2002,1114154-insomnia,7.7,166,153,13,92,7.8,33,31,2,93,3.2,18085,66,http://content6.flixster.com/movie/27/69/276996_det.jpg
5389,Spirit: Stallion of the Cimarron,2002,spirit_stallion_of_the_cimarron,6.4,125,86,39,68,6.9,29,23,6,79,3.3,8302,72,http://content9.flixster.com/movie/10/87/48/10874827_det.jpg
5390,CQ,2001,cq,6.2,73,48,25,65,5.8,22,14,8,63,3.4,1171,66,http://content9.flixster.com/movie/27/79/277903_det.jpg
5391,Thirteen Conversations About One Thing,2001,thirteen_conversations_about_one_thing,7.4,108,89,19,82,6.9,25,19,6,76,3.4,2120,65,http://content7.flixster.com/movie/10/37/88/10378897_det.jpg
5392,Bus Stop,1956,1003296-bus_stop,7.6,10,9,1,90,0,0,0,0,0,0,0,0,http://content8.flixster.com/movie/10/86/99/10869950_det.jpg
5393,Midnight Cowboy,1969,midnight_cowboy,8.3,49,44,5,89,6.8,6,5,1,83,3.9,8994,87,http://content6.flixster.com/movie/10/88/51/10885192_det.jpg
5394,Don't Bother to Knock,1952,dont_bother_to_knock,6.8,7,7,0,100,0,0,0,0,0,0,0,0,http://content8.flixster.com/movie/30/28/302810_det.jpg
5395,"Dr. Mabuse, der Spieler - Ein Bild der Zeit",1922,dr_mabuse_the_gambler,7.4,11,10,1,90,0,1,0,1,0,4.1,721,90,http://content7.flixster.com/movie/10/88/71/10887161_det.jpg
5396,Let's Make Love,1960,lets_make_love,5.5,11,7,4,63,0,0,0,0,0,0,0,0,http://content7.flixster.com/movie/10/92/01/10920169_det.jpg
5397,Monkey Business,1931,1014137-monkey_business,7.8,12,11,1,91,0,0,0,0,0,0,0,0,http://content6.flixster.com/movie/10/86/15/10861560_det.jpg
5398,Requiem for a Heavyweight,1962,1080265-requiem_for_a_heavyweight,7.6,8,7,1,87,0,0,0,0,0,0,0,0,http://content9.flixster.com/movie/14/81/37/1481379_det.jpg
5399,River of No Return,1954,river_of_no_return,5.8,13,8,5,61,0,3,3,0,100,3.4,1421,59,http://content6.flixster.com/movie/10/87/53/10875372_det.jpg
5400,The Sum of All Fears,2002,sum_of_all_fears,6,166,98,68,59,5.6,35,16,19,45,3,11603,53,http://content6.flixster.com/movie/10/84/98/10849880_det.jpg
5401,Undercover Brother,2002,undercover_brother,6.6,126,96,30,76,6.1,24,17,7,70,2.8,7732,60,http://content6.flixster.com/movie/25/99/259924_det.jpg
5402,The Diaries of Vaslav Nijinsky,2001,nijinsky_2002,0,0,0,0,0,0,0,0,0,0,0,0,0,http://content8.flixster.com/movie/10/84/92/10849254_det.jpg
5403,The Sleepy Time Gal,2001,sleepy_time_gal,6.9,19,15,4,78,7.5,7,6,1,85,3.3,174,45,http://content7.flixster.com/movie/28/46/284621_det.jpg
5404,84 Charing Cross Road,1987,84_charing_cross_road,7.4,15,12,3,80,0,2,0,2,0,3.7,1344,76,http://content7.flixster.com/movie/25/67/256797_det.jpg
5405,Dakota,1945,1005131-dakota,0,2,0,2,0,0,0,0,0,0,0,0,0,http://content9.flixster.com/movie/10/89/16/10891627_det.jpg
5406,The Desert Rats,1953,desert_rats,6.3,5,4,1,80,0,0,0,0,0,0,0,0,http://content9.flixster.com/movie/10/87/30/10873035_det.jpg
5407,La b√ªche,1999,la_buche,6.4,20,14,6,70,6.6,7,5,2,71,3.4,364,60,http://content8.flixster.com/movie/30/38/303806_det.jpg
5408,Nora inu,1949,1020312-stray_dog,7.4,15,14,1,93,0,0,0,0,0,0,0,0,http://content7.flixster.com/movie/29/82/298201_det.jpg
5409,Rapid Fire,1992,1040198-rapid_fire,4.7,14,4,10,28,0,4,0,4,0,3.1,3041,51,http://content7.flixster.com/movie/27/50/275097_det.jpg
5410,Silent Running,1972,silent_running,6.6,25,17,8,68,0,4,3,1,75,3.5,2762,69,http://content8.flixster.com/movie/25/35/253514_det.jpg
5411,Summer Holiday,1963,1113757-summer_holiday,0,1,0,1,0,0,0,0,0,0,0,0,0,http://content9.flixster.com/movie/30/31/303103_det.jpg
5412,The Villain,1979,villain,3.7,7,0,7,0,0,0,0,0,0,0,0,0,http://content6.flixster.com/movie/10/93/11/10931172_det.jpg
5413,Zombi Holocaust,1980,zombie_holocaust,0,2,0,2,0,0,0,0,0,0,0,0,0,http://content6.flixster.com/movie/27/79/277996_det.jpg
5414,Bad Company,2002,1114548-bad_company,3.9,134,14,120,10,4,31,5,26,16,2.8,6415,42,http://content6.flixster.com/movie/26/66/266604_det.jpg
5415,Divine Secrets of the Ya-Ya Sisterhood,2002,divine_secrets_of_the_yaya_sisterhood,5.3,142,62,80,43,5.3,34,17,17,50,3.2,12363,63,http://content9.flixster.com/movie/10/89/02/10890223_det.jpg
5416,Cherish,2002,cherish,5.7,76,36,40,47,5.8,23,11,12,47,3.4,572,60,http://content7.flixster.com/movie/27/78/277897_det.jpg
5417,Atanarjuat,2001,fast_runner,8,94,85,9,90,8.5,26,25,1,96,3.8,1275,80,http://content6.flixster.com/movie/10/91/62/10916272_det.jpg
5418,The Bourne Identity,2002,bourne_identity,7,180,148,32,82,6.9,37,30,7,81,3.9,125823,91,http://content9.flixster.com/movie/10/81/65/10816575_det.jpg
5419,Scooby-Doo,2002,1112357-scoobydoo,4.4,138,39,99,28,4.8,29,12,17,41,2.7,20362,49,http://content7.flixster.com/movie/10/86/10/10861017_det.jpg
5420,Windtalkers,2002,windtalkers,5.1,164,53,111,32,5.3,37,13,24,35,3.2,15905,57,http://content7.flixster.com/movie/10/85/08/10850853_det.jpg
5421,The Dangerous Lives of Altar Boys,2002,country-boys,0,0,0,0,0,0,0,0,0,0,0,0,0,http://content8.flixster.com/movie/10/85/15/10851526_det.jpg
5422,The Emperor's New Clothes,2001,emperors_new_clothes,6.6,84,62,22,73,6.6,26,19,7,73,3.4,293,61,http://content8.flixster.com/movie/10/88/94/10889494_det.jpg
5423,Gangster No. 1,2000,gangster-no-1,6.4,51,37,14,72,6.3,12,8,4,66,3.7,2271,76,http://content9.flixster.com/movie/10/87/93/10879307_det.jpg
5424,Harvard Man,2001,harvard_man,4.6,36,12,24,33,5.3,14,6,8,42,2.7,1487,34,http://content9.flixster.com/movie/10/87/17/10871783_det.jpg
5425,Tmavomodr√Ω svet,2001,dark_blue_world,6.2,58,36,22,62,6.5,20,13,7,65,3.8,719,82,http://content6.flixster.com/movie/27/39/273920_det.jpg
5426,Bad Company,2002,1114548-bad_company,3.9,134,14,120,10,4,31,5,26,16,2.8,6415,42,http://content6.flixster.com/movie/26/66/266604_det.jpg
5427,Caveman,1981,caveman,4.1,15,3,12,20,0,2,1,1,50,3,1935,52,http://content7.flixster.com/movie/10/89/74/10897425_det.jpg
5428,Cheech & Chong's The Corsican Brothers,1984,,0,1,0,1,0,0,0,0,0,0,0,0,0,http://content8.flixster.com/movie/10/87/27/10872706_det.jpg
5429,5 Card Stud,1968,1007472-five_card_stud,0,1,1,0,100,0,1,1,0,100,3.3,527,55,http://content9.flixster.com/movie/10/89/25/10892599_det.jpg
5431,Goin' South,1978,goin_south,6.6,10,9,1,90,0,0,0,0,0,0,0,0,http://content8.flixster.com/movie/10/89/74/10897426_det.jpg
5432,Hero and the Terror,1988,hero_and_the_terror,3.6,5,0,5,0,0,1,0,1,0,2.9,782,45,http://content7.flixster.com/movie/27/71/277105_det.jpg
5433,Silver Bullet,1985,1019007-silver_bullet,5.2,14,7,7,50,0,1,1,0,100,3.2,3559,59,http://content7.flixster.com/movie/10/92/33/10923393_det.jpg
5434,"Sorry, Wrong Number",1948,1032814-sorry_wrong_number,6.8,21,18,3,85,0,3,1,2,33,3.6,1027,78,http://content6.flixster.com/movie/28/65/286504_det.jpg
5435,Pirates of the Caribbean: Dead Man's Chest,2006,,6,217,117,100,53,5.2,39,16,23,41,3.9,395865,86,http://content8.flixster.com/movie/78/63/786362_det.jpg
5436,The Horse's Mouth,1958,horses_mouth,7.5,14,13,1,92,0,0,0,0,0,0,0,0,http://content9.flixster.com/movie/28/79/287907_det.jpg
5437,The Manhattan Project,1986,1013238-manhattan_project,5.5,17,8,9,47,0,1,1,0,100,3,744,47,http://content7.flixster.com/movie/26/42/264221_det.jpg
5438,Men at Work,1990,1029024-men_at_work,4.2,22,7,15,31,0,4,2,2,50,2.7,3778,43,http://content8.flixster.com/movie/10/87/86/10878670_det.jpg
5439,S.O.B.,1981,sob,7.1,14,14,0,100,0,0,0,0,0,0,0,0,http://content7.flixster.com/movie/27/08/270897_det.jpg
5440,She Wore a Yellow Ribbon,1949,she_wore_a_yellow_ribbon,8.3,14,14,0,100,0,0,0,0,0,0,0,0,http://content7.flixster.com/movie/10/89/03/10890309_det.jpg
5441,Traces of Red,1992,traces_of_red,3.5,6,1,5,16,0,2,1,1,50,3,197,35,http://content8.flixster.com/movie/28/40/284018_det.jpg
5442,V.I. Warshawski,1991,vi_warshawski,3.6,20,4,16,20,0,2,1,1,50,2.4,698,25,http://content6.flixster.com/movie/10/95/21/10952104_det.jpg
5443,Juwanna Mann,2002,juwanna_mann,3.2,82,7,75,8,3.2,24,2,22,8,2.5,1219,46,http://content6.flixster.com/movie/26/32/263228_det.jpg
5444,Lilo & Stitch,2002,lilo_and_stitch,7.3,144,123,21,85,7.2,29,22,7,75,3.2,36598,65,http://content6.flixster.com/movie/25/50/255008_det.jpg
5445,Minority Report,2002,minority_report,8,222,203,19,91,7.9,38,34,4,89,3.4,69660,74,http://content9.flixster.com/movie/10/94/48/10944815_det.jpg
5446,Rabbit-Proof Fence,2002,rabbitproof_fence,7.6,133,116,17,87,7.6,29,25,4,86,3.8,5026,85,http://content9.flixster.com/movie/10/87/12/10871259_det.jpg
5447,Sunshine State,2002,sunshine_state,7,106,85,21,80,7,29,23,6,79,3.1,607,50,http://content7.flixster.com/movie/11/12/50/11125097_det.jpg
5448,Hey Arnold! The Movie,2002,hey_arnold_the_movie,4.6,76,23,53,30,4.7,19,6,13,31,2.8,2763,37,http://content9.flixster.com/movie/26/42/264203_det.jpg
5449,Mr. Deeds,2002,mr_deeds,4,153,33,120,21,3.6,30,5,25,16,3.3,69840,68,http://content6.flixster.com/movie/25/97/259704_det.jpg
5450,Lovely & Amazing,2001,lovely_and_amazing,7.3,119,102,17,85,7.3,28,25,3,89,3.4,1223,62,http://content6.flixster.com/movie/10/91/92/10919252_det.jpg
5451,Pumpkin,2002,,4.9,71,27,44,38,5.3,23,10,13,43,3.2,2927,56,http://content7.flixster.com/movie/10/85/88/10858849_det.jpg
5452,Look Who's Talking Now,1993,look_whos_talking_now,2.5,23,0,23,0,3.2,6,0,6,0,2.5,9093,41,http://content7.flixster.com/movie/26/38/263897_det.jpg
5453,Lost in Yonkers,1993,lost_in_yonkers,5.8,16,11,5,68,0,3,1,2,33,3.4,491,70,http://content8.flixster.com/movie/26/06/260602_det.jpg
5454,Mo' Money,1992,mo_money,4,22,3,19,13,0,4,1,3,25,2.9,1450,51,http://content6.flixster.com/movie/27/86/278600_det.jpg
5455,The Object of Beauty,1991,object_of_beauty,6.1,12,9,3,75,0,2,2,0,100,2.9,442,29,http://content7.flixster.com/movie/28/54/285409_det.jpg
5456,Wagons East,1994,wagons_east,1.8,10,0,10,0,0,2,0,2,0,2.5,1055,33,http://content8.flixster.com/movie/10/88/95/10889598_det.jpg
5457,Zebrahead,1992,zebrahead,6.1,14,10,4,71,0,4,3,1,75,3.3,221,62,http://content6.flixster.com/movie/28/33/283392_det.jpg
5458,Like Mike,2002,like_mike,5.5,96,54,42,56,5.7,28,13,15,46,2.8,7917,55,http://content6.flixster.com/movie/11/12/17/11121780_det.jpg
5459,Men in Black II,2002,men_in_black_ii,5.2,187,72,115,38,5.5,34,14,20,41,3.1,54446,57,http://content6.flixster.com/movie/55/06/05/5506052_det.jpg
5460,The Powerpuff Girls,2002,powerpuff_girls_movie,6.1,99,63,36,63,6.2,24,17,7,70,3.1,2190,53,http://content7.flixster.com/movie/11/15/31/11153169_det.jpg
5461,Me Without You,2001,me_without_you,6.2,65,43,22,66,6.3,22,16,6,72,3.8,1522,78,http://content8.flixster.com/movie/10/88/45/10884586_det.jpg
5462,The Crocodile Hunter: Collision Course,2002,crocodile_hunter_collision_course,5.2,81,42,39,51,5.7,20,12,8,60,2.8,4549,51,http://content7.flixster.com/movie/10/91/77/10917789_det.jpg
5463,Reign of Fire,2002,reign_of_fire,5.2,149,59,90,39,4.7,31,13,18,41,3,15531,55,http://content8.flixster.com/movie/10/87/80/10878014_det.jpg
5464,Road to Perdition,2002,road_to_perdition,7.5,205,169,36,82,7.1,37,29,8,78,3.5,23335,81,http://content7.flixster.com/movie/27/83/278309_det.jpg
5465,Riri Shushu no subete,2001,all_about_lily_chouchou,6.7,37,25,12,67,7.3,11,8,3,72,4.1,2372,88,http://content9.flixster.com/movie/10/86/05/10860555_det.jpg
5466,Ma femme est une actrice,2001,my_wife_is_an_actress,6.2,72,47,25,65,6.7,23,17,6,73,3.4,747,66,http://content7.flixster.com/movie/10/90/57/10905733_det.jpg
5467,Never Say Never Again,1983,never_say_never_again,5.9,34,22,12,64,6.2,5,3,2,60,3.1,7414,48,http://content6.flixster.com/movie/25/63/256316_det.jpg
5468,20 Million Miles to Earth,1957,20_million_miles_to_earth,6.4,8,7,1,87,0,0,0,0,0,0,0,0,http://content8.flixster.com/movie/29/61/296118_det.jpg
5469,Grand Theft Auto,1977,grand_theft_auto,4.8,11,3,8,27,0,0,0,0,0,0,0,0,http://content8.flixster.com/movie/10/91/24/10912414_det.jpg
5470,The Importance of Being Earnest,2002,,\N,\N,\N,\N,\N,\N,\N,\N,\N,\N,\N,\N,\N,\N
5471,A Perfect Getaway,2009,a_perfect_getaway,5.8,124,76,48,61,5.9,29,18,11,62,3.2,102622,50,http://content7.flixster.com/movie/10/91/93/10919317_det.jpg
5472,1776,1972,1776,6.8,14,8,6,57,0,1,0,1,0,3.8,2415,80,http://content6.flixster.com/movie/10/88/57/10885736_det.jpg
5473,Faustrecht der Freiheit,1975,fox_and_his_friends,7.8,15,13,2,86,0,3,2,1,66,0,0,0,http://content7.flixster.com/movie/29/79/297905_det.jpg
5474,The Legend of Boggy Creek,1972,legend-of-boggy-creek,0,0,0,0,0,0,0,0,0,0,0,0,0,http://content8.flixster.com/movie/10/86/99/10869974_det.jpg
5475,Dragon Ball Z,1989,,\N,\N,\N,\N,\N,\N,\N,\N,\N,\N,\N,\N,\N,\N
5476,Halloween: Resurrection,2002,halloween_resurrection,3.4,57,6,51,10,3.4,16,2,14,12,2.8,14228,46,http://content6.flixster.com/movie/10/92/14/10921404_det.jpg
5477,Luc√≠a y el sexo,2001,sex_and_lucia,6.5,69,49,20,71,5.8,20,12,8,60,3.9,6145,85,http://content9.flixster.com/movie/10/89/48/10894831_det.jpg
5478,Eight Legged Freaks,2002,eight_legged_freaks,5.5,140,66,74,47,5,25,9,16,36,2.5,10925,36,http://content7.flixster.com/movie/26/67/266717_det.jpg
5479,K-19: The Widowmaker,2002,k19_the_widowmaker,6.1,165,100,65,60,6.3,33,21,12,63,3,6024,50,http://content6.flixster.com/movie/25/89/258904_det.jpg
5480,Stuart Little 2,2002,stuart_little_2,6.9,114,95,19,83,6.9,29,26,3,89,2.7,10893,44,http://content7.flixster.com/movie/25/70/257017_det.jpg
5481,Austin Powers in Goldmember,2002,austin_powers_in_goldmember,5.8,179,97,82,54,5.8,37,22,15,59,3,145625,47,http://content8.flixster.com/movie/16/90/52/1690522_det.jpg
5482,The Country Bears,2002,country_bears,4.3,77,21,56,27,4.2,21,4,17,19,2.7,2600,39,http://content6.flixster.com/movie/10/87/62/10876240_det.jpg
5483,The Kid Stays in the Picture,2002,the-kid-makes-the-picture,0,0,0,0,0,0,0,0,0,0,0,0,0,http://images.rottentomatoescdn.com/images/defaults/poster_default.gif
5484,Xingfu shiguang,2000,happy_times,6.4,60,43,17,71,6.7,20,16,4,80,3.7,927,76,http://content6.flixster.com/movie/26/33/263316_det.jpg
5485,Tadpole,2002,tadpole,6.7,104,81,23,77,6.7,31,24,7,77,3.2,888,56,http://content6.flixster.com/movie/26/44/264496_det.jpg
5486,Who Is Cletis Tout?,2001,who_is_cletis_tout,4.3,55,13,42,23,4.4,20,6,14,30,3.1,596,48,http://content6.flixster.com/movie/28/46/284604_det.jpg
5487,Harry and Walter Go to New York,1976,harry_and_walter_go_to_new_york,5.9,7,4,3,57,0,1,0,1,0,3.3,105,44,http://content7.flixster.com/movie/10/84/79/10847917_det.jpg
5488,H√§ndler der vier Jahreszeiten,1971,merchant_of_four_seasons,7.9,12,11,1,91,0,2,1,1,50,0,0,0,http://content7.flixster.com/movie/30/38/303897_det.jpg
5489,Nosferatu: Phantom der Nacht,1979,nosferatu_the_vampyre,7.6,34,32,2,94,0,4,4,0,100,3.7,5091,81,http://content8.flixster.com/movie/26/48/264822_det.jpg
5490,The Big Bus,1976,big_bus,5.9,5,3,2,60,0,0,0,0,0,0,0,0,http://content9.flixster.com/movie/10/86/99/10869947_det.jpg
5491,The Eddy Duchin Story,1956,eddy_duchin_story,0,2,0,2,0,0,0,0,0,0,0,0,0,http://content8.flixster.com/movie/10/87/88/10878874_det.jpg
5492,Fathom,1967,fathom,5,5,2,3,40,0,0,0,0,0,0,0,0,http://content6.flixster.com/movie/11/12/35/11123532_det.jpg
5493,In Like Flint,1967,in_like_flint,6.2,15,11,4,73,0,1,0,1,0,3.3,618,53,http://content6.flixster.com/movie/28/68/286800_det.jpg
5494,La terra trema: Episodio del mare,1948,la_terra_trema,8.5,6,6,0,100,0,0,0,0,0,0,0,0,http://content7.flixster.com/movie/10/89/58/10895853_det.jpg
5495,Modesty Blaise,1966,modesty_blaise,0,4,1,3,25,0,0,0,0,0,0,0,0,http://content8.flixster.com/movie/28/86/288614_det.jpg
5496,Ossessione,1943,ossessione,8.2,9,9,0,100,0,2,2,0,100,3.9,583,83,http://content8.flixster.com/movie/30/02/300218_det.jpg
5497,Our Man Flint,1966,our_man_flint,6.6,18,15,3,83,0,0,0,0,0,0,0,0,http://content8.flixster.com/movie/28/67/286726_det.jpg
5498,Akahige,1965,red_beard,7.8,11,9,2,81,0,2,2,0,100,4.3,2413,94,http://content7.flixster.com/movie/10/84/02/10840233_det.jpg
5499,The Adventures of Robin Hood,1938,1000355-adventures_of_robin_hood,8.9,43,43,0,100,8.6,7,7,0,100,3.7,6404,84,http://content9.flixster.com/movie/11/14/22/11142287_det.jpg
5500,Top Secret!,1984,1021699-top_secret,6.4,25,19,6,76,0,1,1,0,100,3.4,8375,77,http://content9.flixster.com/movie/25/49/254927_det.jpg
5501,The Master of Disguise,2002,master_of_disguise,2.2,97,2,95,2,2.2,26,0,26,0,2.3,6303,39,http://content7.flixster.com/movie/26/09/260917_det.jpg
5502,Signs,2002,signs,6.8,223,164,59,73,5.9,39,22,17,56,3.2,63081,65,http://content6.flixster.com/movie/10/89/48/10894808_det.jpg
5503,L'ultimo bacio,2001,1114866-last_kiss,6.4,78,57,21,73,6.4,25,17,8,68,3.8,2248,77,http://content8.flixster.com/movie/26/87/268722_det.jpg
5504,Spy Kids 2: Island of Lost Dreams,2002,spy_kids_2_island_of_lost_dreams,6.6,127,95,32,74,6.7,30,23,7,76,2.6,12329,43,http://content8.flixster.com/movie/10/86/89/10868998_det.jpg
5505,The Good Girl,2002,a-good-death-beats-a-dull-life,0,0,0,0,0,0,0,0,0,0,0,0,0,http://content7.flixster.com/movie/10/88/48/10884801_det.jpg
5506,Blood Work,2002,blood_work,5.6,147,79,68,53,6.3,34,24,10,70,3,4504,42,http://content9.flixster.com/movie/27/73/277307_det.jpg
5507,xXx,2002,xxx,5.6,174,83,91,47,5,32,11,21,34,3.2,47523,69,http://content9.flixster.com/movie/11/12/63/11126395_det.jpg
5508,24 Hour Party People,2002,manchester-fiesta-part-1,0,0,0,0,0,0,0,0,0,0,0,0,0,http://content9.flixster.com/movie/10/90/12/10901271_det.jpg
5509,Biggie and Tupac,2002,biggie_and_tupac,6.7,47,38,9,80,5.9,15,10,5,66,3.8,1434,79,http://content7.flixster.com/movie/10/90/06/10900681_det.jpg
5510,The Ch√¢teau,2001,chateau,5.3,52,26,26,50,5,15,6,9,40,2.7,261,28,http://content6.flixster.com/movie/28/27/282792_det.jpg
5511,Die B√ºchse der Pandora,1929,pandoras_box,8.5,23,21,2,91,8.1,8,6,2,75,4.1,1316,88,http://content9.flixster.com/movie/93/51/65/9351659_det.jpg
5512,Raye makhfi,2001,secret_ballot,7,57,47,10,82,6.8,16,13,3,81,3.4,349,62,http://content9.flixster.com/movie/25/29/252927_det.jpg
5513,Martin Lawrence Live: Runteldat,2002,martin_lawrence_live_runteldat,5,56,21,35,37,5.6,22,11,11,50,3.8,23,71,http://images.rottentomatoescdn.com/images/defaults/poster_default.gif
5514,Lan yu,2001,lan_yu,6.2,34,22,12,64,6.1,13,8,5,61,3.9,584,83,http://content6.flixster.com/movie/85/77/857796_det.jpg
5515,S√•nger fr√•n andra v√•ningen,2000,songs-from-the-second-floor,7.4,33,29,4,87,8,11,11,0,100,4.2,2079,90,http://content9.flixster.com/movie/29/81/298123_det.jpg
5516,Sur mes l√®vres,2001,read_my_lips,7.8,95,92,3,96,8.1,26,25,1,96,3.8,1495,81,http://content8.flixster.com/movie/10/88/74/10887498_det.jpg
5517,Merci pour le chocolat,2000,merci-pour-le-chocolat,7.2,50,42,8,84,7.8,15,15,0,100,3.5,668,64,http://content8.flixster.com/movie/30/81/308106_det.jpg
5518,Beau-p√®re,1981,beau_pere,6.6,5,4,1,80,0,1,1,0,100,3.5,254,73,http://content9.flixster.com/movie/10/92/32/10923287_det.jpg
5519,Change of Habit,1969,change_of_habit,4,10,1,9,10,0,0,0,0,0,0,0,0,http://content6.flixster.com/movie/25/19/251920_det.jpg
5520,Une affaire de go√ªt,2000,a-matter-of-taste,0,0,0,0,0,0,0,0,0,0,0,0,0,http://content9.flixster.com/movie/10/84/93/10849331_det.jpg
5521,Lean on Me,1989,lean_on_me,5.8,14,9,5,64,0,1,0,1,0,3.7,5235,86,http://content6.flixster.com/movie/25/68/256820_det.jpg
5522,Rollerball,1975,1017814-rollerball,6,25,17,8,68,0,4,1,3,25,3.2,2655,61,http://content8.flixster.com/movie/27/22/272218_det.jpg
5523,The Adventures of Pluto Nash,2002,adventures_of_pluto_nash,2.7,72,4,68,5,2.2,13,0,13,0,2,3816,20,http://content8.flixster.com/movie/26/57/265718_det.jpg
5524,Blue Crush,2002,1113404-crush,5,78,27,51,34,5,24,8,16,33,3.2,804,58,http://content6.flixster.com/movie/10/88/47/10884704_det.jpg
5525,Bella Martha,2001,mostly_martha,7.2,82,75,7,91,7,25,22,3,88,4,2477,88,http://content7.flixster.com/movie/10/92/31/10923101_det.jpg
5526,Seom,2000,seom-the-isle,6.2,32,24,8,75,7,8,7,1,87,3.7,1897,73,http://content8.flixster.com/movie/28/80/288010_det.jpg
5527,Possession,2009,10009228-possession,0,2,0,2,0,0,1,0,1,0,2.9,4231,34,http://content7.flixster.com/movie/10/86/81/10868161_det.jpg
5528,One Hour Photo,2002,family-flaw,0,0,0,0,0,0,0,0,0,0,0,0,0,http://content9.flixster.com/movie/10/85/41/10854183_det.jpg
5529,Serving Sara,2002,serving_sara,3,105,5,100,4,3.1,24,2,22,8,2.4,2909,31,http://content6.flixster.com/movie/26/29/262900_det.jpg
5530,S1m0ne,2002,,5.8,154,78,76,50,5,34,12,22,35,2.8,2552,33,http://content9.flixster.com/movie/10/84/93/10849387_det.jpg
5531,Undisputed,2002,undisputed,5.5,103,50,53,48,6.1,29,19,10,65,3.2,2298,56,http://content7.flixster.com/movie/27/99/279993_det.jpg
5532,Amy's Orgasm,2001,amys_o,4.4,30,8,22,26,5.4,8,4,4,50,2.8,555,33,http://content8.flixster.com/movie/10/87/27/10872770_det.jpg
5533,Children on Their Birthdays,2002,children_on_their_birthdays,0,3,0,3,0,0,1,0,1,0,3.3,281,57,http://content8.flixster.com/movie/26/47/264714_det.jpg
5534,Hush,1998,1082899-hush,3.4,37,4,33,10,3.2,8,0,8,0,2.9,1448,43,http://content9.flixster.com/movie/10/87/07/10870779_det.jpg
5535,Comment j'ai tu√© mon p√®re,2001,how-i-killed-my-father,0,0,0,0,0,0,0,0,0,0,0,0,0,http://content7.flixster.com/movie/10/85/15/10851561_det.jpg
5537,Satin rouge,2002,satin_rouge,6.9,47,39,8,82,7.1,19,17,2,89,3.5,291,64,http://content9.flixster.com/movie/30/03/300319_det.jpg
5538,The Care Bears Movie,1985,stellaluna_2004,0,0,0,0,0,0,0,0,0,0,0,0,0,http://content6.flixster.com/movie/25/15/251524_det.jpg
5539,Care Bears Movie II: A New Generation,1986,care_bears_movie_2_a_new_generation,0,0,0,0,0,0,0,0,0,0,0,0,0,http://content7.flixster.com/movie/10/94/34/10943409_det.jpg
5540,Clash of the Titans,1981,clash_of_the_titans,5.8,37,24,13,64,0,2,1,1,50,3.4,10585,70,http://content9.flixster.com/movie/11/15/28/11152887_det.jpg
5541,Hot Shots!,1991,1036179-hot_shots,6.5,22,18,4,81,0,1,1,0,100,3,14175,63,http://content8.flixster.com/movie/25/63/256310_det.jpg
5542,Nightmare City 2035,2007,nightmare-city-2035,0,0,0,0,0,0,0,0,0,0,0,0,0,http://images.rottentomatoescdn.com/images/defaults/poster_default.gif
5543,Shark Swarm,2008,shark_swarm,0,1,0,1,0,0,0,0,0,0,0,0,0,http://content6.flixster.com/movie/10/84/55/10845552_det.jpg
5544,Time After Time,1979,time_after_time,7.2,28,24,4,85,0,4,3,1,75,3.5,1546,68,http://content9.flixster.com/movie/10/92/43/10924387_det.jpg
5545,The Unearthly,1957,unearthly,0,2,1,1,50,0,0,0,0,0,0,0,0,http://content9.flixster.com/movie/35/40/96/3540963_det.jpg
5546,976-Evil II,1992,976evil-ii,0,0,0,0,0,0,0,0,0,0,0,0,0,http://content6.flixster.com/movie/10/84/29/10842996_det.jpg
5547,Camilla,1994,camilla,5.2,5,2,3,40,0,2,0,2,0,3,598,31,http://content8.flixster.com/movie/26/45/264594_det.jpg
5548,Down and Out in Beverly Hills,1986,down_and_out_in_beverly_hills,6.8,24,20,4,83,0,4,3,1,75,2.9,2039,49,http://content8.flixster.com/movie/27/29/272906_det.jpg
5549,Flaming Star,1960,flaming_star,7.3,10,9,1,90,0,0,0,0,0,0,0,0,http://content7.flixster.com/movie/27/07/98/2707981_det.jpg
5550,Love Me Tender,1956,love_me_tender,5.4,8,3,5,37,0,0,0,0,0,0,0,0,http://content9.flixster.com/movie/10/88/39/10883923_det.jpg
5551,The Return of the Vampire,1944,return_of_the_vampire,5.3,5,3,2,60,0,0,0,0,0,0,0,0,http://content7.flixster.com/movie/10/85/82/10858249_det.jpg
5552,The Revenge of Frankenstein,1958,revenge_of_frankenstein,6.2,7,6,1,85,0,0,0,0,0,0,0,0,http://content9.flixster.com/movie/28/78/287815_det.jpg
5553,Stakeout,1987,1019779-stakeout,6.5,18,15,3,83,0,1,1,0,100,2.9,2040,50,http://content7.flixster.com/movie/27/16/271625_det.jpg
5554,Wild in the Country,1961,wild_in_the_country,5.8,8,4,4,50,0,0,0,0,0,0,0,0,http://content7.flixster.com/movie/35/68/13/3568133_det.jpg
5555,Wolfen,1981,wolfen,5.8,22,16,6,72,0,1,1,0,100,3,988,45,http://content9.flixster.com/movie/27/10/271007_det.jpg
5556,FeardotCom,2002,fear_dot_com,2.6,87,3,84,3,3,15,0,15,0,2.3,7455,28,http://content8.flixster.com/movie/28/08/280806_det.jpg
5557,Slap Her... She's French,2002,slap-her-shes-french,4.7,25,9,16,36,0,2,0,2,0,2.9,1785,45,http://content8.flixster.com/movie/10/90/01/10900190_det.jpg
5558,Love and a Bullet,2002,love_and_a_bullet,0,2,0,2,0,0,0,0,0,0,0,0,0,http://content6.flixster.com/movie/10/92/33/10923388_det.jpg
5559,Juana la Loca,2001,1118498-mad_love,5.3,49,23,26,46,5.6,14,6,8,42,3.6,465,67,http://content7.flixster.com/movie/27/51/275197_det.jpg
5560,√Ä nous la libert√©,1931,a_nous_la_liberte,8.3,16,16,0,100,0,2,2,0,100,3.7,914,76,http://content9.flixster.com/movie/10/89/17/10891715_det.jpg
5561,True Colors,1991,1033465-true_colors,5,14,7,7,50,0,4,0,4,0,3,876,47,http://content7.flixster.com/movie/10/87/54/10875477_det.jpg
5562,Blade,1998,1083484-blade,5.7,83,46,37,55,4.6,24,7,17,29,3.6,87683,78,http://content6.flixster.com/movie/35/84/20/3584204_det.jpg
5563,City by the Sea,2002,city_by_the_sea,5.8,140,67,73,47,5.8,33,17,16,51,2.9,3070,41,http://content7.flixster.com/movie/27/75/277501_det.jpg
5564,Swimfan,2002,swimfan,3.9,89,13,76,14,4.3,16,4,12,25,2.5,5068,38,http://content6.flixster.com/movie/10/88/37/10883720_det.jpg
5567,Incubus,2006,incubus,0,3,0,3,0,0,0,0,0,0,0,0,0,http://content8.flixster.com/movie/10/93/72/10937258_det.jpg
5568,Johnny Dangerously,1984,johnny_dangerously,5,15,7,8,46,0,1,0,1,0,3.2,1967,60,http://content7.flixster.com/movie/25/74/257409_det.jpg
5569,The Last House on the Left,2009,1205377-last_house_on_the_left,4.9,143,60,83,41,4.5,29,12,17,41,2.7,137767,55,http://content6.flixster.com/movie/10/89/43/10894312_det.jpg
5570,Tesis,1996,thesis,6.8,7,5,2,71,0,0,0,0,0,0,0,0,http://content7.flixster.com/movie/27/70/277093_det.jpg
5572,Barbershop 2: Back in Business,2004,barbershop_2_back_in_business,6.3,123,84,39,68,6.4,34,23,11,67,3.1,7601,58,http://content7.flixster.com/movie/10/86/73/10867301_det.jpg
5573,Stealing Harvard,2002,stealing_harvard,3.2,102,8,94,7,3.2,25,1,24,4,2.7,2451,42,http://content8.flixster.com/movie/10/87/17/10871782_det.jpg
5574,The Transporter,2002,transporter,5.6,122,65,57,53,5.1,28,13,15,46,3.5,52782,78,http://content9.flixster.com/movie/25/54/255403_det.jpg
5575,Betty Fisher et autres histoires,2001,alias_betty,7.2,51,47,4,92,7.3,19,18,1,94,3.4,366,57,http://content9.flixster.com/movie/10/89/10/10891047_det.jpg
5576,Les enfants du si√®cle,1999,children-of-the-century,5.2,42,18,24,42,5.4,12,5,7,41,3.6,422,71,http://content6.flixster.com/movie/11/15/07/11150796_det.jpg
5577,Igby Goes Down,2002,igby_goes_down,6.9,126,96,30,76,6.9,32,24,8,75,3.4,8640,77,http://content7.flixster.com/movie/10/90/14/10901449_det.jpg
5580,Aspen Extreme,1993,aspen_extreme,3.8,9,2,7,22,0,1,0,1,0,2.9,1218,51,http://content7.flixster.com/movie/25/94/259409_det.jpg
5581,Betsy's Wedding,1990,betsys_wedding,5.3,7,3,4,42,0,2,1,1,50,2.8,904,41,http://content7.flixster.com/movie/21/77/84/2177845_det.jpg
5582,Captain Ron,1992,captain_ron,4.2,13,3,10,23,0,2,0,2,0,2.7,4124,44,http://content8.flixster.com/movie/10/87/31/10873166_det.jpg
5583,The Devil Bat,1940,devil-bat,5.6,9,5,4,55,0,0,0,0,0,0,0,0,http://content9.flixster.com/movie/30/53/305323_det.jpg
5584,Ernest Goes to Jail,1990,ernest_goes_to_jail,3.8,8,1,7,12,0,0,0,0,0,0,0,0,http://content6.flixster.com/movie/25/98/259816_det.jpg
5585,Ernest Scared Stupid,1991,ernest-scared-stupid,3.2,5,1,4,20,0,0,0,0,0,0,0,0,http://content8.flixster.com/movie/10/86/99/10869998_det.jpg
5586,The Gypsy Moths,1969,gypsy_moths,0,0,0,0,0,0,0,0,0,0,0,0,0,http://content8.flixster.com/movie/10/93/39/10933970_det.jpg
5587,The Hills Have Eyes II,2007,hills_have_eyes_2,3.2,64,7,57,10,3.6,16,2,14,12,2.9,63799,50,http://content6.flixster.com/movie/10/91/33/10913320_det.jpg
5588,The Hills Have Eyes,2006,hills_have_eyes,5.3,133,65,68,48,5,30,12,18,40,3.1,75042,64,http://content9.flixster.com/movie/10/91/33/10913327_det.jpg
5589,Indian Summer,1996,alive_and_kicking,6.7,6,5,1,83,0,2,2,0,100,3.2,492,45,http://content7.flixster.com/movie/10/70/10/10701045_det.jpg
5590,The Mack,1973,mack,0,3,2,1,66,0,0,0,0,0,0,0,0,http://content7.flixster.com/movie/27/05/270501_det.jpg
5591,Monkey Trouble,1994,monkey_trouble,5.6,11,6,5,54,0,2,2,0,100,2.5,2170,39,http://content6.flixster.com/movie/26/29/262996_det.jpg
5592,Monster in the Closet,1986,monster_in_the_closet,0,1,0,1,0,0,0,0,0,0,0,0,0,http://content6.flixster.com/movie/29/21/57/2921576_det.jpg
5593,No Way to Treat a Lady,1968,no_way_to_treat_a_lady,7.8,9,8,1,88,0,0,0,0,0,0,0,0,http://content7.flixster.com/movie/28/82/288209_det.jpg
5595,Shock Waves,1977,1018865-shock_waves,0,2,2,0,100,0,0,0,0,0,0,0,0,http://content9.flixster.com/movie/10/88/51/10885111_det.jpg
5596,Spaced Invaders,1990,spaced_invaders,3.3,11,1,10,9,0,2,0,2,0,2.7,834,43,http://content8.flixster.com/movie/11/12/36/11123666_det.jpg
5597,Suburban Commando,1991,suburban_commando,3.7,10,2,8,20,0,1,0,1,0,2.3,2563,31,http://content8.flixster.com/movie/21/00/15/2100150_det.jpg
5598,Surf Ninjas,1993,surf_ninjas,3.3,12,1,11,8,0,4,1,3,25,3.1,2874,64,http://content7.flixster.com/movie/10/88/99/10889981_det.jpg
5599,Tabu: A Story of the South Seas,1931,tabu,8.2,8,8,0,100,0,2,2,0,100,3.8,448,76,http://content7.flixster.com/movie/30/28/302897_det.jpg
5600,The Wanderers,1979,the-wanderers,6.8,17,15,2,88,0,0,0,0,0,0,0,0,http://content7.flixster.com/movie/26/78/267813_det.jpg
5601,The Yearling,1946,1024237-yearling,8.4,11,11,0,100,0,0,0,0,0,0,0,0,http://content8.flixster.com/movie/25/13/251318_det.jpg
5602,The Ladykillers,2004,ladykillers,6.1,185,101,84,54,5.8,39,18,21,46,2.8,12107,40,http://content8.flixster.com/movie/11/14/68/11146886_det.jpg
5603,The Lavender Hill Mob,1951,lavender_hill_mob,8.2,18,18,0,100,0,0,0,0,0,0,0,0,http://content8.flixster.com/movie/29/57/295722_det.jpg
5604,The Man in the White Suit,1951,man_in_the_white_suit,8.4,8,8,0,100,0,0,0,0,0,0,0,0,http://content8.flixster.com/movie/10/90/04/10900402_det.jpg
5605,Ratcatcher,1999,,\N,\N,\N,\N,\N,\N,\N,\N,\N,\N,\N,\N,\N,\N
5606,Society,1989,society,5.2,7,3,4,42,0,0,0,0,0,0,0,0,http://content9.flixster.com/movie/27/80/278095_det.jpg
5607,El hijo de la novia,2001,son_of_the_bride,7.3,57,49,8,85,6.8,18,13,5,72,4.2,1942,91,http://content6.flixster.com/movie/15/52/86/1552864_det.jpg
5608,Das Experiment,2001,1116582-experiment,6.6,64,46,18,71,5.9,19,10,9,52,3.9,5538,88,http://content7.flixster.com/movie/27/61/276197_det.jpg
5609,Ballistic: Ecks vs. Sever,2002,ballistic_ecks_vs_sever,2.6,108,0,108,0,2.4,28,0,28,0,2.2,3969,25,http://content6.flixster.com/movie/27/50/275024_det.jpg
5610,The Banger Sisters,2002,banger_sisters,5.3,140,66,74,47,5.1,34,14,20,41,2.7,4139,45,http://content6.flixster.com/movie/27/44/274416_det.jpg
5611,The Four Feathers,2002,four_feathers,5.4,149,61,88,40,5.6,32,13,19,40,3.2,6862,65,http://content8.flixster.com/movie/10/83/86/10838682_det.jpg
5612,Trapped,2002,1116086-trapped,4.1,56,10,46,17,4,12,2,10,16,3.1,4086,56,http://content7.flixster.com/movie/11/12/22/11122265_det.jpg
5613,8 femmes,2002,8_women,6.9,111,87,24,78,6.8,30,24,6,80,3.6,5397,74,http://content8.flixster.com/movie/27/10/271014_det.jpg
5614,Le fate ignoranti,2001,his_secret_life,6.5,34,25,9,73,6.9,13,11,2,84,4.1,1356,89,http://content7.flixster.com/movie/27/43/274309_det.jpg
5615,Invincible,2006,invincible,6.4,132,94,38,71,6.2,32,19,13,59,3.6,34698,75,http://content9.flixster.com/movie/21/92/35/2192351_det.jpg
5616,The Mesmerist,2002,mesmerist,0,2,0,2,0,0,0,0,0,0,0,0,0,http://content7.flixster.com/movie/37/11/59/3711597_det.jpg
5617,Secretary,2002,secretary,6.7,140,104,36,74,6.5,30,22,8,73,3.7,16511,84,http://content8.flixster.com/movie/26/72/267298_det.jpg
5618,Sen to Chihiro no kamikakushi,2001,spirited_away,8.5,154,150,4,97,8.7,31,31,0,100,4.1,72315,95,http://content9.flixster.com/movie/10/93/90/10939003_det.jpg
5619,The Trials of Henry Kissinger,2002,trials_of_henry_kissinger,7.2,57,54,3,94,7.8,17,17,0,100,3.6,328,74,http://content6.flixster.com/movie/10/88/30/10883056_det.jpg
5620,Sweet Home Alabama,2002,sweet_home_alabama,5.2,154,57,97,37,5.1,33,13,20,39,3.3,82825,77,http://content8.flixster.com/movie/25/45/254526_det.jpg
5621,The Tuxedo,2002,tuxedo,4.4,136,30,106,22,4.1,28,3,25,10,2.6,12285,43,http://content9.flixster.com/movie/26/29/262911_det.jpg
5622,Charlie and the Chocolate Factory,2005,fly-thought-on-golden-wings,0,0,0,0,0,0,0,0,0,0,0,0,0,http://content8.flixster.com/movie/10/84/54/10845470_det.jpg
5623,Crazy as Hell,2002,crazy_as_hell,5.3,14,7,7,50,4.6,5,2,3,40,3.2,275,55,http://content6.flixster.com/movie/51/24/28/5124284_det.jpg
5624,Ae Fond Kiss...,2004,1140811-fond_kiss,7.4,24,21,3,87,0,4,4,0,100,3.7,1269,73,http://content6.flixster.com/movie/10/87/10/10871048_det.jpg
5625,Moonlight Mile,2002,moonlight_mile,6.4,145,90,55,62,6.2,33,18,15,54,3.4,3000,64,http://content7.flixster.com/movie/10/91/91/10919189_det.jpg
5626,Shanghai Ghetto,2002,shanghai_ghetto,6.8,44,36,8,81,6.7,21,18,3,85,3.6,181,67,http://content9.flixster.com/movie/11/13/73/11137319_det.jpg
5627,Skins,2002,skins,5.9,58,34,24,58,5.6,19,10,9,52,4.1,578,86,http://content6.flixster.com/movie/52/47/62/5247624_det.jpg
5628,Wasabi,2001,wasabi,5.1,42,18,24,42,5.5,13,7,6,53,3.5,3717,69,http://content8.flixster.com/movie/10/61/32/10613254_det.jpg
5629,Jonah: A VeggieTales Movie,2002,jonah_a_veggietales_movie,5.8,54,35,19,64,6.1,18,14,4,77,3.4,4629,70,http://content6.flixster.com/movie/10/94/42/10944208_det.jpg
5630,Red Dragon,2002,red_dragon,6.4,183,125,58,68,5.9,35,19,16,54,3.4,39977,74,http://content6.flixster.com/movie/26/80/268012_det.jpg
5631,Between Strangers,2002,between_strangers,4.3,8,2,6,25,0,2,0,2,0,3.3,164,52,http://content7.flixster.com/movie/10/90/94/10909493_det.jpg
5632,Bloody Sunday,2002,bloody_sunday,7.9,102,94,8,92,8.2,30,28,2,93,4,2812,89,http://content8.flixster.com/movie/10/90/21/10902182_det.jpg
5633,Heaven,2002,heaven,6.7,86,63,23,73,6.4,25,17,8,68,3.7,3048,77,http://content7.flixster.com/movie/10/91/83/10918393_det.jpg
5634,Pipe Dream,2002,pipe_dream,6.4,18,13,5,72,6.6,7,5,2,71,2.8,194,26,http://content7.flixster.com/movie/28/47/284797_det.jpg
5635,The Man from Elysian Fields,2001,man_from_elysian_fields,5.9,70,36,34,51,5.6,25,11,14,44,3.3,426,54,http://content8.flixster.com/movie/28/13/281306_det.jpg
5636,Welcome to Collinwood,2002,welcome_to_collinwood,5.9,64,34,30,53,6,22,11,11,50,3.2,1767,54,http://content7.flixster.com/movie/10/88/39/10883901_det.jpg
5637,Flirting with Disaster,1996,flirting_with_disaster,7.4,42,36,6,85,8.5,6,6,0,100,3.3,2127,65,http://content9.flixster.com/movie/92/18/93/9218931_det.jpg
5638,Mosura tai Gojira,1964,godzilla-vs-mothra,6.7,9,8,1,88,0,0,0,0,0,0,0,0,http://content6.flixster.com/movie/28/91/289112_det.jpg
5639,Gojira-Minira-Gabara: Oru kaij√ª daishingeki,1969,godzillas-revenge,4.8,6,2,4,33,0,1,0,1,0,2.7,774,30,http://content7.flixster.com/movie/10/87/24/10872497_det.jpg
5640,"Godzilla, King of the Monsters!",1956,godzilla_king_of_the_monsters,6.9,20,16,4,80,0,3,2,1,66,3.6,2215,73,http://content9.flixster.com/movie/10/88/18/10881807_det.jpg
5641,Modern Times,1936,modern_times,8.9,47,47,0,100,8.2,11,11,0,100,4.2,9563,95,http://content7.flixster.com/movie/29/01/290109_det.jpg
5642,The Onion Field,1979,onion_field,8.2,5,5,0,100,0,0,0,0,0,0,0,0,http://content8.flixster.com/movie/10/86/94/10869490_det.jpg
5643,Powaqqatsi,1988,powaqqatsi,6.8,8,5,3,62,0,1,0,1,0,3.9,1251,83,http://content7.flixster.com/movie/25/20/252013_det.jpg
5644,The Pride of the Yankees,1942,pride_of_the_yankees,7.4,20,18,2,90,0,3,3,0,100,3.9,1471,88,http://content6.flixster.com/movie/10/90/06/10900632_det.jpg
5645,Texasville,1990,texasville,5.6,21,12,9,57,4.5,5,2,3,40,2.9,302,45,http://content9.flixster.com/movie/27/50/275015_det.jpg
5646,Dangerous Liaisons,1988,1005199-dangerous_liaisons,7.7,27,25,2,92,6.5,6,5,1,83,3.7,11359,84,http://content6.flixster.com/movie/26/84/268496_det.jpg
5647,Ernest Goes to Africa,1997,ernest-goes-to-africa,0,0,0,0,0,0,0,0,0,0,0,0,0,http://content6.flixster.com/movie/10/87/38/10873884_det.jpg
5648,Ernest in the Army,1998,ernest-in-the-army,3,6,1,5,16,0,0,0,0,0,0,0,0,http://content6.flixster.com/movie/10/87/21/10872164_det.jpg
5649,Dracula,1958,horror_of_dracula,7.5,27,24,3,88,0,3,2,1,66,3.6,3118,73,http://content6.flixster.com/movie/28/64/286420_det.jpg
5650,The Adventures of Bob & Doug McKenzie: Strange Brew,1983,strange_brew,6.5,20,14,6,70,0,1,0,1,0,3.4,4156,80,http://content9.flixster.com/movie/25/50/255023_det.jpg
5651,The Incredible Mr. Limpet,1964,incredible_mr_limpet,5.3,7,3,4,42,0,0,0,0,0,0,0,0,http://content7.flixster.com/movie/29/11/291109_det.jpg
5652,Claire of the Moon,1992,,\N,\N,\N,\N,\N,\N,\N,\N,\N,\N,\N,\N,\N,\N
5653,Sukiyaki Western Django,2007,,5.7,49,28,21,57,5.2,10,4,6,40,3.4,5732,59,http://content8.flixster.com/movie/11/12/51/11125186_det.jpg
5654,Django 2: il grande ritorno,1987,,\N,\N,\N,\N,\N,\N,\N,\N,\N,\N,\N,\N,\N,\N
5655,The Fan,1996,1072972-fan,4.8,25,10,15,40,5.3,5,2,3,40,2.8,5593,37,http://content9.flixster.com/movie/27/82/278295_det.jpg
5656,Festival in Cannes,2001,festival_in_cannes,6.1,54,35,19,64,6,20,12,8,60,2.8,203,32,http://content8.flixster.com/movie/26/56/265698_det.jpg
5657,Flashback,1990,1007522-flashback,4.9,13,5,8,38,0,1,1,0,100,3,804,54,http://content6.flixster.com/movie/27/64/276424_det.jpg
5658,Hanky Panky,1982,hanky_panky,4.8,8,3,5,37,0,0,0,0,0,0,0,0,http://content7.flixster.com/movie/26/38/263825_det.jpg
5659,The Rocking Horse Winner,1949,rocking_horse_winner,7.7,6,5,1,83,0,0,0,0,0,0,0,0,http://content8.flixster.com/movie/10/87/81/10878154_det.jpg
5660,Seance on a Wet Afternoon,1964,seance_on_a_wet_afternoon,7.2,9,7,2,77,0,0,0,0,0,0,0,0,http://content7.flixster.com/movie/30/58/305825_det.jpg
5661,Shamus,1973,shamus,5,7,3,4,42,0,1,0,1,0,3,301,34,http://content7.flixster.com/movie/26/51/265193_det.jpg
5662,The Wrong Guy,1997,wrong_guy,0,3,0,3,0,0,1,0,1,0,3.6,826,81,http://content7.flixster.com/movie/10/92/04/10920477_det.jpg
5663,Eight Below,2006,eight_below,6.5,139,99,40,71,6.1,31,16,15,51,3.4,27593,80,http://content6.flixster.com/movie/31/28/312800_det.jpg
5664,Brown Sugar,2002,brown_sugar,6.2,84,54,30,64,6.5,28,20,8,71,3.8,11172,88,http://content6.flixster.com/movie/10/91/32/10913272_det.jpg
5665,Knockaround Guys,2001,knockaround_guys,4.3,97,19,78,19,4.2,25,4,21,16,3.1,4913,58,http://content7.flixster.com/movie/27/43/274325_det.jpg
5666,The Rules of Attraction,2002,rules_of_attraction,5.3,134,59,75,44,4.9,27,9,18,33,3.2,10253,71,http://content8.flixster.com/movie/26/92/269226_det.jpg
5667,Tuck Everlasting,2002,tuck_everlasting,6.3,114,69,45,60,6.2,28,16,12,57,3.3,22077,66,http://content8.flixster.com/movie/25/61/256102_det.jpg
5668,White Oleander,2002,white_oleander,6.5,131,91,40,69,6,31,18,13,58,3.5,9063,79,http://content9.flixster.com/movie/26/10/261003_det.jpg
5669,Bowling for Columbine,2002,bowling_for_columbine,8.2,160,154,6,96,7.7,30,28,2,93,3.5,24080,81,http://content8.flixster.com/movie/10/93/45/10934550_det.jpg
5670,Comedian,2002,comedian,6.8,88,67,21,76,6.9,27,22,5,81,3.4,1389,66,http://content6.flixster.com/movie/26/91/269100_det.jpg
5671,Le bossu,1997,on_guard,7,30,26,4,86,7,14,12,2,85,3.7,406,70,http://content7.flixster.com/movie/90/51/32/9051329_det.jpg
5672,Pok√©mon 4Ever,2002,pokemon_4ever,3.5,36,5,31,13,3.1,16,1,15,6,3.2,4367,58,http://content8.flixster.com/movie/25/21/252118_det.jpg
5673,Punch-Drunk Love,2002,punchdrunk_love,7.4,179,141,38,78,7.4,36,29,7,80,3.2,24379,72,http://content7.flixster.com/movie/27/01/270105_det.jpg
5675,Swept Away,2002,1116774-swept_away,2.8,77,4,73,5,3,28,4,24,14,2.2,2205,28,http://content7.flixster.com/movie/10/84/02/10840225_det.jpg
5676,The Young Unknowns,2000,the-young-unknowns,4,28,3,25,10,4,12,2,10,16,2.6,115,33,http://content7.flixster.com/movie/10/84/77/10847713_det.jpg
5677,Abandon,2002,abandon,4.3,109,18,91,16,4.1,26,6,20,23,2.7,2670,37,http://content7.flixster.com/movie/26/67/266793_det.jpg
5678,The 51st State,2001,formula_51,4.3,101,26,75,25,3.9,27,5,22,18,3.1,5566,61,http://content9.flixster.com/movie/10/89/25/10892587_det.jpg
5679,The Ring,2002,ring,6.6,169,120,49,71,6.3,32,18,14,56,3,146246,50,http://content8.flixster.com/movie/10/86/94/10869458_det.jpg
5680,Auto Focus,2002,auto_focus,6.7,155,112,43,72,6.9,37,28,9,75,3.2,1283,56,http://content8.flixster.com/movie/27/88/278806_det.jpg
5681,La faute √† Fidel!,2006,blame_it_on_fidel,7.4,43,40,3,93,7.8,12,11,1,91,4.1,2344,90,http://content9.flixster.com/movie/10/88/27/10882787_det.jpg
5682,The Grey Zone,2001,grey_zone,7,80,55,25,68,6.7,26,17,9,65,3.5,1987,71,http://content9.flixster.com/movie/10/87/05/10870567_det.jpg
5683,Hansel & Gretel,2002,1117372-hansel_and_gretel,3.2,5,0,5,0,0,3,0,3,0,3.1,1129,50,http://content7.flixster.com/movie/26/39/263993_det.jpg
5684,Naqoyqatsi,2002,naqoyqatsi,5.8,52,25,27,48,5.8,16,9,7,56,3.7,1161,74,http://content6.flixster.com/movie/25/48/254816_det.jpg
5685,Real Women Have Curves,2002,real_women_have_curves,6.8,82,68,14,82,7.2,23,21,2,91,3.6,2864,73,http://content9.flixster.com/movie/10/86/58/10865811_det.jpg
5686,Russkiy kovcheg,2002,russian_ark,7.8,93,82,11,88,8.3,24,22,2,91,3.9,2668,80,http://content7.flixster.com/movie/29/26/292613_det.jpg
5687,Goyangileul butaghae,2001,take_care_of_my_cat,6.8,27,22,5,81,6.5,8,5,3,62,3.7,622,80,http://content9.flixster.com/movie/10/89/40/10894031_det.jpg
5688,Tully,2000,tully,6.9,52,42,10,80,6.8,20,16,4,80,3.6,374,78,http://content7.flixster.com/movie/28/04/280417_det.jpg
5689,Billy Bathgate,1991,billy_bathgate,5.2,18,9,9,50,0,2,0,2,0,2.8,1397,32,http://content7.flixster.com/movie/27/24/272493_det.jpg
5690,Hotaru no haka,1988,grave_of_the_fireflies,8.9,22,20,2,90,0,2,2,0,100,4.3,17989,93,http://content6.flixster.com/movie/10/93/23/10932312_det.jpg
5691,Jason Goes to Hell: The Final Friday,1993,jason_goes_to_hell_the_final_friday,4.1,15,4,11,26,0,2,0,2,0,2.8,9066,47,http://content9.flixster.com/movie/10/93/46/10934639_det.jpg
5692,The Mechanic,1972,1013632-mechanic,0,3,1,2,33,0,1,0,1,0,3.5,913,70,http://content8.flixster.com/movie/25/79/257910_det.jpg
5693,Saturday Night Fever,1977,saturday_night_fever,7.4,38,34,4,89,0,4,3,1,75,3.1,13427,67,http://content7.flixster.com/movie/10/86/34/10863417_det.jpg
5694,Stay Alive,2006,10006370-stay_alive,3,57,5,52,8,2.8,14,1,13,7,3.3,40388,60,http://content8.flixster.com/movie/10/87/03/10870338_det.jpg
5695,To the Devil a Daughter,1976,to_the_devil_a_daughter,4,6,1,5,16,0,1,0,1,0,3.1,703,44,http://content9.flixster.com/movie/27/75/277507_det.jpg
5696,Urban Cowboy,1980,urban_cowboy,6.5,13,10,3,76,0,0,0,0,0,0,0,0,http://content8.flixster.com/movie/10/88/51/10885190_det.jpg
5697,Terror Train,1980,terror_train,4.6,9,3,6,33,0,1,0,1,0,2.9,1162,40,http://content9.flixster.com/movie/27/26/272615_det.jpg
5698,Times Square,1980,times_square,0,4,1,3,25,0,1,0,1,0,3.6,569,66,http://content6.flixster.com/movie/10/87/15/10871532_det.jpg
5699,Tom Horn,1980,tom_horn,0,4,4,0,100,0,0,0,0,0,0,0,0,http://content6.flixster.com/movie/10/86/96/10869628_det.jpg
5700,L'uomo puma,1980,,\N,\N,\N,\N,\N,\N,\N,\N,\N,\N,\N,\N,\N,\N
5701,Up the Academy,1980,up_the_academy,0,4,0,4,0,0,1,0,1,0,3.2,244,51,http://content8.flixster.com/movie/11/15/04/11150478_det.jpg
5702,When Time Ran Out...,1980,when_time_ran_out,0,4,0,4,0,0,0,0,0,0,0,0,0,http://content8.flixster.com/movie/10/87/10/10871038_det.jpg
5703,Wholly Moses!,1980,wholly_moses,0,0,0,0,0,0,0,0,0,0,0,0,0,http://content8.flixster.com/movie/10/87/50/10875082_det.jpg
5705,Xanadu,1980,xanadu,4.5,22,9,13,40,0,2,1,1,50,3,3569,60,http://content6.flixster.com/movie/10/92/51/10925120_det.jpg
5706,...All the Marbles,1981,all_the_marbles,0,0,0,0,0,0,0,0,0,0,0,0,0,http://content7.flixster.com/movie/10/88/50/10885053_det.jpg
5707,Absence of Malice,1981,absence_of_malice,6.6,22,19,3,86,6.6,5,4,1,80,3.3,1000,55,http://content6.flixster.com/movie/99/67/81/9967812_det.jpg
5708,All Night Long,1962,all-night-long-1962,0,0,0,0,0,0,0,0,0,0,0,0,0,http://content7.flixster.com/movie/93/39/09/9339093_det.jpg
5709,The Moguls,2005,the-amateurs,3.9,24,4,20,16,0,4,1,3,25,3,8866,46,http://content7.flixster.com/movie/11/13/35/11133545_det.jpg
5710,Banana Joe,1982,banana-joe,0,0,0,0,0,0,0,0,0,0,0,0,0,http://content8.flixster.com/movie/10/84/01/10840198_det.jpg
5711,Die bleierne Zeit,1981,marianne_and_juliane,0,1,1,0,100,0,0,0,0,0,0,0,0,http://content8.flixster.com/movie/98/97/03/9897038_det.jpg
5712,Blow Out,1981,blow_out,7.5,36,32,4,88,7.1,5,4,1,80,3.6,2727,74,http://content6.flixster.com/movie/10/87/44/10874488_det.jpg
5714,Buddy,1997,1078022-buddy,5.4,19,5,14,26,6.2,6,2,4,33,2.8,1106,37,http://content6.flixster.com/movie/26/42/264224_det.jpg
5715,Burn After Reading,2008,burn_after_reading,6.8,217,169,48,77,6.2,42,26,16,61,3.4,71248,64,http://content9.flixster.com/movie/11/15/10/11151031_det.jpg
5716,The Butterfly Effect,2004,butterfly_effect,4.8,166,55,111,33,3.8,34,6,28,17,3.6,109956,81,http://content8.flixster.com/movie/11/14/18/11141874_det.jpg
5717,Cannibal ferox,1981,cannibal_ferox,0,3,0,3,0,0,0,0,0,0,0,0,0,http://content7.flixster.com/movie/97/82/79/9782797_det.jpg
5718,Carbon Copy,1981,1003547-carbon_copy,0,1,0,1,0,0,0,0,0,0,0,0,0,http://content8.flixster.com/movie/11/12/59/11125910_det.jpg
5719,Charlie Chan and the Curse of the Dragon Queen,1981,charlie_chan_and_the_curse_of_the_dragon_queen,5.5,5,2,3,40,0,0,0,0,0,0,0,0,http://content7.flixster.com/movie/10/86/90/10869069_det.jpg
5720,"Chi trova un amico, trova un tesoro",1981,,\N,\N,\N,\N,\N,\N,\N,\N,\N,\N,\N,\N,\N,\N
5721,The Chosen,1981,1004110-chosen,5.6,9,7,2,77,0,2,2,0,100,3.8,256,78,http://content6.flixster.com/movie/25/67/256792_det.jpg
5722,The Goat,1921,the-goat-1921,0,0,0,0,0,0,0,0,0,0,0,0,0,http://content9.flixster.com/movie/10/89/57/10895787_det.jpg
5723,Continental Divide,1981,continental_divide,6.2,9,7,2,77,0,2,1,1,50,3,537,48,http://content9.flixster.com/movie/25/82/258215_det.jpg
5724,The Creature Wasn't Nice,1983,the-creature-wasnt-nice,0,0,0,0,0,0,0,0,0,0,0,0,0,http://content6.flixster.com/movie/10/87/68/10876844_det.jpg
5725,Czlowiek z zelaza,1981,man_of_iron,0,1,1,0,100,0,0,0,0,0,0,0,0,http://content9.flixster.com/movie/10/89/35/10893571_det.jpg
5726,Dead & Buried,1981,dead_and_buried,6.2,11,8,3,72,0,0,0,0,0,0,0,0,http://content6.flixster.com/movie/10/95/08/10950892_det.jpg
5727,Deadly Blessing,1981,deadly_blessing,4.4,5,1,4,20,0,0,0,0,0,0,0,0,http://content6.flixster.com/movie/10/89/98/10899880_det.jpg
5728,Death Hunt,1981,death_hunt,0,3,1,2,33,0,1,0,1,0,3.5,872,71,http://content9.flixster.com/movie/26/84/268423_det.jpg
5729,Endless Love,1981,endless_love,3.9,13,3,10,23,0,3,0,3,0,0,0,0,http://content8.flixster.com/movie/18/96/79/1896794_det.jpg
5730,Enter the Ninja,1981,enter_the_ninja,0,1,0,1,0,0,0,0,0,0,0,0,0,http://content7.flixster.com/movie/12/31/64/1231641_det.jpg
5731,The Entity,1981,entity,0,2,2,0,100,0,0,0,0,0,0,0,0,http://content6.flixster.com/movie/26/87/268796_det.jpg
5732,Eye of the Needle,1981,eye_of_the_needle,6.5,13,11,2,84,0,1,1,0,100,3.4,963,61,http://content9.flixster.com/movie/26/80/268091_det.jpg
5733,Eyewitness,1970,1020414-eyewitness,0,0,0,0,0,0,0,0,0,0,0,0,0,http://content9.flixster.com/movie/10/86/39/10863983_det.jpg
5734,Faces of Death II,1981,faces-of-death-ii,0,0,0,0,0,0,0,0,0,0,0,0,0,http://images.rottentomatoescdn.com/images/defaults/poster_default.gif
5735,Faces of Death,1978,,\N,\N,\N,\N,\N,\N,\N,\N,\N,\N,\N,\N,\N,\N
5736,Faces of Death III,1985,faces_of_death_pt_3,0,0,0,0,0,0,0,0,0,0,0,0,0,http://content8.flixster.com/movie/10/84/03/10840314_det.jpg
5737,Faces of Death IV,1990,faces-of-death-iv,0,0,0,0,0,0,0,0,0,0,0,0,0,http://content6.flixster.com/movie/29/01/290100_det.jpg
5738,Faces of Death V,1995,faces-of-death-v,0,0,0,0,0,0,0,0,0,0,0,0,0,http://content6.flixster.com/movie/10/85/86/10858692_det.jpg
5739,Faces of Death VI,1996,faces-of-death-vi,0,0,0,0,0,0,0,0,0,0,0,0,0,http://content7.flixster.com/movie/10/85/86/10858693_det.jpg
5740,Faces of Death: Fact or Fiction?,1999,faces-of-death,2.6,11,2,9,18,0,0,0,0,0,0,0,0,http://content9.flixster.com/movie/31/29/312907_det.jpg
5741,La femme d'√† c√¥t√©,1981,woman_next_door,7.7,10,9,1,90,0,3,3,0,100,3.8,931,80,http://content9.flixster.com/movie/10/92/15/10921579_det.jpg
5742,First Monday in October,1981,first_monday_in_october,0,4,1,3,25,0,0,0,0,0,0,0,0,http://content7.flixster.com/movie/27/30/273005_det.jpg
5743,Fort Apache the Bronx,1981,fort_apache_the_bronx,6.6,11,9,2,81,0,1,0,1,0,3.2,1172,57,http://content6.flixster.com/movie/10/95/34/10953460_det.jpg
5744,Four Friends,1981,four_friends,6.9,7,5,2,71,0,1,1,0,100,3.6,291,69,http://content8.flixster.com/movie/27/56/275610_det.jpg
5745,H√§ndler der vier Jahreszeiten,1971,merchant_of_four_seasons,7.9,12,11,1,91,0,2,1,1,50,0,0,0,http://content7.flixster.com/movie/30/38/303897_det.jpg
5746,Galaxy of Terror,1981,1008055-galaxy_of_terror,5.1,10,4,6,40,0,0,0,0,0,0,0,0,http://content7.flixster.com/movie/10/93/70/10937081_det.gif
5747,Gallipoli,1981,1008074-gallipoli,7.4,21,18,3,85,0,2,1,1,50,3.6,5646,77,http://content9.flixster.com/movie/26/00/260095_det.jpg
5748,Zork: Grand Inquisitor,1997,,\N,\N,\N,\N,\N,\N,\N,\N,\N,\N,\N,\N,\N,\N
5749,Sien nui yau wan,1987,chinese_ghost_story,7.8,8,6,2,75,0,0,0,0,0,0,0,0,http://content7.flixster.com/movie/11/12/73/11127361_det.jpg
5750,Going Ape!,1981,going_ape,0,0,0,0,0,0,0,0,0,0,0,0,0,http://content9.flixster.com/movie/73/52/15/7352159_det.jpg
5751,Goodbye Pork Pie,1981,,\N,\N,\N,\N,\N,\N,\N,\N,\N,\N,\N,\N,\N,\N
5752,Gregory's Girl,1981,gregorys_girl,7.7,13,12,1,92,0,4,4,0,100,3.7,1117,79,http://content6.flixster.com/movie/26/02/260208_det.jpg
5753,G√∂ta kanal eller Vem drog ur proppen?,1981,gota-kanal-eller-vem-drog-ur-proppen-who-pulled-the-plug,0,0,0,0,0,0,0,0,0,0,0,0,0,http://content7.flixster.com/movie/10/83/93/10839345_det.jpg
5754,Cool Hand Luke,1967,cool_hand_luke,8.8,44,44,0,100,8.5,6,6,0,100,4.1,17521,93,http://content9.flixster.com/movie/29/06/290627_det.jpg
5755,Happy Birthday to Me,1981,happy_birthday_to_me,5.2,8,2,6,25,0,0,0,0,0,0,0,0,http://content8.flixster.com/movie/10/91/57/10915774_det.jpg
5756,Heartbeeps,1981,heartbeeps,1.6,5,0,5,0,0,0,0,0,0,0,0,0,http://content8.flixster.com/movie/10/58/60/10586062_det.jpg
5759,"Ladies and Gentlemen, the Fabulous Stains",1982,ladies-and-gentlemen-the-fabulous-stains,0,0,0,0,0,0,0,0,0,0,0,0,0,http://content6.flixster.com/movie/10/89/80/10898020_det.jpg
5760,Lady Chatterley's Lover,1981,1149046-lady_chatterleys_lover,0,0,0,0,0,0,0,0,0,0,0,0,0,http://content9.flixster.com/movie/11/12/63/11126327_det.jpg
5761,The Legend of the Lone Ranger,1981,1012184-legend_of_the_lone_ranger,0,0,0,0,0,0,0,0,0,0,0,0,0,http://content7.flixster.com/movie/11/13/21/11132189_det.jpg
5762,Lili Marleen,1981,lili_marleen,5.8,5,2,3,40,0,3,1,2,33,3.8,317,79,http://content8.flixster.com/movie/10/69/48/10694882_det.jpg
5763,Lola,1981,10002128-lola,8.1,6,6,0,100,0,1,1,0,100,3.9,529,82,http://content7.flixster.com/movie/10/83/83/10838329_det.jpg
5764,Looker,1981,looker,4.4,17,5,12,29,0,2,0,2,0,3.2,1109,50,http://content7.flixster.com/movie/29/07/80/2907809_det.jpg
5765,"Looney, Looney, Looney Bugs Bunny Movie",1981,looney_looney_looney_bugs_bunny_movie,0,3,2,1,66,0,0,0,0,0,0,0,0,http://content6.flixster.com/movie/10/89/76/10897612_det.jpg
5766,"I, Madman",1989,i_madman,0,4,3,1,75,0,1,1,0,100,3,387,44,http://content6.flixster.com/movie/28/13/281300_det.jpg
5767,Mis,1981,mis-teddy-bear,0,0,0,0,0,0,0,0,0,0,0,0,0,http://content7.flixster.com/movie/51/10/30/5110301_det.jpg
5768,Modern Problems,1981,modern_problems,0,3,0,3,0,0,0,0,0,0,0,0,0,http://content6.flixster.com/movie/25/90/259020_det.jpg
5769,Modern Romance,1981,modern_romance,6.4,20,17,3,85,0,1,1,0,100,3.6,466,72,http://content6.flixster.com/movie/51/27/80/5127804_det.jpg
5770,Ms. 45,1981,ms_45,6.9,9,7,2,77,0,0,0,0,0,0,0,0,http://content6.flixster.com/movie/10/89/20/10892048_det.jpg
5771,My Bloody Valentine,2009,my_bloody_valentine_3_d,5.7,85,48,37,56,5.2,8,3,5,37,3.1,111307,49,http://content8.flixster.com/movie/10/92/60/10926074_det.jpg
5772,My Dinner with Andre,1981,my_dinner_with_andre,7.1,18,16,2,88,0,1,1,0,100,4,1441,85,http://content6.flixster.com/movie/28/64/286428_det.jpg
5773,Your Friends & Neighbors,1998,your_friends_and_neighbors,7,55,42,13,76,6.4,20,13,7,65,3.3,1418,60,http://content7.flixster.com/movie/10/93/56/10935653_det.jpg
5774,Night of the Zombies,1981,night-of-the-zombies-battalion-of-the-living-deadgamma-693the-chillingsister-of-death,0,0,0,0,0,0,0,0,0,0,0,0,0,http://content6.flixster.com/movie/11/15/23/11152352_det.jpg
5775,The Night the Lights Went Out in Georgia,1981,night_the_lights_went_out_in_georgia,0,1,1,0,100,0,0,0,0,0,0,0,0,http://content7.flixster.com/movie/10/93/08/10930837_det.jpg
5776,Only When I Laugh,1981,1015639-only_when_i_laugh,4.9,6,3,3,50,0,1,0,1,0,3.1,189,39,http://content7.flixster.com/movie/10/87/50/10875081_det.jpg
5777,Pennies from Heaven,1981,1016119-pennies_from_heaven,7,24,20,4,83,4.3,5,1,4,20,3.3,851,58,http://content8.flixster.com/movie/10/86/58/10865866_det.jpg
5778,Five Easy Pieces,1970,five_easy_pieces,8.2,30,25,5,83,6.5,5,3,2,60,3.9,4148,85,http://content6.flixster.com/movie/27/03/270308_det.jpg
5779,Piranha Part Two: The Spawning,1981,piranha_2_the_spawning,3.4,13,1,12,7,0,1,0,1,0,2,692,11,http://content7.flixster.com/movie/11/14/64/11146497_det.jpg
5780,Polyester,1981,polyester,7.1,17,15,2,88,0,0,0,0,0,0,0,0,http://content8.flixster.com/movie/95/83/91/9583918_det.jpg
5781,Private Lessons,1981,1016793-private_lessons,2.7,6,0,6,0,0,1,0,1,0,2.9,1236,38,http://content8.flixster.com/movie/86/22/74/8622742_det.jpg
5782,Le professionnel,1981,le-professionnel,0,1,0,1,0,0,0,0,0,0,0,0,0,http://content8.flixster.com/movie/29/92/299298_det.jpg
5783,Derrida,2002,derrida,6.7,34,28,6,82,7.2,11,10,1,90,3.3,333,59,http://content7.flixster.com/movie/10/87/61/10876129_det.jpg
5784,Ghost Ship,2002,ghost_ship,3.8,119,15,104,12,3.5,28,3,25,10,2.9,21180,53,http://content8.flixster.com/movie/10/88/28/10882826_det.jpg
5785,Jackass: The Movie,2002,jackass_the_movie,5.1,93,46,47,49,4.1,17,6,11,35,3.4,50664,78,http://content6.flixster.com/movie/26/98/269808_det.jpg
5786,Paid in Full,2002,paid_in_full,5.8,41,21,20,51,5.7,16,7,9,43,4.3,4068,94,http://content9.flixster.com/movie/27/13/271311_det.jpg
5787,The Truth About Charlie,2002,truth_about_charlie,4.8,130,43,87,33,4.9,35,14,21,40,2.7,2359,29,http://content6.flixster.com/movie/10/88/84/10888428_det.jpg
5788,All or Nothing,2002,1117377-all_or_nothing,7.1,88,73,15,82,6.8,24,18,6,75,3.8,907,82,http://content9.flixster.com/movie/66/64/06/6664063_det.jpg
5789,All the Queen's Men,2001,all_the_queens_men,3.3,29,2,27,6,2.8,11,0,11,0,3.1,969,51,http://content9.flixster.com/movie/26/34/263495_det.jpg
5790,Food of Love,2002,food_of_love,5.3,28,13,15,46,5.4,10,5,5,50,3,360,47,http://content8.flixster.com/movie/10/88/06/10880606_det.jpg
5791,Frida,2002,frida,6.9,148,112,36,75,6.8,36,23,13,63,3.7,14440,84,http://content7.flixster.com/movie/26/75/267501_det.jpg
5792,Roger Dodger,2002,roger_dodger,7.4,121,106,15,87,7.4,30,28,2,93,3.6,1712,75,http://content9.flixster.com/movie/12/88/67/1288679_det.jpg
5793,Time Changer,2002,time_changer,3.9,9,2,7,22,0,1,0,1,0,3.6,571,72,http://content6.flixster.com/movie/25/95/259592_det.jpg
5794,Beau travail,1999,beau_travail,7.6,29,23,6,79,0,4,4,0,100,3.9,709,79,http://content9.flixster.com/movie/30/45/304519_det.jpg
5795,The Big Knife,1955,big_knife,0,4,3,1,75,0,0,0,0,0,0,0,0,http://content9.flixster.com/movie/10/83/79/10837951_det.jpg
5796,Casino Royale,2006,casino_royale,7.8,214,202,12,94,7.8,43,41,2,95,3.9,155430,87,http://content9.flixster.com/movie/11/12/81/11128111_det.jpg
5797,The Company of Wolves,1984,company_of_wolves,6.5,13,10,3,76,0,1,1,0,100,3.5,2206,71,http://content8.flixster.com/movie/27/07/270730_det.jpg
5798,Escanaba in da Moonlight,2001,escanaba_in_da_moonlight,0,3,1,2,33,0,1,0,1,0,0,0,0,http://content9.flixster.com/movie/10/91/91/10919191_det.jpg
5799,Exodus,1960,1006872-exodus,6,12,8,4,66,0,2,2,0,100,3.6,904,71,http://content6.flixster.com/movie/29/20/292008_det.jpg
5800,How to Murder Your Wife,1965,how_to_murder_your_wife,5.9,8,5,3,62,0,0,0,0,0,0,0,0,http://content9.flixster.com/movie/10/87/56/10875691_det.jpg
5801,The Russians Are Coming the Russians Are Coming,1966,russians_are_coming_the_russians_are_coming,6.8,17,14,3,82,0,1,0,1,0,3.5,861,74,http://content8.flixster.com/movie/28/60/286014_det.jpg
5802,The World of Henry Orient,1964,world_of_henry_orient,7.6,8,7,1,87,0,0,0,0,0,0,0,0,http://content9.flixster.com/movie/29/44/294407_det.jpg
5803,I Spy,2002,hit-me,0,0,0,0,0,0,0,0,0,0,0,0,0,http://content8.flixster.com/movie/10/89/32/10893214_det.jpg
5804,The Santa Clause 2,2002,santa_clause_2,5.6,111,61,50,54,5.4,28,13,15,46,2.9,17510,59,http://content7.flixster.com/movie/25/10/251025_det.jpg
5806,Takht√© siah,2000,blackboards,6.8,34,25,9,73,7.1,11,9,2,81,3.6,447,67,http://content8.flixster.com/movie/30/31/303194_det.jpg
5807,Love in the Time of Money,2002,love_in_the_time_of_money,4.2,39,7,32,17,3.1,12,1,11,8,3,203,28,http://content9.flixster.com/movie/27/60/276011_det.jpg
5808,The Weight of Water,2000,weight_of_water,5.1,62,20,42,32,5.3,21,8,13,38,3,1230,40,http://content6.flixster.com/movie/61/72/95/6172952_det.jpg
5809,Femme Fatale,2002,1118216-femme_fatale,5.4,133,64,69,48,5.5,32,16,16,50,2.9,3552,49,http://content9.flixster.com/movie/27/17/271791_det.jpg
5810,8 Mile,2002,8_mile,6.7,179,133,46,74,7.2,38,32,6,84,3.1,199023,54,http://content7.flixster.com/movie/26/85/268597_det.jpg
5811,Tout pr√®s des √©toiles: Les danseurs de l'Op√©ra de Paris,2001,etoiles_dancers_of_the_paris_opera_ballet,6.1,13,8,5,61,6,6,3,3,50,4.4,11,100,http://content7.flixster.com/movie/11/14/80/11148005_det.jpg
5812,Far from Heaven,2002,far_from_heaven,8.1,188,168,20,89,8.4,37,35,2,94,3.6,5103,77,http://content6.flixster.com/movie/10/87/46/10874600_det.jpg
5813,"Dieu est grand, je suis toute petite",2001,god_is_great_im_not,4.5,25,6,19,24,4.1,11,1,10,9,3,1107,39,http://content6.flixster.com/movie/30/22/302212_det.jpg
5814,The Rising Place,2001,rising_place,4.3,16,2,14,12,3.2,6,0,6,0,3.6,47,75,http://content9.flixster.com/movie/10/85/01/10850187_det.jpg
5815,Half Past Dead 2,2007,,\N,\N,\N,\N,\N,\N,\N,\N,\N,\N,\N,\N,\N,\N
5816,Harry Potter and the Chamber of Secrets,2002,harry_potter_and_the_chamber_of_secrets,7.1,199,164,35,82,6.6,39,27,12,69,3.6,176055,80,http://content8.flixster.com/movie/95/10/68/9510686_det.jpg
5817,Ararat,2002,ararat,6.4,75,42,33,56,6.3,22,10,12,45,3.6,923,70,http://content9.flixster.com/movie/10/93/70/10937051_det.jpg
5818,El crimen del padre Amaro,2002,crime_of_padre_amaro,6.2,82,51,31,62,6.3,29,19,10,65,3.7,3433,73,http://content8.flixster.com/movie/10/89/50/10895046_det.jpg
5819,Interview with the Assassin,2002,interview_with_the_assassin,6.5,57,38,19,66,6.1,17,10,7,58,3.3,332,52,http://content9.flixster.com/movie/10/89/12/10891239_det.jpg
5820,Standing in the Shadows of Motown,2002,standing_in_the_shadows_of_motown,7.5,88,81,7,92,7.5,26,24,2,92,4,660,87,http://content8.flixster.com/movie/10/94/96/10949682_det.jpg
5821,Jibeuro,2002,way_home,6.6,55,41,14,74,6.5,18,13,5,72,4.2,1280,91,http://content8.flixster.com/movie/10/87/02/10870242_det.jpg
5822,Acci√≥n mutante,1993,accion-mutante-mutant-action,0,0,0,0,0,0,0,0,0,0,0,0,0,http://content6.flixster.com/movie/10/90/90/10909084_det.jpg
5823,Eyes of an Angel,1991,eyes_of_an_angel,0,3,0,3,0,0,0,0,0,0,0,0,0,http://content9.flixster.com/movie/57/74/28/5774283_det.jpg
5824,Liberty Stands Still,2002,liberty_stands_still,0,4,0,4,0,0,0,0,0,0,0,0,0,http://content6.flixster.com/movie/10/89/17/10891708_det.jpg
5825,The Life and Death of Colonel Blimp,1943,life_and_death_of_colonel_blimp,8.7,11,10,1,90,0,1,1,0,100,4.2,1070,93,http://content7.flixster.com/movie/10/92/93/10929329_det.jpg
5826,Rio Grande,1950,rio_grande,6.7,12,9,3,75,0,0,0,0,0,0,0,0,http://content9.flixster.com/movie/30/10/301019_det.jpg
5827,Young Americans,2000,,\N,\N,\N,\N,\N,\N,\N,\N,\N,\N,\N,\N,\N,\N
5828,Bad Day at Black Rock,1955,bad_day_at_black_rock,8.2,25,24,1,96,0,3,2,1,66,3.9,1420,86,http://content9.flixster.com/movie/10/56/78/10567843_det.jpg
5829,Men with Brooms,2002,men_with_brooms,5.6,16,10,6,62,0,3,3,0,100,3.1,1241,61,http://content9.flixster.com/movie/27/39/273907_det.jpg
5830,Mysterious Island,1961,1014592-mysterious_island,6.2,10,8,2,80,0,0,0,0,0,0,0,0,http://content8.flixster.com/movie/28/65/286594_det.jpg
5831,Soul Assassin,2001,soul_assassin,0,1,0,1,0,0,0,0,0,0,0,0,0,http://content7.flixster.com/movie/10/89/12/10891241_det.jpg
5832,Left Behind II: Tribulation Force,2002,left_behind_ii_tribulation_force,0,2,0,2,0,0,0,0,0,0,0,0,0,http://content8.flixster.com/movie/10/88/75/10887598_det.jpg
5833,Dog Soldiers,2002,dog_soldiers,6.8,29,22,7,75,0,2,2,0,100,0,0,0,http://content7.flixster.com/movie/26/93/269313_det.jpg
5834,Goldfinger,1964,goldfinger,8.4,48,46,2,95,7.9,6,5,1,83,3.6,22155,83,http://content7.flixster.com/movie/26/38/263829_det.jpg
5835,"God afton, Herr Wallenberg - En Passionshistoria fr√•n verkligheten",1990,,\N,\N,\N,\N,\N,\N,\N,\N,\N,\N,\N,\N,\N,\N
5836,Houseboat,1958,houseboat,5.5,11,6,5,54,0,0,0,0,0,0,0,0,http://content9.flixster.com/movie/10/87/75/10877507_det.jpg
5837,Legion of the Dead,2005,1156538-legion_of_the_dead,0,0,0,0,0,0,0,0,0,0,0,0,0,http://content8.flixster.com/movie/10/85/37/10853770_det.jpg
5838,Madame Bovary,1991,1042062-madame_bovary,6.4,10,8,2,80,0,1,1,0,100,3.3,531,57,http://content9.flixster.com/movie/10/92/98/10929847_det.jpg
5839,La gloire de mon p√®re,1990,my_fathers_glory,7.5,5,5,0,100,0,2,2,0,100,3.9,1022,84,http://content7.flixster.com/movie/10/91/76/10917665_det.jpg
5840,Le ch√¢teau de ma m√®re,1990,my_mothers_castle,7.4,7,6,1,85,0,2,1,1,50,4,771,84,http://content9.flixster.com/movie/10/91/76/10917667_det.jpg
5841,Return to the Blue Lagoon,1991,return_to_the_blue_lagoon,1.9,20,0,20,0,0,4,0,4,0,2.8,2859,48,http://content7.flixster.com/movie/10/92/42/10924289_det.jpg
5842,Trop belle pour toi,1989,too_beautiful_for_you,0,3,3,0,100,0,1,1,0,100,3.5,391,66,http://content8.flixster.com/movie/10/92/32/10923286_det.jpg
5843,Toy Soldiers,1991,1035639-toy_soldiers,4.4,13,5,8,38,0,2,0,2,0,3,3691,57,http://content9.flixster.com/movie/10/91/90/10919071_det.jpg
5844,The Prowler,1981,1016854-prowler,0,3,2,1,66,0,0,0,0,0,0,0,0,http://content8.flixster.com/movie/28/55/285514_det.jpg
5845,The Pursuit of D.B. Cooper,1981,pursuit_of_db_cooper,0,0,0,0,0,0,0,0,0,0,0,0,0,http://images.rottentomatoescdn.com/images/defaults/poster_default.gif
5846,Raggedy Man,1981,raggedy_man,6.5,6,5,1,83,0,1,1,0,100,3.3,201,65,http://content8.flixster.com/movie/26/44/264430_det.jpg
5847,Ragtime,1981,ragtime,7.3,10,9,1,90,0,1,1,0,100,3.5,672,71,http://content9.flixster.com/movie/98/97/51/9897515_det.jpg
5848,Rich and Famous,1981,1017530-rich_and_famous,4.9,9,5,4,55,0,1,0,1,0,3,151,38,http://content9.flixster.com/movie/10/85/62/10856287_det.jpg
5849,Ricomincio da tre,1981,,\N,\N,\N,\N,\N,\N,\N,\N,\N,\N,\N,\N,\N,\N
5851,Rollover,1981,rollover,0,3,2,1,66,0,0,0,0,0,0,0,0,http://content8.flixster.com/movie/27/84/278422_det.jpg
5852,Saturday the 14th,1981,saturday_the_14th,3.4,10,1,9,10,0,0,0,0,0,0,0,0,http://content9.flixster.com/movie/19/57/51/1957519_det.jpg
5853,Scanners,1981,1018315-scanners,6.8,25,19,6,76,0,4,1,3,25,3.2,5721,61,http://content8.flixster.com/movie/10/61/95/10619538_det.jpg
5854,Sharky's Machine,1981,sharkys_machine,6.2,14,13,1,92,0,1,1,0,100,3,659,45,http://content6.flixster.com/movie/27/34/273492_det.jpg
5855,Shock Treatment,1981,shock_treatment,5.3,5,2,3,40,0,0,0,0,0,0,0,0,http://content7.flixster.com/movie/11/15/34/11153485_det.jpg
5856,Sjecas li se Dolly Bell,1981,do_you_remember_dolly_bell,0,4,4,0,100,0,0,0,0,0,0,0,0,http://content7.flixster.com/movie/11/01/82/11018269_det.jpg
5857,So Fine,1981,so_fine,0,4,3,1,75,0,1,1,0,100,2.9,107,15,http://content6.flixster.com/movie/10/85/39/10853936_det.jpg
5858,La soupe aux choux,1981,soupe_aux_choux,0,0,0,0,0,0,0,0,0,0,0,0,0,http://content9.flixster.com/movie/63/85/02/6385023_det.jpg
5859,Southern Comfort,1981,1019482-southern_comfort,6.7,14,12,2,85,0,1,1,0,100,3.5,1184,72,http://content7.flixster.com/movie/10/86/94/10869485_det.jpg
5860,Sphinx,1981,1019612-sphinx,0,0,0,0,0,0,0,0,0,0,0,0,0,http://content7.flixster.com/movie/10/87/14/10871421_det.jpg
5861,Storie di ordinaria follia,1981,storie-di-ordinaria-follia-tales-of-ordinary-madness,0,0,0,0,0,0,0,0,0,0,0,0,0,http://content7.flixster.com/movie/10/91/75/10917545_det.jpg
5862,Student Bodies,1981,student_bodies,3.2,6,1,5,16,0,0,0,0,0,0,0,0,http://content7.flixster.com/movie/11/13/82/11138233_det.jpg
5863,Take This Job and Shove It,1981,take_this_job_and_shove_it,0,1,0,1,0,0,0,0,0,0,0,0,0,http://content8.flixster.com/movie/26/27/262726_det.jpg
5864,Tarzan the Ape Man,1932,1020896-tarzan_the_ape_man,7.8,13,13,0,100,0,0,0,0,0,0,0,0,http://content9.flixster.com/movie/83/84/86/8384863_det.jpg
5865,Tattoo,2002,10001956-tattoo,6.5,25,17,8,68,6.6,9,6,3,66,3.4,520,60,http://content6.flixster.com/movie/29/59/41/2959412_det.jpg
5866,They All Laughed,1981,they_all_laughed,5.2,6,2,4,33,0,0,0,0,0,0,0,0,http://content9.flixster.com/movie/10/89/44/10894419_det.jpg
5867,The Thief of Bagdad,1924,1028714-thief_of_bagdad,8.1,13,13,0,100,0,1,1,0,100,3.6,655,75,http://content9.flixster.com/movie/15/52/58/1552587_det.jpg
5868,Elvis,1979,elvis_the_movie,0,2,1,1,50,0,0,0,0,0,0,0,0,http://content7.flixster.com/movie/10/05/52/10055261_det.jpg
5869,True Confessions,1981,true_confessions,7.5,6,6,0,100,0,1,1,0,100,3.3,674,55,http://content6.flixster.com/movie/36/46/41/3646416_det.jpg
5870,Revolution #9,2001,revolution-9,6.5,25,19,6,76,6,5,4,1,80,3.3,37,57,http://content8.flixster.com/movie/10/89/28/10892814_det.jpg
5872,Die Another Day,2002,die_another_day,6.1,190,112,78,58,5.6,36,15,21,41,3.1,29585,53,http://content8.flixster.com/movie/10/93/34/10933478_det.jpg
5873,The Emperor's Club,2002,emperors_club,5.8,125,63,62,50,5.7,30,14,16,46,3.3,5179,66,http://content9.flixster.com/movie/25/93/259391_det.jpg
5874,Friday After Next,2002,friday_after_next,4.1,69,17,52,24,4.5,23,7,16,30,3.3,23508,76,http://content7.flixster.com/movie/10/88/93/10889369_det.jpg
5875,Personal Velocity: Three Portraits,2002,personal_velocity,6.5,99,68,31,68,7.3,28,22,6,78,3.4,664,61,http://content8.flixster.com/movie/10/84/15/10841598_det.jpg
5876,The Quiet American,2002,1118347-quiet_american,7.7,150,131,19,87,8,35,33,2,94,3.5,2910,69,http://content8.flixster.com/movie/10/90/98/10909866_det.jpg
5878,Hable con ella,2002,con-man,0,0,0,0,0,0,0,0,0,0,0,0,0,http://content7.flixster.com/movie/10/84/79/10847933_det.jpg
5879,Eight Crazy Nights,2002,adam_sandlers_eight_crazy_nights,3.1,105,13,92,12,3.3,30,4,26,13,3.1,18784,61,http://content8.flixster.com/movie/10/93/56/10935638_det.jpg
5880,Extreme Ops,2002,extreme_ops,2.9,65,4,61,6,3.3,18,2,16,11,2.6,1235,33,http://content7.flixster.com/movie/26/67/266701_det.jpg
5881,Solyaris,1972,solyaris,8.3,39,38,1,97,8.2,8,8,0,100,4.1,7425,89,http://content9.flixster.com/movie/10/86/81/10868183_det.jpg
5882,Treasure Planet,2002,treasure_planet,6.5,140,97,43,69,6.5,33,24,9,72,3.1,9742,64,http://content7.flixster.com/movie/25/74/257421_det.jpg
5883,They,2002,1115907-1115907-they,4.2,54,20,34,37,3.9,12,4,8,33,2.6,2603,31,http://content8.flixster.com/movie/10/83/86/10838622_det.jpg
5884,Chrome Hearts,1989,chopper_chicks_in_zombietown,0,3,0,3,0,0,0,0,0,0,0,0,0,http://content9.flixster.com/movie/11/13/92/11139267_det.jpg
5885,"Was tun, wenn's brennt?",2001,what_to_do_in_case_of_fire,5.6,24,12,12,50,5.5,8,5,3,62,4,589,84,http://content7.flixster.com/movie/28/54/96/2854961_det.jpg
5886,Ik ook van jou,2001,i_love_you_too,0,0,0,0,0,0,0,0,0,0,0,0,0,http://content7.flixster.com/movie/11/15/07/11150737_det.jpg
5887,Another You,1991,another_you,3,8,1,7,12,0,0,0,0,0,0,0,0,http://content8.flixster.com/movie/27/76/277626_det.jpg
5888,Borat: Cultural Learnings of America for Make Benefit Glorious Nation of Kazakhstan,2006,borat,8,209,191,18,91,8.1,41,40,1,97,3.4,141091,76,http://content7.flixster.com/movie/32/05/57/3205577_det.jpg
5889,Zhestokiy romans,1984,,\N,\N,\N,\N,\N,\N,\N,\N,\N,\N,\N,\N,\N,\N
5890,Elling,2001,elling,7.1,58,49,9,84,7.3,17,16,1,94,4.1,2002,90,http://content9.flixster.com/movie/10/88/31/10883135_det.jpg
5891,Day of the Woman,1978,i_spit_on_your_grave,4.9,27,15,12,55,0,0,0,0,0,0,0,0,http://content6.flixster.com/movie/11/12/31/11123100_det.jpg
5892,The Island at the Top of the World,1974,island_at_the_top_of_the_world,0,3,1,2,33,0,0,0,0,0,0,0,0,http://content7.flixster.com/movie/31/06/310621_det.jpg
5893,The Last Seduction,1994,last_seduction,7.8,48,45,3,93,7.9,11,11,0,100,3.6,1444,73,http://content8.flixster.com/movie/10/87/98/10879818_det.jpg
5895,Contact,1997,1078021-contact,6.8,55,37,18,67,6.5,13,7,6,53,3.1,19572,74,http://content9.flixster.com/movie/25/44/254411_det.jpg
5896,New Waterford Girl,1999,new_waterford_girl,7.4,12,11,1,91,0,2,2,0,100,3.7,582,80,http://content9.flixster.com/movie/30/44/304403_det.jpg
5897,Das Arche Noah Prinzip,1984,noahs_ark_principle,0,0,0,0,0,0,0,0,0,0,0,0,0,http://content8.flixster.com/movie/64/02/37/6402370_det.jpg
5898,The Sword and the Sorcerer,1982,sword_and_the_sorcerer,6.8,5,4,1,80,0,0,0,0,0,0,0,0,http://content9.flixster.com/movie/10/89/23/10892327_det.jpg
5899,Zulu,1964,zulu,7.2,13,12,1,92,0,2,2,0,100,3.8,4868,89,http://content6.flixster.com/movie/28/73/287300_det.jpg
5900,Analyze That,2002,analyze_that,4.8,145,39,106,26,4.1,32,6,26,18,2.9,11576,45,http://content9.flixster.com/movie/27/55/275523_det.jpg
5901,Empire,2002,1118698-empire,4.4,99,21,78,21,4.5,26,5,21,19,3.3,2601,62,http://content9.flixster.com/movie/31/30/313091_det.jpg
5902,Adaptation.,2002,1118700-adaptation,8.2,195,177,18,90,8,35,30,5,85,3.6,39757,82,http://content6.flixster.com/movie/26/86/268624_det.jpg
5903,Equilibrium,2002,equilibrium,4.8,82,30,52,36,4.5,23,7,16,30,3.7,77822,82,http://content8.flixster.com/movie/26/70/267094_det.jpg
5906,√áa commence aujourd'hui,1999,,7.2,16,13,3,81,0,4,4,0,100,3.6,210,73,http://content8.flixster.com/movie/10/88/99/10889966_det.jpg
5907,Madea Goes to Jail,2009,madea-goes-to-jail,4.9,46,12,34,26,4.5,11,3,8,27,3.8,153294,74,http://content9.flixster.com/movie/10/88/81/10888143_det.jpg
5909,Bijit√¢ Q,2001,visitor_q,5.6,8,4,4,50,0,1,0,1,0,3.8,3392,77,http://content9.flixster.com/movie/10/88/59/10885907_det.jpg
5910,Les uns et les autres,1981,,\N,\N,\N,\N,\N,\N,\N,\N,\N,\N,\N,\N,\N,\N
5911,Urgh! A Music War,1981,urgh-a-music-war,0,0,0,0,0,0,0,0,0,0,0,0,0,http://content7.flixster.com/movie/10/85/72/10857225_det.jpg
5912,Vabank,1981,vabank,0,0,0,0,0,0,0,0,0,0,0,0,0,http://content8.flixster.com/movie/11/03/46/11034654_det.jpg
5913,Varning f√∂r J√∂nssonligan,1981,varning-for-jonssonligan,0,0,0,0,0,0,0,0,0,0,0,0,0,http://images.rottentomatoescdn.com/images/defaults/poster_default.gif
5914,"Vernon, Florida",1981,vernon_florida,7.9,7,7,0,100,0,0,0,0,0,0,0,0,http://content9.flixster.com/movie/29/54/295427_det.jpg
5915,Victory,1981,1022576-victory,5.7,6,4,2,66,0,2,2,0,100,3.5,2887,69,http://content8.flixster.com/movie/25/68/256802_det.jpg
5916,Whose Life Is It Anyway?,1981,whose_life_is_it_anyway,5.9,5,4,1,80,0,0,0,0,0,0,0,0,http://content7.flixster.com/movie/10/88/81/10888177_det.jpg
5917,Zoot Suit,1981,zoot_suit,0,3,1,2,33,0,0,0,0,0,0,0,0,http://content9.flixster.com/movie/10/87/85/10878503_det.jpg
5918,Alone in the Dark,2005,alone_in_the_dark,1.7,116,1,115,0,1.7,26,0,26,0,2.1,8641,21,http://content6.flixster.com/movie/10/92/96/10929640_det.jpg
5919,Android Apocalypse,2006,android_apocalypse,0,2,0,2,0,0,0,0,0,0,0,0,0,http://content7.flixster.com/movie/10/89/08/10890865_det.jpg
5921,Attack Force Z,1982,attack_force_z,0,0,0,0,0,0,0,0,0,0,0,0,0,http://content8.flixster.com/movie/73/76/91/7376918_det.jpg
5922,Attila,1954,,\N,\N,\N,\N,\N,\N,\N,\N,\N,\N,\N,\N,\N,\N
5923,Author! Author!,1982,author_author,0,1,1,0,100,0,0,0,0,0,0,0,0,http://content9.flixster.com/movie/61/03/38/6103387_det.jpg
5924,Barbarosa,1982,barbarosa,0,4,4,0,100,0,0,0,0,0,0,0,0,http://content8.flixster.com/movie/10/89/50/10895010_det.jpg
5925,The Beast Within,1982,beast_within,0,4,0,4,0,0,0,0,0,0,0,0,0,http://content9.flixster.com/movie/10/91/95/10919519_det.jpg
5926,My Best Friend's Wedding,1997,my_best_friends_wedding,6.5,54,39,15,72,5.9,17,10,7,58,3.3,64013,72,http://content7.flixster.com/movie/55/35/54/5535541_det.jpg
5927,The Best Little Whorehouse in Texas,1982,best_little_whorehouse_in_texas,5.1,9,5,4,55,0,1,0,1,0,3.2,2628,68,http://content8.flixster.com/movie/26/84/268402_det.jpg
5928,The Border,1982,1002907-border,6.7,9,8,1,88,0,0,0,0,0,0,0,0,http://content8.flixster.com/movie/27/58/275894_det.jpg
5929,La boum,1980,,\N,\N,\N,\N,\N,\N,\N,\N,\N,\N,\N,\N,\N,\N
5930,Brimstone & Treacle,1982,brimstone_and_treacle,0,1,1,0,100,0,0,0,0,0,0,0,0,http://content8.flixster.com/movie/10/95/63/10956306_det.jpg
5931,Britannia Hospital,1982,britannia_hospital,6.8,5,3,2,60,0,0,0,0,0,0,0,0,http://content6.flixster.com/movie/10/88/30/10883016_det.jpg
5932,Burden of Dreams,1982,burden_of_dreams,8.6,14,14,0,100,0,2,2,0,100,4.1,903,89,http://content9.flixster.com/movie/29/55/295503_det.jpg
5933,Cannery Row,1982,cannery_row,6.2,6,4,2,66,0,1,0,1,0,3.5,328,67,http://content6.flixster.com/movie/49/79/29/4979292_det.jpg
5935,Class of 1984,1982,class_of_1984,5.9,10,6,4,60,0,1,1,0,100,3.2,1460,61,http://content9.flixster.com/movie/10/89/54/10895447_det.jpg
5936,"Come Back to the Five and Dime, Jimmy Dean, Jimmy Dean",1982,come_back_to_the_5_and_dime_jimmy_dean_jimmy_dean,0,0,0,0,0,0,0,0,0,0,0,0,0,http://content8.flixster.com/movie/10/89/41/10894142_det.jpg
5937,Danton,1983,danton,7.7,7,6,1,85,0,1,1,0,100,3.8,550,79,http://content9.flixster.com/movie/95/34/51/9534511_det.jpg
5938,Deathtrap,1982,deathtrap,6.1,11,7,4,63,0,1,1,0,100,3.5,1117,69,http://content9.flixster.com/movie/25/98/259815_det.jpg
5939,D√ºnyayi kurtaran adam,1982,turkish_star_wars,0,2,2,0,100,0,0,0,0,0,0,0,0,http://content7.flixster.com/movie/12/87/50/1287509_det.jpg
5940,Eating Raoul,1982,eating_raoul,6.7,17,15,2,88,0,1,0,1,0,3.4,1151,67,http://content9.flixster.com/movie/27/11/271103_det.jpg
5941,Drumline,2002,drumline,6.7,81,66,15,81,7,25,23,2,92,3.2,40552,73,http://content6.flixster.com/movie/10/88/87/10888704_det.jpg
5942,The Hot Chick,2002,hot_chick,3.8,80,17,63,21,4.1,24,7,17,29,3.1,39910,67,http://content8.flixster.com/movie/25/84/258410_det.jpg
5943,Maid in Manhattan,2002,maid_in_manhattan,5.1,144,56,88,38,5.1,32,10,22,31,2.9,39640,53,http://content9.flixster.com/movie/10/87/06/10870643_det.jpg
5944,Star Trek: Nemesis,2002,star_trek_nemesis,5.2,155,57,98,36,5.8,32,14,18,43,3.1,16224,56,http://content7.flixster.com/movie/10/88/85/10888597_det.jpg
5945,About Schmidt,2002,about_schmidt,7.7,198,168,30,84,7.9,41,37,4,90,3.1,14978,64,http://content6.flixster.com/movie/10/89/01/10890128_det.jpg
5946,El Bola,2000,el-bola,7.2,11,10,1,90,0,4,4,0,100,3.9,644,85,http://content6.flixster.com/movie/10/36/07/10360792_det.jpg
5947,Evelyn,2002,evelyn,6.1,106,69,37,65,6.5,29,23,6,79,3.6,1505,76,http://content6.flixster.com/movie/26/09/260996_det.jpg
5948,Family Guy,1999,,\N,\N,\N,\N,\N,\N,\N,\N,\N,\N,\N,\N,\N,\N
5949,Intacto,2001,intacto,6.5,72,52,20,72,5.9,21,13,8,61,3.8,2133,82,http://content9.flixster.com/movie/27/72/277295_det.jpg
5950,The Jimmy Show,2001,jimmy_show,5,10,4,6,40,0,3,0,3,0,2.8,238,30,http://content8.flixster.com/movie/28/40/284010_det.jpg
5951,Morvern Callar,2002,morvern_callar,7,76,64,12,84,7.3,24,21,3,87,3.6,1321,74,http://content7.flixster.com/movie/28/37/283713_det.jpg
5952,The Lord of the Rings: The Two Towers,2002,lord_of_the_rings_the_two_towers,8.4,218,210,8,96,8,39,39,0,100,4.1,263598,92,http://content6.flixster.com/movie/25/61/256112_det.jpg
5953,Guizi lai le,2000,devils-on-the-doorstep,6.8,10,9,1,90,0,4,3,1,75,4.1,530,89,http://content7.flixster.com/movie/10/89/49/10894941_det.jpg
5954,25th Hour,2002,25th_hour,7.1,162,126,36,77,7,35,26,9,74,3.7,25056,83,http://content9.flixster.com/movie/10/87/40/10874063_det.jpg
5955,Antwone Fisher,2002,antwone_fisher,6.9,145,114,31,78,7.1,33,28,5,84,3.6,7166,85,http://content8.flixster.com/movie/10/94/35/10943538_det.jpg
5956,Gangs of New York,2002,gangs_of_new_york,7.1,200,149,51,74,6.5,42,28,14,66,3.5,35768,76,http://content6.flixster.com/movie/26/81/268116_det.jpg
5957,Two Weeks Notice,2002,two_weeks_notice,5.2,118,49,69,41,5.1,30,10,20,33,3,28494,63,http://content7.flixster.com/movie/25/98/259805_det.jpg
5958,The Wild Thornberrys Movie,2002,wild_thornberrys_movie,6.6,86,68,18,79,6.9,26,22,4,84,2.8,2798,43,http://content8.flixster.com/movie/25/96/259698_det.jpg
5959,Narc,2002,narc,7.1,151,126,25,83,6.7,30,22,8,73,3.4,4235,76,http://content6.flixster.com/movie/10/04/58/10045880_det.jpg
5960,Bad Influence,1990,bad_influence,6.1,14,10,4,71,0,2,2,0,100,3,751,46,http://content7.flixster.com/movie/27/40/274025_det.jpg
5961,Blue Steel,1989,1028554-blue_steel,5.9,16,12,4,75,0,2,2,0,100,2.8,1502,32,http://content8.flixster.com/movie/11/13/20/11132034_det.jpg
5962,Body of Evidence,1993,body_of_evidence,2.7,33,2,31,6,2.6,8,0,8,0,2.4,1797,30,http://content6.flixster.com/movie/28/72/287204_det.jpg
5963,The Children's Hour,1961,childrens_hour,7.2,5,5,0,100,0,0,0,0,0,0,0,0,http://content7.flixster.com/movie/29/33/293325_det.jpg
5964,The Business,2005,10005666-business,5.8,6,3,3,50,0,0,0,0,0,0,0,0,http://content7.flixster.com/movie/31/31/313113_det.jpg
5965,The Duellists,1977,duellists,7.3,14,14,0,100,0,0,0,0,0,0,0,0,http://content7.flixster.com/movie/11/12/21/11122181_det.jpg
5966,A Kiss Before Dying,1956,1101255-kiss_before_dying,0,4,3,1,75,0,0,0,0,0,0,0,0,http://content7.flixster.com/movie/10/83/91/10839121_det.jpg
5968,Miami Blues,1990,miami_blues,6.5,18,15,3,83,0,2,0,2,0,3,889,45,http://content8.flixster.com/movie/27/84/278410_det.jpg
5969,My Girl,1991,1037649-my_girl,5.3,12,6,6,50,0,2,1,1,50,3.5,29984,75,http://content6.flixster.com/movie/26/11/261104_det.jpg
5970,My Girl,1991,1037649-my_girl,5.3,12,6,6,50,0,2,1,1,50,3.5,29984,75,http://content6.flixster.com/movie/26/11/261104_det.jpg
5971,Tonari no Totoro,1988,my_neighbor_totoro,8.1,28,25,3,89,0,3,1,2,33,4.3,31390,94,http://content9.flixster.com/movie/10/93/56/10935671_det.jpg
5972,The Road to Hong Kong,1962,road_to_hong_kong,0,4,3,1,75,0,0,0,0,0,0,0,0,http://content9.flixster.com/movie/28/71/287191_det.jpg
5973,Running Time,1997,running-time,0,0,0,0,0,0,0,0,0,0,0,0,0,http://content8.flixster.com/movie/38/13/56/3813566_det.gif
5974,The Thief of Bagdad,1924,1028714-thief_of_bagdad,8.1,13,13,0,100,0,1,1,0,100,3.6,655,75,http://content9.flixster.com/movie/15/52/58/1552587_det.jpg
5975,War and Peace,1956,1023093-war_and_peace,5,6,3,3,50,0,1,0,1,0,3.5,2121,66,http://content6.flixster.com/movie/10/93/85/10938588_det.jpg
5976,Stay,2006,1158918-sleeping_dogs_lie,6.1,50,32,18,64,6.1,14,10,4,71,2.8,1534,38,http://content8.flixster.com/movie/10/88/93/10889358_det.jpg
5977,Where's Poppa?,1970,wheres_poppa,7.4,8,8,0,100,0,1,1,0,100,3.3,354,64,http://content9.flixster.com/movie/27/04/270411_det.jpg
5978,The Whistle Blower,1987,whistle_blower,7.6,7,6,1,85,0,1,1,0,100,3.1,379,36,http://content9.flixster.com/movie/26/48/264815_det.jpg
5979,Attack of the Crab Monsters,1957,attack_of_the_crab_monsters,0,1,0,1,0,0,0,0,0,0,0,0,0,http://content8.flixster.com/movie/10/88/18/10881806_det.jpg
5980,Black Christmas,2006,black-love,0,0,0,0,0,0,0,0,0,0,0,0,0,http://content9.flixster.com/movie/10/84/31/10843131_det.jpg
5981,The Day of the Triffids,1962,1005366-day_of_the_triffids,6.5,15,13,2,86,0,1,1,0,100,3,1136,47,http://content6.flixster.com/movie/30/20/302012_det.jpg
5982,Esther Kahn,2000,esther-kahn,5.5,24,12,12,50,4.2,8,2,6,25,3.5,245,57,http://content7.flixster.com/movie/10/91/09/10910917_det.jpg
5983,Invaders from Mars,1953,1010672-invaders_from_mars,7,10,8,2,80,0,0,0,0,0,0,0,0,http://content6.flixster.com/movie/10/92/41/10924148_det.jpg
5984,Histoire d'O,1975,the-story-of-o,0,0,0,0,0,0,0,0,0,0,0,0,0,http://content6.flixster.com/movie/10/85/71/10857176_det.jpg
5985,Asoka,2001,asoka,7.6,10,10,0,100,0,0,0,0,0,0,0,0,http://content6.flixster.com/movie/27/19/271996_det.jpg
5986,Fat City,1972,fat_city,8.6,17,17,0,100,8.1,5,5,0,100,3.9,668,84,http://content8.flixster.com/movie/26/36/263622_det.jpg
5987,"Love, Honour and Obey",2000,love_honor_and_obey,4.2,15,4,11,26,2.9,5,0,5,0,4.1,2113,87,http://content8.flixster.com/movie/27/97/279794_det.jpg
5988,Quicksilver,1986,quicksilver,3.1,12,1,11,8,0,1,0,1,0,2.8,823,34,http://content7.flixster.com/movie/25/96/259605_det.jpg
5989,Catch Me If You Can,2002,catch_me_if_you_can,7.9,191,183,8,95,7.3,42,38,4,90,3.6,77695,81,http://content7.flixster.com/movie/11/15/12/11151205_det.jpg
5990,Pinocchio,1940,1016342-pinocchio,9,37,37,0,100,8.5,5,5,0,100,3.3,19102,66,http://content8.flixster.com/movie/10/87/27/10872762_det.jpg
5991,Chicago,2002,,\N,\N,\N,\N,\N,\N,\N,\N,\N,\N,\N,\N,\N,\N
5992,The Hours,2002,hours,7.4,184,148,36,80,7.1,37,29,8,78,3.7,23176,83,http://content8.flixster.com/movie/26/18/261814_det.jpg
5993,Max,2002,max,6.4,110,76,34,69,6.3,27,19,8,70,3.3,1412,63,http://content9.flixster.com/movie/27/59/275907_det.jpg
5994,Nicholas Nickleby,2002,1119037-nicholas_nickleby,6.8,120,92,28,76,6.4,30,22,8,73,3.5,2514,72,http://content9.flixster.com/movie/31/29/312991_det.jpg
5995,The Pianist,2002,pianist,8.2,177,169,8,95,8.1,35,33,2,94,4,55875,94,http://content8.flixster.com/movie/11/12/67/11126798_det.jpg
5996,Sonny,2002,sonny,4.2,26,6,20,23,4.2,8,2,6,25,3,1479,43,http://content8.flixster.com/movie/10/87/40/10874098_det.jpg
5997,Champagne for Caesar,1950,champagne_for_caesar,0,3,3,0,100,0,0,0,0,0,0,0,0,http://content6.flixster.com/movie/10/86/68/10866884_det.jpg
5998,Doppelg√§nger,1969,journey_to_the_far_side_of_the_sun,0,4,1,3,25,0,0,0,0,0,0,0,0,http://content7.flixster.com/movie/25/29/252909_det.jpg
5999,Heavy Metal 2000,2000,heavy_metal_2000,3.7,9,0,9,0,0,1,0,1,0,2.9,2857,44,http://content7.flixster.com/movie/27/68/276805_det.jpg
6000,La casa sperduta nel parco,1980,house_on_the_edge_of_the_park,0,3,1,2,33,0,0,0,0,0,0,0,0,http://content8.flixster.com/movie/10/95/78/10957814_det.jpg
6001,The King of Comedy,1982,1011623-king_of_comedy,8.3,39,36,3,92,7,5,4,1,80,3.8,6225,84,http://content7.flixster.com/movie/25/78/257817_det.jpg
6002,Love Liza,2002,love_liza,5.9,85,46,39,54,5.6,24,13,11,54,3.7,1656,76,http://content6.flixster.com/movie/27/52/275292_det.jpg
6003,Confessions of a Dangerous Mind,2002,,\N,\N,\N,\N,\N,\N,\N,\N,\N,\N,\N,\N,\N,\N
6004,Vale Abra√£o,1993,abrahams_valley,7.3,6,5,1,83,0,2,2,0,100,3.7,181,69,http://content6.flixster.com/movie/10/90/59/10905940_det.jpg
6005,Blue Collar Comedy Tour: The Movie,2003,blue_collar_comedy_tour_the_movie,6.8,13,12,1,92,7,8,8,0,100,3.6,6829,82,http://content6.flixster.com/movie/10/89/21/10892104_det.jpg
6006,Just Married,2003,just-married-marriage-was-only-the-beginning,0,0,0,0,0,0,0,0,0,0,0,0,0,http://content6.flixster.com/movie/11/14/71/11147160_det.jpg
6007,P.S. Your Cat Is Dead!,2002,ps_your_cat_is_dead,4.2,17,4,13,23,4.1,8,1,7,12,3.1,453,48,http://content8.flixster.com/movie/28/05/280502_det.jpg
6008,Le fils,2002,the-son-le-fils,0,0,0,0,0,0,0,0,0,0,0,0,0,http://content6.flixster.com/movie/30/49/304920_det.jpg
6009,Hy√¥ry√ª-gai,2000,1110769-city_of_lost_souls,5.4,12,7,5,58,0,2,1,1,50,3.2,791,48,http://content9.flixster.com/movie/10/92/43/10924339_det.jpg
6010,Double Whammy,2001,double_whammy,4.5,10,3,7,30,0,0,0,0,0,0,0,0,http://content8.flixster.com/movie/28/02/280210_det.jpg
6011,WiseGirls,2002,wisegirls2002,0,0,0,0,0,0,0,0,0,0,0,0,0,http://content8.flixster.com/movie/10/84/93/10849354_det.jpg
6012,A Guy Thing,2003,guy_thing,4.1,97,24,73,24,3.8,27,5,22,18,2.8,8292,37,http://content6.flixster.com/movie/26/21/262112_det.jpg
6013,Kangaroo Jack,2003,1136750-jack,0,0,0,0,0,0,0,0,0,0,0,0,0,http://content7.flixster.com/movie/93/43/76/9343769_det.jpg
6014,National Security,2003,national_security,3.3,87,10,77,11,4,26,6,20,23,3,10503,55,http://content8.flixster.com/movie/26/19/261926_det.jpg
6015,Da wan,2001,big_shots_funeral,4.7,15,3,12,20,0,1,0,1,0,3.6,201,72,http://content8.flixster.com/movie/10/87/11/10871130_det.jpg
6016,Cidade de Deus,2002,city_of_god,8.3,149,137,12,91,8.2,34,31,3,91,4.3,66456,97,http://content7.flixster.com/movie/26/72/267221_det.jpg
6017,Yadon ilaheyya,2002,1119800-divine_intervention,7.2,68,55,13,80,7.6,19,18,1,94,3.7,616,76,http://content8.flixster.com/movie/10/89/02/10890222_det.jpg
6018,En k√¶rlighedshistorie,2001,kiras_reason_a_love_story,5.7,18,12,6,66,0,4,1,3,25,3.7,143,64,http://content6.flixster.com/movie/88/97/60/8897608_det.jpg
6019,Indagine su un cittadino al di sopra di ogni sospetto,1970,investigation_of_a_citizen_above_suspicion,7.9,5,5,0,100,0,3,3,0,100,4.4,483,97,http://content6.flixster.com/movie/53/53/00/5353004_det.jpg
6020,Alice Adams,1935,alice_adams,7.8,14,13,1,92,0,3,3,0,100,3.6,789,67,http://content9.flixster.com/movie/30/31/303111_det.jpg
6021,Der amerikanische Freund,1977,american_friend,7.2,16,14,2,87,0,2,2,0,100,3.8,1218,80,http://content9.flixster.com/movie/29/98/299891_det.jpg
6022,American Me,1992,american_me,6.8,8,5,3,62,0,2,2,0,100,4.1,2720,91,http://content7.flixster.com/movie/10/89/50/10895017_det.jpg
6023,Bande √† part,1964,band_of_outsiders,7.9,39,37,2,94,7.7,12,12,0,100,4.2,4082,91,http://content6.flixster.com/movie/10/89/23/10892392_det.jpg
6024,The Break-Up,2006,break_up,5,187,62,125,33,4.5,40,8,32,20,3.1,107481,52,http://content8.flixster.com/movie/10/89/28/10892870_det.jpg
6025,CB4,1993,cb4,5.7,20,11,9,55,4.8,7,2,5,28,3.1,2278,60,http://content6.flixster.com/movie/27/05/270524_det.jpg
6026,Der Totmacher,1995,deathmaker,0,0,0,0,0,0,0,0,0,0,0,0,0,http://content7.flixster.com/movie/30/76/307613_det.jpg
6027,Dogfight,1991,1036458-dogfight,6.8,15,12,3,80,0,2,1,1,50,3.8,1613,83,http://content8.flixster.com/movie/27/17/271722_det.jpg
6029,Fun in Acapulco,1963,,\N,\N,\N,\N,\N,\N,\N,\N,\N,\N,\N,\N,\N,\N
6030,Girls! Girls! Girls!,1962,1008358-girls_girls_girls,4.9,5,2,3,40,0,0,0,0,0,0,0,0,http://content7.flixster.com/movie/26/07/260709_det.jpg
6031,Imitation of Life,1959,1010417-imitation_of_life,7.4,13,11,2,84,0,1,1,0,100,4.2,2834,91,http://content9.flixster.com/movie/30/43/304323_det.jpg
6032,A Little Romance,1979,1012506-little_romance,6.7,14,11,3,78,0,1,0,1,0,3.8,1363,79,http://content8.flixster.com/movie/10/91/32/10913278_det.jpg
6033,Mystery Date,1991,mystery_date,4.7,8,2,6,25,0,1,0,1,0,2.9,538,41,http://content8.flixster.com/movie/26/48/264810_det.jpg
6035,P√©p√© le Moko,1937,pepe-le-moko,8.6,29,29,0,100,8.8,11,11,0,100,3.8,713,82,http://content6.flixster.com/movie/10/85/08/10850812_det.jpg
6036,Secret Admirer,1985,secret_admirer,4.1,8,2,6,25,0,0,0,0,0,0,0,0,http://content7.flixster.com/movie/26/94/269405_det.jpg
6037,Summer Lovers,1982,summer_lovers,0,4,0,4,0,0,1,0,1,0,3.1,495,47,http://content8.flixster.com/movie/27/02/270222_det.jpg
6038,Tune in Tomorrow...,1990,tune_in_tomorrow,6,11,5,6,45,6.2,5,2,3,40,3,665,42,http://content6.flixster.com/movie/26/39/263900_det.jpg
6039,The Woman in Red,1984,woman_in_red,4.3,7,2,5,28,0,0,0,0,0,0,0,0,http://content8.flixster.com/movie/10/88/55/10885562_det.jpg
6040,Darkness Falls,2003,darkness_falls,3.2,124,10,114,8,3,25,1,24,4,2.8,11135,46,http://content6.flixster.com/movie/26/25/262512_det.jpg
6041,Amen.,2002,amen,6.3,49,33,16,67,6.1,15,9,6,60,3.9,1385,82,http://content7.flixster.com/movie/29/03/290397_det.jpg
6042,Im toten Winkel - Hitlers Sekret√§rin,2002,blind_spot_hitlers_secretary,7.3,80,68,12,85,7.7,27,26,1,96,3.4,472,66,http://content8.flixster.com/movie/25/93/259318_det.jpg
6043,Im Spiegel der Maya Deren,2002,in_the_mirror_of_maya_deren,8,18,17,1,94,7.8,7,7,0,100,3.8,258,79,http://content8.flixster.com/movie/10/87/77/10877738_det.jpg
6044,Blind Date,1987,1002571-blind_date,4.1,22,5,17,22,0,3,1,2,33,2.9,2983,44,http://content9.flixster.com/movie/26/21/262123_det.jpg
6045,Love and a Bullet,2002,love_and_a_bullet,0,2,0,2,0,0,0,0,0,0,0,0,0,http://content6.flixster.com/movie/10/92/33/10923388_det.jpg
6047,Dead Reckoning,1947,1005412-dead_reckoning,6.2,6,4,2,66,0,0,0,0,0,0,0,0,http://content7.flixster.com/movie/29/81/298129_det.jpg
6048,The Devil at 4 O'Clock,1961,devil_at_4_oclock,0,3,2,1,66,0,0,0,0,0,0,0,0,http://content9.flixster.com/movie/30/39/303907_det.jpg
6049,Ethan Frome,1993,ethan_frome,5.7,9,5,4,55,0,2,1,1,50,2.9,406,40,http://content7.flixster.com/movie/25/89/258913_det.jpg
6050,Milk,2008,milk,8,217,203,14,93,8.3,38,36,2,94,3.9,55245,88,http://content8.flixster.com/movie/10/95/34/10953470_det.jpg
6051,The Harder They Come,1972,harder_they_come,7.6,13,11,2,84,0,1,0,1,0,3.9,1321,84,http://content9.flixster.com/movie/31/31/313103_det.jpg
6052,The Horse in the Gray Flannel Suit,1968,horse_in_the_gray_flannel_suit,0,0,0,0,0,0,0,0,0,0,0,0,0,http://content9.flixster.com/movie/10/92/33/10923359_det.jpg
6053,Krush Groove,1985,krush_groove,0,4,3,1,75,0,0,0,0,0,0,0,0,http://content6.flixster.com/movie/10/90/85/10908564_det.jpg
6054,The Moon-Spinners,1964,moonspinners,0,2,1,1,50,0,0,0,0,0,0,0,0,http://content6.flixster.com/movie/25/12/251292_det.jpg
6055,Sugar Hill,1993,1048585-sugar_hill,5.1,9,2,7,22,0,1,0,1,0,3.4,1056,71,http://content6.flixster.com/movie/10/91/32/10913260_det.jpg
6056,Chaos,2005,10006150-chaos,0,4,1,3,25,0,0,0,0,0,0,0,0,http://content9.flixster.com/movie/46/23/91/4623911_det.jpg
6057,Biker Boyz,2003,biker_boyz,4.2,90,20,70,22,4,28,6,22,21,3,10252,59,http://content7.flixster.com/movie/26/30/263017_det.jpg
6058,Final Destination 2,2003,final_destination_2,5,106,50,56,47,4,23,7,16,30,3.2,47391,70,http://content6.flixster.com/movie/35/84/22/3584220_det.jpg
6059,The Recruit,2003,recruit,5.5,163,70,93,42,5.6,35,16,19,45,3.2,15473,63,http://content9.flixster.com/movie/25/65/256599_det.jpg
6060,The Guru,2002,1119875-guru,5.7,87,50,37,57,5.6,25,15,10,60,2.6,2775,39,http://content8.flixster.com/movie/10/93/40/10934098_det.jpg
6061,Kedma,2002,kedma,4.8,13,4,9,30,0,2,0,2,0,3.4,166,53,http://content8.flixster.com/movie/30/97/309706_det.jpg
6062,Lost in La Mancha,2002,lost_in_la_mancha,7.5,97,91,6,93,7.4,25,22,3,88,3.6,5216,72,http://content7.flixster.com/movie/10/93/78/10937849_det.jpg
6063,May,2002,may,6.1,63,43,20,68,5.1,16,7,9,43,3.5,5807,75,http://content9.flixster.com/movie/10/87/03/10870399_det.jpg
6064,The Harder They Fall,1956,1009224-harder_they_fall,7.4,9,9,0,100,0,0,0,0,0,0,0,0,http://content9.flixster.com/movie/30/30/303099_det.jpg
6065,I'm All Right Jack,1959,im_all_right_jack,8,5,5,0,100,0,0,0,0,0,0,0,0,http://content9.flixster.com/movie/29/62/296203_det.jpg
6066,Murder by Decree,1979,murder_by_decree,6.9,7,6,1,85,0,0,0,0,0,0,0,0,http://content6.flixster.com/movie/25/92/259200_det.jpg
6067,Ordinary Decent Criminal,2000,ordinary-decent-criminal,3.7,7,1,6,14,0,0,0,0,0,0,0,0,http://content8.flixster.com/movie/27/73/277310_det.jpg
6068,Pursued,2004,pursued,0,0,0,0,0,0,0,0,0,0,0,0,0,http://content8.flixster.com/movie/28/11/281198_det.jpg
6070,Top√¢zu,1992,tokyo_decadence,6.6,5,3,2,60,0,1,0,1,0,3.4,394,61,http://content6.flixster.com/movie/28/56/285620_det.jpg
6072,La femme infid√®le,1969,unfaithful_wife,0,3,3,0,100,0,0,0,0,0,0,0,0,http://content8.flixster.com/movie/10/89/39/10893958_det.jpg
6073,La decima vittima,1965,tenth_victim,0,4,4,0,100,0,0,0,0,0,0,0,0,http://content8.flixster.com/movie/10/89/40/10894082_det.jpg
6074,The Freshman,1990,10009001-the_freshman,7.3,32,30,2,93,7.2,8,7,1,87,3.1,2525,52,http://content6.flixster.com/movie/11/14/93/11149316_det.jpg
6075,Den enfaldige m√∂rdaren,1982,den-enfaldige-mordaren-the-simpleminded-murder,0,0,0,0,0,0,0,0,0,0,0,0,0,http://content8.flixster.com/movie/71/74/77/7174774_det.jpg
6076,Enigma,2001,1113649-enigma,6.6,104,75,29,72,6.8,29,22,7,75,3.2,2061,52,http://content6.flixster.com/movie/27/95/279508_det.jpg
6077,Evil Under the Sun,1982,evil_under_the_sun,6.5,6,5,1,83,0,1,1,0,100,3.4,1485,61,http://content6.flixster.com/movie/10/94/46/10944652_det.jpg
6078,Firefox,1982,firefox,5.2,12,5,7,41,0,1,1,0,100,2.9,3121,39,http://content6.flixster.com/movie/25/79/257996_det.jpg
6079,Five Days One Summer,1982,five_days_one_summer,4,5,1,4,20,0,2,0,2,0,3,98,41,http://content6.flixster.com/movie/10/91/32/10913208_det.jpg
6080,Forced Vengeance,1982,forced_vengeance,0,0,0,0,0,0,0,0,0,0,0,0,0,http://content8.flixster.com/movie/10/27/87/10278786_det.jpg
6081,Le gendarme et les gendarmettes,1982,gendarme-et-les-gendarmettes-le,0,0,0,0,0,0,0,0,0,0,0,0,0,http://content8.flixster.com/movie/10/89/90/10899030_det.jpg
6082,The Grey Fox,1982,grey_fox,7.1,12,12,0,100,0,1,1,0,100,3.5,162,64,http://content7.flixster.com/movie/10/85/27/10852757_det.jpg
6083,Hammett,1982,hammett,5.2,8,6,2,75,0,0,0,0,0,0,0,0,http://content9.flixster.com/movie/10/86/96/10869627_det.jpg
6084,Honkytonk Man,1982,honkytonk_man,7,14,13,1,92,0,4,3,1,75,3.2,1335,52,http://content7.flixster.com/movie/26/18/261821_det.jpg
6086,"I, the Jury",1982,1010263-i_the_jury,0,4,1,3,25,0,0,0,0,0,0,0,0,http://content9.flixster.com/movie/71/60/13/7160131_det.jpg
6087,If You Could See What I Hear,1982,if_you_could_see_what_i_hear,0,0,0,0,0,0,0,0,0,0,0,0,0,http://content6.flixster.com/movie/92/55/59/9255596_det.jpg
6088,Jekyll and Hyde... Together Again,1982,jekyll_and_hyde_together_again,0,0,0,0,0,0,0,0,0,0,0,0,0,http://content6.flixster.com/movie/63/53/21/6353212_det.jpg
6089,J√∂nssonligan & DynamitHarry,1982,jonssonligan-dynamitharry,0,0,0,0,0,0,0,0,0,0,0,0,0,http://images.rottentomatoescdn.com/images/defaults/poster_default.gif
6090,Kiss Me Goodbye,1982,kiss_me_goodbye,0,1,1,0,100,0,0,0,0,0,0,0,0,http://content8.flixster.com/movie/25/93/259314_det.jpg
6091,Laberinto de pasiones,1982,labyrinth_of_passion,7.8,6,6,0,100,0,4,4,0,100,0,0,0,http://content8.flixster.com/movie/54/66/68/5466682_det.jpg
6092,The Last American Virgin,1982,last_american_virgin,5.8,9,6,3,66,0,1,0,1,0,3.3,3330,60,http://content6.flixster.com/movie/10/88/86/10888644_det.jpg
6093,The Last Unicorn,1982,last_unicorn,5.8,10,5,5,50,0,0,0,0,0,0,0,0,http://content7.flixster.com/movie/25/08/250821_det.jpg
6094,Liquid Sky,1982,liquid_sky,6.9,17,16,1,94,0,3,3,0,100,3.5,1091,67,http://content6.flixster.com/movie/27/15/271592_det.jpg
6095,Long xiao ye,1982,dragon_lord,0,4,3,1,75,0,0,0,0,0,0,0,0,http://content7.flixster.com/movie/88/00/28/8800289_det.jpg
6096,Making Love,1982,making_love,4.6,16,5,11,31,0,3,0,3,0,3.4,534,61,http://content9.flixster.com/movie/10/89/08/10890875_det.jpg
6097,Manhattan Baby,1982,manhattan_baby,0,2,0,2,0,0,0,0,0,0,0,0,0,http://content6.flixster.com/movie/10/91/08/10910888_det.jpg
6099,Megaforce,1982,megaforce,1.4,7,0,7,0,0,0,0,0,0,0,0,0,http://content6.flixster.com/movie/34/98/93/3498936_det.jpg
6100,A Midsummer Night's Sex Comedy,1982,midsummer_nights_sex_comedy,6.3,21,15,6,71,0,4,0,4,0,3.3,2757,58,http://content9.flixster.com/movie/10/88/17/10881707_det.jpg
6101,The Missing,2003,1127407-missing,6.1,168,98,70,58,6.1,39,21,18,53,3,6895,52,http://content8.flixster.com/movie/11/12/76/11127650_det.jpg
6102,The Mission,1986,1014027-mission,6.4,16,11,5,68,0,2,1,1,50,3.8,11307,83,http://content8.flixster.com/movie/10/91/81/10918186_det.jpg
6103,Monsignor,1982,monsignor,1.9,5,0,5,0,0,3,0,3,0,2.1,20,0,http://content6.flixster.com/movie/10/92/27/10922728_det.jpg
6104,Monty Python Live at the Hollywood Bowl,1982,monty_python_live_at_the_hollywood_bowl,0,2,2,0,100,0,0,0,0,0,0,0,0,http://content7.flixster.com/movie/10/93/78/10937841_det.jpg
6105,Moonlight,2007,,\N,\N,\N,\N,\N,\N,\N,\N,\N,\N,\N,\N,\N,\N
6106,Mother Lode,1982,mother_lode,0,0,0,0,0,0,0,0,0,0,0,0,0,http://content6.flixster.com/movie/10/88/52/10885284_det.jpg
6107,La notte di San Lorenzo,1982,night_of_the_shooting_stars,6.8,9,6,3,66,0,1,0,1,0,3.8,345,72,http://content8.flixster.com/movie/10/91/73/10917310_det.jpg
6108,La nuit de Varennes,1982,la_nuit_de_varennes,0,4,3,1,75,0,1,0,1,0,3.9,168,78,http://content6.flixster.com/movie/89/95/16/8995164_det.jpg
6109,One from the Heart,1982,one_from_the_heart,5.8,27,13,14,48,5.9,11,6,5,54,3.4,725,61,http://content9.flixster.com/movie/29/72/297215_det.jpg
6110,Pandemonium,1982,pandemonium,0,0,0,0,0,0,0,0,0,0,0,0,0,http://content8.flixster.com/movie/11/13/74/11137478_det.jpg
6111,Paradise,1982,1015925-paradise,0,3,0,3,0,0,0,0,0,0,0,0,0,http://content7.flixster.com/movie/83/85/92/8385921_det.jpg
6112,Partner(s),2005,partners2005,0,0,0,0,0,0,0,0,0,0,0,0,0,http://content9.flixster.com/movie/11/14/76/11147603_det.jpg
6113,Passion,1982,1082980-passion,6.2,6,4,2,66,0,1,1,0,100,3.5,398,61,http://content7.flixster.com/movie/10/88/59/10885985_det.jpg
6114,Permanent Vacation,2007,1203530-permanent_vacation,0,0,0,0,0,0,0,0,0,0,0,0,0,http://content9.flixster.com/movie/10/90/48/10904807_det.jpg
6115,Personal Best,1982,personal_best,6.4,22,16,6,72,5.5,5,2,3,40,3.3,320,58,http://content9.flixster.com/movie/31/03/43/3103435_det.jpg
6116,Pirates of the Caribbean: The Curse of the Black Pearl,2003,pirates_of_the_caribbean_the_curse_of_the_black_pearl,7.1,196,153,43,78,6.4,38,25,13,65,3.9,297546,86,http://content6.flixster.com/movie/10/87/11/10871100_det.jpg
6117,Privates on Parade,1982,privates_on_parade,0,1,0,1,0,0,0,0,0,0,0,0,0,http://content8.flixster.com/movie/94/07/13/9407130_det.jpg
6118,Przypadek,1981,blind-chance,7.6,6,5,1,83,0,0,0,0,0,0,0,0,http://content9.flixster.com/movie/93/54/82/9354823_det.jpg
6119,Le p√®re No√´l est une ordure,1982,le-pere-noel-est-une-orduresanta-claus-is-a-louse,0,0,0,0,0,0,0,0,0,0,0,0,0,http://content9.flixster.com/movie/10/09/73/10097319_det.jpg
6120,Q,1982,q,0,0,0,0,0,0,0,0,0,0,0,0,0,http://content7.flixster.com/movie/28/45/284597_det.jpg
6121,Querelle,1982,querelle,5.2,9,5,4,55,0,1,0,1,0,3.7,843,71,http://content6.flixster.com/movie/10/91/60/10916068_det.jpg
6122,Richard Pryor Live on the Sunset Strip,1982,richard_pryor_live_on_sunset_strip,8.8,13,13,0,100,0,1,1,0,100,3.7,1438,82,http://content8.flixster.com/movie/10/87/78/10877882_det.jpg
6123,Sans soleil,1983,sans_soleil,7.4,10,9,1,90,0,1,1,0,100,4.3,1016,89,http://content9.flixster.com/movie/36/02/79/3602799_det.jpg
6124,Savannah Smiles,1982,savannah_smiles,0,1,0,1,0,0,0,0,0,0,0,0,0,http://content6.flixster.com/movie/25/14/251420_det.jpg
6125,The Secret Policeman's Other Ball,1982,secret_policemans_other_ball,0,4,4,0,100,0,0,0,0,0,0,0,0,http://content9.flixster.com/movie/95/47/17/9547175_det.jpg
6126,Die Sehnsucht der Veronika Voss,1982,veronika_voss,7.4,8,6,2,75,0,3,2,1,66,4.1,643,87,http://content9.flixster.com/movie/11/14/16/11141659_det.jpg
6127,Shoot the Moon,1982,shoot_the_moon,7.8,8,8,0,100,0,1,1,0,100,3.7,260,64,http://content7.flixster.com/movie/10/87/89/10878941_det.jpg
6128,Six-Pack,2000,,\N,\N,\N,\N,\N,\N,\N,\N,\N,\N,\N,\N,\N,\N
6129,Six Weeks,1982,six_weeks,0,0,0,0,0,0,0,0,0,0,0,0,0,http://content6.flixster.com/movie/10/21/34/10213420_det.gif
6130,Soldier,1998,1083934-soldier,3.5,50,5,45,10,3.6,15,2,13,13,2.8,5503,46,http://content9.flixster.com/movie/26/95/269595_det.jpg
6131,Some Kind of Hero,1982,some_kind_of_hero,0,0,0,0,0,0,0,0,0,0,0,0,0,http://content7.flixster.com/movie/10/85/54/10855481_det.jpg
6132,Lo squartatore di New York,1982,new_york_ripper,0,4,0,4,0,0,0,0,0,0,0,0,0,http://content7.flixster.com/movie/28/94/289405_det.jpg
6133,Der Stand der Dinge,1982,state_of_things,0,4,2,2,50,0,0,0,0,0,0,0,0,http://content8.flixster.com/movie/10/87/16/10871606_det.jpg
6134,Starstruck,1982,1020035-starstruck,0,1,1,0,100,0,0,0,0,0,0,0,0,http://content9.flixster.com/movie/11/12/44/11124415_det.jpg
6135,Still of the Night,1982,still_of_the_night,5.8,6,4,2,66,0,0,0,0,0,0,0,0,http://content7.flixster.com/movie/68/63/51/6863517_det.jpg
6137,Sword of the Valiant: The Legend of Sir Gawain and the Green Knight,1984,sword_of_the_valiant,0,1,0,1,0,0,0,0,0,0,0,0,0,http://content9.flixster.com/movie/10/89/29/10892923_det.jpg
6138,Tag: The Assassination Game,1982,tag_the_assassination_game,0,1,1,0,100,0,0,0,0,0,0,0,0,http://content8.flixster.com/movie/11/14/85/11148502_det.jpg
6139,The Tempest,1979,1087280-tempest,0,4,3,1,75,0,0,0,0,0,0,0,0,http://content7.flixster.com/movie/10/87/71/10877137_det.jpg
6140,Tenebre,1982,tenebre,6.7,15,11,4,73,0,0,0,0,0,0,0,0,http://content8.flixster.com/movie/11/12/32/11123286_det.jpg
6141,My Name Is Bruce,2007,1196557-my_name_is_bruce,4.8,42,17,25,40,4.2,11,3,8,27,3.2,5111,50,http://content8.flixster.com/movie/10/92/00/10920030_det.jpg
6142,Time Walker,1982,time_walker,0,0,0,0,0,0,0,0,0,0,0,0,0,http://content7.flixster.com/movie/10/87/34/10873497_det.jpg
6143,Trail of the Pink Panther,1982,trail_of_the_pink_panther,3.8,11,3,8,27,0,0,0,0,0,0,0,0,http://content9.flixster.com/movie/10/87/22/10872251_det.jpg
6144,La traviata,1982,traviata-la,0,0,0,0,0,0,0,0,0,0,0,0,0,http://content8.flixster.com/movie/10/93/16/10931694_det.jpg
6145,Venom,2005,1151780-venom,3.1,62,6,56,9,3.5,19,3,16,15,2.6,2557,30,http://content8.flixster.com/movie/25/01/250118_det.jpg
6146,Finnegan Begin Again,1985,,\N,\N,\N,\N,\N,\N,\N,\N,\N,\N,\N,\N,\N,\N
6147,Die wei√üe Rose,1982,white_rose,0,0,0,0,0,0,0,0,0,0,0,0,0,http://content9.flixster.com/movie/10/88/94/10889431_det.jpg
6148,White Dog,1982,white_dog,7.6,10,9,1,90,0,0,0,0,0,0,0,0,http://content7.flixster.com/movie/10/48/20/10482025_det.gif
6149,Who Dares Wins,1982,1007329-final_option,0,0,0,0,0,0,0,0,0,0,0,0,0,http://content8.flixster.com/movie/10/93/73/10937358_det.jpg
6150,Wrong Is Right,1982,wrong_is_right,5.1,8,3,5,37,0,2,0,2,0,3,305,38,http://content6.flixster.com/movie/10/92/04/10920484_det.jpg
6151,Yol,1982,yol,0,1,1,0,100,0,0,0,0,0,0,0,0,http://content6.flixster.com/movie/60/56/14/6056148_det.jpg
6152,Il mondo di Yor,1983,yor_the_hunter_from_the_future,2.8,5,1,4,20,0,0,0,0,0,0,0,0,http://content8.flixster.com/movie/70/51/73/7051730_det.jpg
6153,Zapped!,1982,zapped,2,10,0,10,0,0,1,0,1,0,2.8,878,42,http://content8.flixster.com/movie/10/89/77/10897786_det.jpg
6154,Deliver Us from Eva,2003,deliver_us_from_eva,5.4,81,35,46,43,5.3,28,12,16,42,3.5,3415,78,http://content7.flixster.com/movie/27/62/276225_det.jpg
6155,How to Lose a Guy in 10 Days,2003,how_to_lose_a_guy_in_10_days,5,145,62,83,42,4.9,34,12,22,35,3.4,131729,78,http://content9.flixster.com/movie/10/91/74/10917463_det.jpg
6156,Shanghai Knights,2003,shanghai_knights,6,145,95,50,65,6.2,32,23,9,71,3.1,25826,63,http://content6.flixster.com/movie/10/89/55/10895588_det.jpg
6157,Daredevil,2003,daredevil,5.2,210,93,117,44,4.4,35,9,26,25,2.8,46864,46,http://content9.flixster.com/movie/10/93/34/10933475_det.jpg
6158,The Jungle Book 2,2003,jungle_book_2,4.4,85,16,69,18,4.1,25,4,21,16,2.9,4176,48,http://content8.flixster.com/movie/11/14/32/11143298_det.jpg
6159,All the Real Girls,2003,all_the_real_girls,6.9,110,78,32,70,6.7,29,22,7,75,3.9,2897,80,http://content8.flixster.com/movie/27/45/274526_det.jpg
6160,Amandla! A Revolution in Four Part Harmony,2002,amandla-a-revolution-in-four-part-harmony,7.1,61,50,11,81,7.6,17,15,2,88,4,313,86,http://content7.flixster.com/movie/10/90/89/10908909_det.jpg
6161,Chihwaseon,2002,chihwaseon,0,0,0,0,0,0,0,0,0,0,0,0,0,http://content9.flixster.com/movie/10/87/22/10872295_det.jpg
6162,Jerry Maguire,1996,jerry_maguire,7.4,57,48,9,84,7.5,19,17,2,89,3.3,32601,72,http://content9.flixster.com/movie/26/81/268123_det.jpg
6163,√Ä la folie... pas du tout,2002,he_loves_me_he_loves_me_not,6.8,71,52,19,73,6.9,24,18,6,75,3.8,6623,82,http://content6.flixster.com/movie/10/88/40/10884076_det.jpg
6164,Lockdown,2000,,\N,\N,\N,\N,\N,\N,\N,\N,\N,\N,\N,\N,\N,\N
6166,Dennis the Menace,1993,dennis_the_menace,3.9,22,5,17,22,4.9,7,2,5,28,2.7,11273,44,http://content7.flixster.com/movie/10/88/36/10883649_det.jpg
6167,The Stand,1994,,\N,\N,\N,\N,\N,\N,\N,\N,\N,\N,\N,\N,\N,\N
6168,10 to Midnight,1983,ten_to_midnight,0,4,1,3,25,0,0,0,0,0,0,0,0,http://content6.flixster.com/movie/27/56/275696_det.jpg
6169,The Black Stallion Returns,1983,black_stallion_returns,0,2,0,2,0,0,1,0,1,0,3.5,1102,77,http://content6.flixster.com/movie/26/25/262508_det.jpg
6170,The Black Stallion,1979,black_stallion,7.7,21,18,3,85,6,5,3,2,60,3.2,3574,76,http://content9.flixster.com/movie/25/11/251127_det.jpg
6172,A Countess from Hong Kong,1967,countess_from_hong_kong,0,4,2,2,50,0,0,0,0,0,0,0,0,http://content7.flixster.com/movie/10/63/53/10635333_det.jpg
6173,Into the West,1992,1046771-into_the_west,6.4,10,7,3,70,0,2,1,1,50,3.6,744,73,http://content7.flixster.com/movie/11/13/07/11130701_det.jpg
6174,Kinjite: Forbidden Subjects,1989,kinjite_forbidden_subjects,3.6,6,0,6,0,0,1,0,1,0,3,491,40,http://content6.flixster.com/movie/27/84/278492_det.jpg
6175,Messenger of Death,1988,messenger_of_death,0,0,0,0,0,0,0,0,0,0,0,0,0,http://content7.flixster.com/movie/11/14/35/11143521_det.jpg
6176,Mr. Majestyk,1974,mr_majestyk,6,8,6,2,75,0,0,0,0,0,0,0,0,http://content6.flixster.com/movie/26/07/260796_det.jpg
6177,Murphy's Law,1986,murphys_law,0,3,1,2,33,0,0,0,0,0,0,0,0,http://content9.flixster.com/movie/27/89/278995_det.jpg
6178,A Patch of Blue,1965,patch_of_blue,8,5,5,0,100,0,0,0,0,0,0,0,0,http://content6.flixster.com/movie/29/46/294604_det.jpg
6179,A Prayer for the Dying,1987,prayer_for_the_dying,5.3,8,5,3,62,0,1,0,1,0,3.1,695,51,http://content9.flixster.com/movie/27/48/274891_det.jpg
6180,Q,1982,q,0,0,0,0,0,0,0,0,0,0,0,0,0,http://content7.flixster.com/movie/28/45/284597_det.jpg
6181,The Red Badge of Courage,1951,red_badge_of_courage,7.6,9,8,1,88,0,0,0,0,0,0,0,0,http://content8.flixster.com/movie/10/88/23/10882366_det.jpg
6182,The Thrill of It All,1963,thrill_of_it_all,0,2,1,1,50,0,0,0,0,0,0,0,0,http://content7.flixster.com/movie/29/11/291117_det.jpg
6183,Pillow Talk,1959,pillow_talk,7.1,23,21,2,91,0,3,2,1,66,3.8,3898,85,http://content8.flixster.com/movie/28/97/289714_det.jpg
6184,The Man Who Fell to Earth,1976,man_who_fell_to_earth,7.8,22,19,3,86,6.8,5,3,2,60,3.6,3805,71,http://content8.flixster.com/movie/27/90/279098_det.jpg
6185,Dark Blue,2002,dark_blue,5.8,127,73,54,57,5.8,32,18,14,56,3.1,2377,50,http://content6.flixster.com/movie/27/65/276516_det.jpg
6186,Gods and Generals,2003,gods_and_generals,3.5,119,9,110,7,3.5,29,1,28,3,3.5,2681,67,http://content8.flixster.com/movie/10/89/49/10894934_det.jpg
6187,The Life of David Gale,2003,life_of_david_gale,4.2,153,30,123,19,4.1,36,5,31,13,3.6,17064,81,http://content7.flixster.com/movie/27/05/270593_det.jpg
6188,Old School,2003,old_school,5.6,165,99,66,60,5.4,31,16,15,51,3.7,85493,84,http://content9.flixster.com/movie/31/25/312595_det.jpg
6190,Lawless Heart,2001,lawless_heart,7.1,51,43,8,84,7.2,22,19,3,86,3.6,186,59,http://content6.flixster.com/movie/92/24/05/9224056_det.jpg
6191,The Navigators,2001,1120811-navigators,7.3,10,10,0,100,0,3,3,0,100,3.6,355,75,http://content6.flixster.com/movie/28/34/283424_det.jpg
6192,Elsker dig for evigt,2002,open_hearts,7.6,55,53,2,96,7.4,16,15,1,93,4.1,1075,88,http://content9.flixster.com/movie/50/91/95/5091955_det.jpg
6193,Poolhall Junkies,2002,poolhall_junkies,4.6,44,15,29,34,4.1,12,2,10,16,3.9,3976,87,http://content7.flixster.com/movie/10/88/97/10889797_det.jpg
6194,Till Human Voices Wake Us,2002,till_human_voices_wake_us,4.9,70,17,53,24,4.8,23,4,19,17,3.6,697,68,http://content9.flixster.com/movie/10/87/32/10873231_det.jpg
6195,Stone Reader,2002,stone_reader,7.2,64,53,11,82,7.3,22,18,4,81,3.5,316,66,http://content6.flixster.com/movie/26/53/265300_det.jpg
6196,Cradle 2 the Grave,2003,cradle_2_the_grave,4.5,118,31,87,26,4.3,24,8,16,33,3.2,15487,61,http://content8.flixster.com/movie/55/35/18/5535186_det.jpg
6197,Spider,2002,1120292-spider,7.5,126,107,19,84,7.6,34,30,4,88,3.3,4398,67,http://content7.flixster.com/movie/27/56/275625_det.jpg
6198,American Heart,1992,american_heart,6.4,8,6,2,75,0,1,1,0,100,3.4,430,61,http://content7.flixster.com/movie/28/09/280917_det.jpg
6199,Edie & Pen,1996,edie_and_pen,0,0,0,0,0,0,0,0,0,0,0,0,0,http://content9.flixster.com/movie/88/84/46/8884463_det.jpg
6200,Insignificance,1985,insignificance,6.6,8,7,1,87,0,1,1,0,100,3.7,200,70,http://content7.flixster.com/movie/73/44/54/7344549_det.jpg
6201,Lady Jane,1986,lady_jane,5.4,7,4,3,57,0,0,0,0,0,0,0,0,http://content7.flixster.com/movie/10/86/75/10867517_det.jpg
6202,Hatuna Meuheret,2001,late_marriage,7.3,64,56,8,87,8,21,21,0,100,3.7,332,74,http://content8.flixster.com/movie/29/02/290222_det.jpg
6203,Life Stinks,1991,life_stinks,3.9,15,3,12,20,0,1,1,0,100,2.9,1450,44,http://content7.flixster.com/movie/26/07/260717_det.jpg
6204,The Meteor Man,1993,meteor_man,4.3,14,4,10,28,0,3,0,3,0,2.4,857,36,http://content9.flixster.com/movie/26/31/263111_det.jpg
6205,Mr. North,1988,mr_north,5.6,7,3,4,42,0,1,0,1,0,2.8,95,29,http://content8.flixster.com/movie/10/84/79/10847906_det.jpg
6206,Dead Poets Society,1989,dead_poets_society,7.2,49,42,7,85,6.5,7,5,2,71,3.8,56733,90,http://content9.flixster.com/movie/10/58/40/10584083_det.jpg
6207,The Slaughter Rule,2002,slaughter_rule,5.9,25,17,8,68,5.6,6,4,2,66,3.1,349,44,http://content6.flixster.com/movie/11/12/35/11123548_det.jpg
6208,Teenagers from Outer Space,1959,teenagers_from_outer_space,0,4,1,3,25,0,0,0,0,0,0,0,0,http://content8.flixster.com/movie/31/15/311514_det.jpg
6209,Trouble Bound,1993,trouble_bound,0,4,1,3,25,0,0,0,0,0,0,0,0,http://content6.flixster.com/movie/28/02/280216_det.jpg
6210,WaSanGo,2001,volcano-high2003,0,0,0,0,0,0,0,0,0,0,0,0,0,http://content7.flixster.com/movie/10/93/77/10937741_det.jpg
6211,Enchanted,2007,enchanted,7.3,157,145,12,92,7.4,34,31,3,91,3.8,188655,80,http://content6.flixster.com/movie/10/87/94/10879424_det.jpg
6212,Bringing Down the House,2003,bringing_down_the_house,4.7,144,49,95,34,4.8,32,12,20,37,3.1,17625,60,http://content9.flixster.com/movie/26/09/260995_det.jpg
6213,Tears of the Sun,2003,tears_of_the_sun,5,148,50,98,33,4.8,36,13,23,36,3.4,24615,72,http://content8.flixster.com/movie/10/87/83/10878362_det.jpg
6214,Irr√©versible,2002,,0,0,0,0,0,0,0,0,0,0,0,0,0,http://images.rottentomatoescdn.com/images/defaults/poster_default.gif
6215,Laurel Canyon,2002,laurel_canyon,6.4,108,73,35,67,6.6,30,20,10,66,3.2,2829,52,http://content9.flixster.com/movie/10/88/52/10885223_det.jpg
6216,Nirgendwo in Afrika,2001,nowhere-in-africa,7.5,97,83,14,85,7.6,30,25,5,83,4,1773,88,http://content6.flixster.com/movie/10/93/76/10937636_det.jpg
6217,The Safety of Objects,2001,the-safety-of-objects,5.9,72,35,37,48,5.5,27,11,16,40,3.5,1184,68,http://content9.flixster.com/movie/10/84/57/10845771_det.jpg
6218,Bend It Like Beckham,2002,bend_it_like_beckham,7.2,147,125,22,85,6.9,32,26,6,81,3.2,49098,69,http://content9.flixster.com/movie/25/51/255127_det.jpg
6219,The Hunted,2003,1120843-hunted,4.7,143,44,99,30,4.5,34,10,24,29,3,5362,51,http://content9.flixster.com/movie/11/13/64/11136427_det.jpg
6220,Willard,2003,willard,6.2,124,80,44,64,5.7,27,15,12,55,2.9,3602,49,http://content7.flixster.com/movie/55/37/22/5537225_det.jpg
6221,Gaudi Afternoon,2001,gaudi_afternoon,4.7,17,5,12,29,3.2,6,0,6,0,3.1,152,40,http://content6.flixster.com/movie/92/89/19/9289196_det.jpg
6222,Prozac Nation,2001,prozac-nation,4.6,23,6,17,26,4.5,5,2,3,40,3.3,5783,61,http://content8.flixster.com/movie/10/91/51/10915122_det.jpg
6223,Spun,2002,spun,4.7,77,28,49,36,4.1,23,4,19,17,3.5,14251,74,http://content7.flixster.com/movie/28/62/286297_det.jpg
6224,Zir-e poost-e shahr,2001,under_the_skin_of_the_city,7,30,26,4,86,7.5,12,11,1,91,3.6,242,72,http://content6.flixster.com/movie/75/68/86/7568868_det.jpg
6225,King of Kings,1961,1011626-king_of_kings,6.2,14,11,3,78,0,4,2,2,50,3.7,879,75,http://content8.flixster.com/movie/11/13/74/11137462_det.jpg
6226,Die verlorene Ehre der Katharina Blum oder: Wie Gewalt entstehen und wohin sie f√ºhren kann,1975,die-verlorene-ehre-der-katharina-blum-oder-wie-gewalt-entstehen-und-wohin-sie-fuhren-kann,7.2,9,8,1,88,0,1,0,1,0,3.9,286,83,http://content7.flixster.com/movie/94/44/08/9444089_det.jpg
6228,The Talk of the Town,1942,talk_of_the_town,7.4,14,13,1,92,0,2,2,0,100,3.8,815,83,http://content9.flixster.com/movie/10/88/24/10882403_det.jpg
6229,Two-Lane Blacktop,1971,twolane-blacktop,7.5,25,23,2,92,7.6,5,5,0,100,3.9,1567,83,http://content8.flixster.com/movie/28/25/282522_det.jpg
6230,Bang the Drum Slowly,1973,1001634-bang_the_drum_slowly,7.4,24,21,3,87,0,3,3,0,100,3.4,1003,62,http://content9.flixster.com/movie/25/82/258207_det.jpg
6231,The Benny Goodman Story,1956,benny_goodman_story,0,2,2,0,100,0,0,0,0,0,0,0,0,http://content6.flixster.com/movie/25/16/251624_det.jpg
6232,Born Free,1966,born_free,6.6,10,9,1,90,0,0,0,0,0,0,0,0,http://content8.flixster.com/movie/10/87/20/10872014_det.jpg
6233,Born Yesterday,1950,1002930-born_yesterday,8.1,20,19,1,95,0,2,1,1,50,3.9,1132,86,http://content6.flixster.com/movie/29/39/293996_det.jpg
6234,Equus,1977,equus,6,14,9,5,64,0,0,0,0,0,0,0,0,http://content8.flixster.com/movie/27/34/273406_det.jpg
6235,Europa Europa,1990,europa_europa,7.5,14,14,0,100,0,1,1,0,100,4.1,1867,90,http://content9.flixster.com/movie/10/89/21/10892127_det.jpg
6236,Fear Strikes Out,1957,fear_strikes_out,6.3,10,7,3,70,0,0,0,0,0,0,0,0,http://content9.flixster.com/movie/19/57/55/1957551_det.jpg
6237,The Glenn Miller Story,1954,glenn_miller_story,7.3,8,7,1,87,0,0,0,0,0,0,0,0,http://content7.flixster.com/movie/11/13/76/11137637_det.jpg
6238,Green Card,1990,green_card,5.4,17,9,8,52,0,2,2,0,100,2.8,3609,45,http://content7.flixster.com/movie/25/94/259413_det.jpg
6239,Journey to the Center of the Earth,2008,10008588-journey_3d,6,148,91,57,61,6.6,31,24,7,77,3.2,38002,55,http://content8.flixster.com/movie/10/88/25/10882502_det.jpg
6240,One Good Cop,1991,one_good_cop,4.4,11,2,9,18,0,2,0,2,0,2.8,845,32,http://content7.flixster.com/movie/27/67/276793_det.jpg
6241,Pauline √† la plage,1983,pauline_at_the_beach,8.8,8,8,0,100,0,2,2,0,100,3.8,644,82,http://content6.flixster.com/movie/10/88/39/10883944_det.jpg
6242,Ringu,1998,ghost-hole,0,0,0,0,0,0,0,0,0,0,0,0,0,http://content9.flixster.com/movie/10/84/77/10847715_det.jpg
6243,Ringu 2,1999,ringu_2,3.6,14,0,14,0,4.2,5,0,5,0,3.2,2782,55,http://content7.flixster.com/movie/31/34/313401_det.jpg
6244,Salaam Bombay!,1988,salaam_bombay,7.9,12,11,1,91,0,3,3,0,100,4.1,1353,91,http://content9.flixster.com/movie/29/39/293915_det.jpg
6245,Sweet Charity,1969,sweet_charity,0,3,3,0,100,0,0,0,0,0,0,0,0,http://content8.flixster.com/movie/25/13/251394_det.jpg
6246,Talent for the Game,1991,,\N,\N,\N,\N,\N,\N,\N,\N,\N,\N,\N,\N,\N,\N
6247,Women in Love,1969,1172784-women_in_love,0,0,0,0,0,0,0,0,0,0,0,0,0,http://content7.flixster.com/movie/43/29/70/4329701_det.jpg
6248,Jap√≥n,2002,japon,7.4,25,20,5,80,8.1,8,8,0,100,3.7,545,72,http://content9.flixster.com/movie/28/48/284823_det.jpg
6249,Boat Trip,2002,boat_trip,2.6,87,6,81,6,3,22,2,20,9,2.7,8176,44,http://content7.flixster.com/movie/10/92/18/10921881_det.jpg
6250,The Dream Catcher,1999,,\N,\N,\N,\N,\N,\N,\N,\N,\N,\N,\N,\N,\N,\N
6251,Piglet's Big Movie,2003,piglets_big_movie,6.3,74,54,20,72,6,22,14,8,63,3.4,1599,66,http://content9.flixster.com/movie/11/14/06/11140647_det.jpg
6252,View from the Top,2003,view_from_the_top,3.7,122,17,105,13,3.6,30,3,27,10,2.6,4839,36,http://content7.flixster.com/movie/10/87/67/10876709_det.jpg
6254,The Awful Truth,1937,awful_truth,8,23,21,2,91,0,2,2,0,100,4,2109,88,http://content7.flixster.com/movie/29/39/293993_det.jpg
6255,For the Bible Tells Me So,2007,for_the_bible_tells_me_so,7.5,47,46,1,97,7.6,16,16,0,100,4.1,1345,89,http://content9.flixster.com/movie/10/07/33/10073351_det.jpg
6256,La casa dalle finestre che ridono,1976,house_with_laughing_windows,0,2,2,0,100,0,0,0,0,0,0,0,0,http://content8.flixster.com/movie/89/69/28/8969282_det.jpg
6257,Jag √§r nyfiken - en film i gult,1967,i_am_curious_blue,5.2,24,12,12,50,0,4,2,2,50,3.6,513,64,http://content7.flixster.com/movie/89/94/04/8994041_det.jpg
6258,Les dames du Bois de Boulogne,1945,les-dames-du-bois-de-boulogne-ladies-of-the-park,8.3,12,12,0,100,0,2,2,0,100,3.8,470,77,http://content8.flixster.com/movie/36/02/71/3602710_det.jpg
6259,Flicka,2006,flicka,5.7,76,41,35,53,5.6,24,12,12,50,3.7,22360,82,http://content8.flixster.com/movie/29/93/87/2993874_det.jpg
6260,Black Robe,1991,black_robe,7,12,11,1,91,0,1,0,1,0,3.3,1641,60,http://content6.flixster.com/movie/28/35/283504_det.jpg
6261,Wind,1992,1040484-wind,5.8,10,5,5,50,0,2,2,0,100,3.5,661,71,http://content8.flixster.com/movie/25/70/257014_det.jpg
6262,Ren xiao yao,2002,unknown_pleasures,6.6,27,17,10,62,6.2,7,5,2,71,3.5,432,67,http://content6.flixster.com/movie/30/08/300896_det.jpg
6263,Basic,2003,basic,4.5,141,30,111,21,4.8,34,8,26,23,3.2,9571,66,http://content6.flixster.com/movie/27/10/271000_det.jpg
6264,The Core,2003,core,5.3,150,63,87,42,5.3,31,14,17,45,2.7,16895,41,http://content9.flixster.com/movie/10/84/02/10840223_det.jpg
6265,Head of State,2003,head_of_state,4.8,116,35,81,30,4.8,26,7,19,26,2.8,5662,51,http://content6.flixster.com/movie/10/92/33/10923344_det.jpg
6266,What a Girl Wants,2003,what_a_girl_wants,4.8,103,35,68,33,4.5,27,6,21,22,3.2,68538,67,http://content6.flixster.com/movie/55/35/52/5535524_det.jpg
6267,Assassination Tango,2002,assassination_tango,5.6,87,42,45,48,6,29,14,15,48,2.9,572,37,http://content9.flixster.com/movie/27/22/272291_det.jpg
6268,Raising Victor Vargas,2002,raising_victor_vargas,7.9,105,101,4,96,8,31,31,0,100,3.8,1155,81,http://content6.flixster.com/movie/27/85/278504_det.jpg
6269,The Life Aquatic with Steve Zissou,2004,yves-st-laurent-his-life-and-times,6.3,14,10,4,71,5.9,9,6,3,66,3.8,65,81,http://content6.flixster.com/movie/10/91/53/10915336_det.jpg
6270,Dreams,1990,1030577-dreams,5.8,17,9,8,52,5.4,5,3,2,60,4.1,4853,87,http://content7.flixster.com/movie/10/92/06/10920649_det.jpg
6271,La nuit am√©ricaine,1973,day_for_night,8.6,22,22,0,100,0,2,2,0,100,4.1,2313,90,http://content7.flixster.com/movie/10/89/48/10894821_det.jpg
6272,Eye of God,1997,eye_of_god,6.8,12,10,2,83,0,2,2,0,100,3.9,140,82,http://content9.flixster.com/movie/94/71/80/9471803_det.jpg
6273,In a Lonely Place,1950,in_a_lonely_place,8.5,28,28,0,100,0,4,4,0,100,4,1654,87,http://content8.flixster.com/movie/10/92/30/10923098_det.jpg
6274,Physical Evidence,1989,physical_evidence,3.3,16,2,14,12,0,4,0,4,0,2.6,340,19,http://content6.flixster.com/movie/28/51/285116_det.jpg
6275,Square Dance,1987,square_dance,0,3,0,3,0,0,1,0,1,0,3.2,289,48,http://content9.flixster.com/movie/10/87/15/10871531_det.jpg
6276,Wake of the Red Witch,1948,wake_of_the_red_witch,0,2,2,0,100,0,0,0,0,0,0,0,0,http://content7.flixster.com/movie/10/87/32/10873237_det.jpg
6277,Winter Kills,1979,winter-kills,7,14,12,2,85,0,3,2,1,66,3.3,254,49,http://content7.flixster.com/movie/10/85/91/10859165_det.jpg
6278,Fellini: Je suis un grand menteur,2002,fellini-im-a-born-liar,6.6,40,29,11,72,6.4,12,8,4,66,3.3,437,59,http://content8.flixster.com/movie/27/34/273418_det.jpg
6279,The Good Thief,2002,good_thief,6.8,138,107,31,77,7,36,29,7,80,3.2,1301,58,http://content7.flixster.com/movie/27/96/279609_det.jpg
6280,A Man Apart,2003,man_apart,4,129,14,115,10,3.9,31,3,28,9,3.4,15785,68,http://content6.flixster.com/movie/27/09/270992_det.jpg
6281,Phone Booth,2002,phone_booth,6.6,184,131,53,71,6.2,35,22,13,62,3.1,27495,63,http://content9.flixster.com/movie/10/84/37/10843731_det.jpg
6282,Cet amour-l√†,2001,cet-amour-la,0,0,0,0,0,0,0,0,0,0,0,0,0,http://content6.flixster.com/movie/30/36/303696_det.jpg
6283,Cowboy Bebop: Tengoku no tobira,2001,cowboy_bebop_the_movie,6.3,69,45,24,65,6.4,19,11,8,57,3.9,8587,89,http://content8.flixster.com/movie/11/12/73/11127322_det.jpg
6284,DysFunktional Family,2003,dysfunktional_family,5.2,63,27,36,42,5.2,19,9,10,47,3.7,483,73,http://content8.flixster.com/movie/27/46/274610_det.jpg
6285,Levity,2003,levity,5.3,87,31,56,35,4.9,29,7,22,24,3,1220,44,http://content9.flixster.com/movie/27/83/278303_det.jpg
6286,Mies vailla menneisyytt√§,2002,man_without_a_past,8,92,90,2,97,8.2,29,29,0,100,4,2471,90,http://content7.flixster.com/movie/10/88/44/10884477_det.jpg
6287,Anger Management,2003,1121649-anger_management,5.1,188,81,107,43,5.1,39,18,21,46,3.3,70407,66,http://content7.flixster.com/movie/10/61/92/10619293_det.jpg
6288,Better Luck Tomorrow,2002,better_luck_tomorrow,7,95,76,19,80,6.8,32,24,8,75,3.6,1992,76,http://content9.flixster.com/movie/10/88/84/10888455_det.jpg
6289,Ghosts of the Abyss,2003,ghosts_of_the_abyss,7.1,94,76,18,80,7.1,24,21,3,87,3.3,1345,60,http://content8.flixster.com/movie/25/88/258806_det.jpg
6290,House of 1000 Corpses,2003,house_of_1000_corpses,3.3,77,13,64,16,2.6,13,0,13,0,3.2,25214,68,http://content7.flixster.com/movie/10/89/45/10894585_det.jpg
6291,Lilja 4-ever,2002,lilya_4ever,7.6,67,58,9,86,7.8,24,23,1,95,4.1,4008,90,http://content6.flixster.com/movie/61/73/00/6173004_det.jpg
6292,Marion Bridge,2002,marion_bridge,6.2,16,12,4,75,6.3,8,6,2,75,3.3,388,58,http://content6.flixster.com/movie/30/90/309016_det.jpg
6293,XX/XY,2002,xx_xy,5.3,61,27,34,44,5.3,26,12,14,46,3.1,728,44,http://content7.flixster.com/movie/10/18/39/10183941_det.jpg
6294,Bulletproof Monk,2003,bulletproof_monk,4.3,130,28,102,21,4,31,5,26,16,2.9,13789,50,http://content8.flixster.com/movie/10/88/61/10886106_det.jpg
6295,Chasing Papi,2003,chasing_papi,3.7,47,6,41,12,3.9,20,3,17,15,2.8,1064,43,http://content7.flixster.com/movie/26/38/263817_det.jpg
6296,A Mighty Wind,2003,mighty_wind,7.4,171,150,21,87,7.4,38,33,5,86,3.6,7120,81,http://content8.flixster.com/movie/10/90/73/10907326_det.jpg
6297,Holes,2003,holes,7,132,102,30,77,6.9,33,24,9,72,3.3,16191,72,http://content6.flixster.com/movie/25/62/256208_det.jpg
6298,Malibu's Most Wanted,2003,malibus_most_wanted,4.6,91,27,64,29,4.2,27,4,23,14,2.6,6955,54,http://content9.flixster.com/movie/10/90/84/10908431_det.jpg
6299,Le peuple migrateur,2001,winged_migration,8.2,126,121,5,96,8.4,36,36,0,100,4,1576,85,http://content9.flixster.com/movie/10/89/15/10891543_det.jpg
6300,Blinkende lygter,2000,flickering_lights,6.3,10,7,3,70,0,4,2,2,50,4.3,1010,92,http://content7.flixster.com/movie/10/44/18/10441837_det.jpg
6301,Straw Dogs,1971,straw_dogs,8.4,30,28,2,93,0,4,2,2,50,3.8,5295,82,http://content8.flixster.com/movie/28/26/282610_det.jpg
6302,Beginning of the End,1957,1034431-beginning_of_the_end,0,4,2,2,50,0,0,0,0,0,0,0,0,http://content7.flixster.com/movie/11/12/92/11129237_det.jpg
6303,The Andromeda Strain,2008,the-andromeda-strain2008,0,2,1,1,50,0,0,0,0,0,0,0,0,http://content6.flixster.com/movie/10/93/75/10937520_det.jpg
6304,Brainscan,1994,brainscan,4,10,2,8,20,0,2,0,2,0,3.1,1960,56,http://content8.flixster.com/movie/27/59/275998_det.jpg
6305,Fahrenheit 451,1966,1007003-fahrenheit_451,7.5,29,25,4,86,0,3,1,2,33,3.5,5957,70,http://content8.flixster.com/movie/28/97/289794_det.jpg
6306,I Am Trying to Break Your Heart,2002,i_am_trying_to_break_your_heart,6.9,59,52,7,88,6.7,20,18,2,90,4,998,88,http://content6.flixster.com/movie/10/90/21/10902152_det.jpg
6307,The Iceman Cometh,1973,1120594-iceman_cometh,6.9,8,7,1,87,6.9,5,4,1,80,3.8,322,67,http://content7.flixster.com/movie/57/04/86/5704865_det.jpg
6308,Legal Eagles,1986,legal_eagles,5.2,14,7,7,50,0,1,0,1,0,2.8,875,32,http://content7.flixster.com/movie/43/88/59/4388597_det.jpg
6309,Married to It,1991,married_to_it,4.6,10,3,7,30,0,2,0,2,0,2.9,355,33,http://content9.flixster.com/movie/28/39/283991_det.jpg
6310,Memories of Me,1988,memories_of_me,0,2,1,1,50,0,1,1,0,100,2.9,313,40,http://content6.flixster.com/movie/26/55/265596_det.jpg
6311,The Other Side of Heaven,2001,other_side_of_heaven,4.6,41,11,30,26,4,12,1,11,8,3.6,2400,74,http://content9.flixster.com/movie/10/88/23/10882343_det.jpg
6312,A Private Function,1984,private_function,0,3,3,0,100,0,0,0,0,0,0,0,0,http://content6.flixster.com/movie/10/86/16/10861640_det.jpg
6313,Sibling Rivalry,1990,1030709-sibling_rivalry,3.5,8,1,7,12,0,2,0,2,0,2.8,481,33,http://content9.flixster.com/movie/26/38/263891_det.jpg
6314,Undercover Blues,1993,undercover_blues,5,17,6,11,35,0,4,1,3,25,3,1603,56,http://content9.flixster.com/movie/25/68/256891_det.jpg
6315,Wildcats,1986,wildcats,3.9,16,2,14,12,0,3,0,3,0,3.1,1616,51,http://content9.flixster.com/movie/26/97/269795_det.jpg
6316,The Wiz,1978,wiz,4.7,19,7,12,36,0,0,0,0,0,0,0,0,http://content8.flixster.com/movie/10/84/04/10840442_det.jpg
6317,Cartouche,1962,cartouche,0,0,0,0,0,0,0,0,0,0,0,0,0,http://content9.flixster.com/movie/39/56/57/3956571_det.jpg
6318,The Marrying Man,1991,marrying_man,3.2,14,1,13,7,0,2,1,1,50,2.7,603,36,http://content8.flixster.com/movie/27/78/277830_det.jpg
6319,"Mon p√®re, ce h√©ros.",1991,mon-pere-ce-heros,0,0,0,0,0,0,0,0,0,0,0,0,0,http://content9.flixster.com/movie/10/84/02/10840299_det.jpg
6320,Scenes from a Mall,1991,scenes_from_a_mall,4.3,23,7,16,30,3.7,6,2,4,33,2.6,1017,29,http://content7.flixster.com/movie/28/03/280397_det.jpg
6321,How Stella Got Her Groove Back,1998,how_stella_got_her_groove_back,5.5,47,23,24,48,5.8,12,7,5,58,3.1,4439,72,http://content8.flixster.com/movie/10/88/71/10887130_det.jpg
6322,Confidence,2003,confidence,6.3,150,106,44,70,6.1,40,25,15,62,3.4,3860,69,http://content6.flixster.com/movie/10/09/80/10098040_det.jpg
6323,Identity,2003,identity,6.4,166,103,63,62,6.1,35,20,15,57,3.4,21479,76,http://content8.flixster.com/movie/10/64/18/10641870_det.jpg
6324,It Runs in the Family,2003,it_runs_in_the_family,4.5,95,27,68,28,4.6,29,11,18,37,2.7,901,32,http://content6.flixster.com/movie/10/88/47/10884756_det.jpg
6325,The Real Cancun,2003,real_cancun,4.2,86,30,56,34,4.4,22,8,14,36,2.2,744,28,http://content7.flixster.com/movie/11/13/45/11134549_det.jpg
6326,City of Ghosts,2002,city_of_ghosts,5.5,66,31,35,46,5.8,23,11,12,47,3.1,795,45,http://content7.flixster.com/movie/55/09/70/5509701_det.jpg
6327,A Decade Under the Influence,2003,decade_under_the_influence,6.7,30,23,7,76,6.9,12,9,3,75,3.8,1167,80,http://content6.flixster.com/movie/27/77/277720_det.jpg
6328,Dom durakov,2002,house_of_fools,5,47,18,29,38,4.9,18,7,11,38,3.8,736,79,http://content9.flixster.com/movie/27/86/278619_det.jpg
6329,Manic,2001,,\N,\N,\N,\N,\N,\N,\N,\N,\N,\N,\N,\N,\N,\N
6330,People I Know,2002,people_i_know,5.4,51,22,29,43,5.7,17,7,10,41,2.9,1615,35,http://content7.flixster.com/movie/27/61/276101_det.jpg
6331,Spellbound,1945,1019609-spellbound,7.3,30,26,4,86,0,1,1,0,100,3.8,4332,82,http://content7.flixster.com/movie/10/93/88/10938881_det.jpg
6332,The Lizzie McGuire Movie,2003,lizzie_mcguire_movie,5.4,96,38,58,39,5.7,29,16,13,55,2.7,32236,57,http://content9.flixster.com/movie/31/93/91/3193911_det.jpg
6333,X2,2003,x2_xmen_united,7.4,221,194,27,87,6.9,40,33,7,82,3.7,110058,84,http://content8.flixster.com/movie/11/13/33/11133378_det.jpg
6334,Blue Car,2002,blue_car,6.9,85,69,16,81,7.2,33,30,3,90,3.3,652,62,http://content6.flixster.com/movie/28/10/281020_det.jpg
6335,The Dancer Upstairs,2002,dancer_upstairs,6.4,112,71,41,63,6.6,35,26,9,74,3.6,1196,73,http://content6.flixster.com/movie/27/72/277216_det.jpg
6336,Gomgashtei dar Aragh,2002,marooned_in_iraq,7.6,27,25,2,92,8.1,10,10,0,100,3.9,152,81,http://content7.flixster.com/movie/10/94/53/10945341_det.jpg
6337,Owning Mahowny,2003,owning_mahowny,7,93,73,20,78,6.8,31,24,7,77,3.5,1339,71,http://content6.flixster.com/movie/27/31/273116_det.jpg
6338,Daddy Day Care,2003,daddy_day_care,4.5,124,35,89,28,4.6,34,9,25,26,3.2,35165,63,http://content6.flixster.com/movie/25/81/258196_det.jpg
6339,L'homme du train,2002,man_on_the_train,7.5,109,100,9,91,7.6,35,33,2,94,3.7,1127,79,http://content7.flixster.com/movie/10/89/39/10893905_det.jpg
6340,Only the Strong Survive,2002,only_the_strong_survive,5.9,44,27,17,61,6.1,22,15,7,68,3.3,234,51,http://content7.flixster.com/movie/10/88/53/10885393_det.jpg
6341,The Shape of Things,2003,shape_of_things,6.3,134,86,48,64,5.7,39,20,19,51,3.4,2043,64,http://content9.flixster.com/movie/11/15/07/11150743_det.jpg
6342,Road Trip,2000,1097259-road_trip,5.9,89,52,37,58,5.9,21,14,7,66,3.3,57286,68,http://content6.flixster.com/movie/55/32/86/5532868_det.jpg
6343,Washington Heights,2002,washington_heights,6.1,38,30,8,78,6,15,12,3,80,3.3,157,57,http://content9.flixster.com/movie/10/93/23/10932323_det.jpg
6344,101 Reykjav√≠k,2000,101_reykjavik,7,46,41,5,89,7.5,11,10,1,90,3.6,2003,71,http://content9.flixster.com/movie/29/99/299915_det.jpg
6345,A Chorus Line,1985,chorus_line,4.8,14,6,8,42,0,1,1,0,100,3.4,2567,64,http://content6.flixster.com/movie/25/65/256500_det.jpg
6346,Absolute Beginners,1986,absolute_beginners,5.9,7,6,1,85,0,0,0,0,0,0,0,0,http://content6.flixster.com/movie/10/93/03/10930356_det.jpg
6347,Beat Street,1984,beat_street,0,4,1,3,25,0,0,0,0,0,0,0,0,http://content7.flixster.com/movie/25/65/256593_det.jpg
6348,Breakin' 2: Electric Boogaloo,1984,electric_boogaloo_breakin_2,0,3,1,2,33,0,1,1,0,100,3.4,1507,66,http://content8.flixster.com/movie/10/86/74/10867438_det.jpg
6349,Breakin',1984,breakin,4,6,2,4,33,0,0,0,0,0,0,0,0,http://content9.flixster.com/movie/10/94/49/10944963_det.jpg
6350,Tenk√ª no shiro Rapyuta,1986,castle-in-the-sky,7.2,17,16,1,94,0,2,1,1,50,4.1,25837,89,http://content6.flixster.com/movie/10/93/73/10937384_det.jpg
6351,Hysterical Blindness,2002,hysterical_blindness,5.4,10,7,3,70,0,3,2,1,66,0,0,0,http://content8.flixster.com/movie/10/88/70/10887014_det.jpg
6352,Lambada,1990,1011825-lambada,0,0,0,0,0,0,0,0,0,0,0,0,0,http://content7.flixster.com/movie/26/30/263093_det.jpg
6353,Roadie,1980,roadie,0,4,0,4,0,0,1,0,1,0,3.2,251,55,http://content8.flixster.com/movie/10/86/90/10869034_det.jpg
6354,The Carpetbaggers,1964,carpetbaggers,5.6,6,3,3,50,0,0,0,0,0,0,0,0,http://content8.flixster.com/movie/26/28/262802_det.jpg
6355,Les Girls,1957,les_girls,0,4,4,0,100,0,0,0,0,0,0,0,0,http://content8.flixster.com/movie/10/87/82/10878294_det.jpg
6356,Gunfight at the O.K. Corral,1957,gunfight_at_the_ok_corral,6.9,11,9,2,81,0,0,0,0,0,0,0,0,http://content6.flixster.com/movie/29/35/293592_det.jpg
6357,High Society,1956,high_society,6.7,15,11,4,73,0,2,1,1,50,3.8,2979,82,http://content8.flixster.com/movie/29/15/291510_det.jpg
6358,Kiss Me Kate,1953,kiss-me-kate1953,7,10,8,2,80,0,2,1,1,50,3.6,1732,73,http://content6.flixster.com/movie/11/12/18/11121816_det.jpg
6365,The Matrix Reloaded,2003,matrix_reloaded,6.8,233,171,62,73,6.5,43,31,12,72,3.4,124014,74,http://content8.flixster.com/movie/59/86/57/5986578_det.jpg
6366,Dracula: Pages from a Virgin's Diary,2002,dracula_pages_from_a_virgins_diary,7.4,59,51,8,86,7.8,21,19,2,90,3.5,898,70,http://content9.flixster.com/movie/10/88/08/10880863_det.jpg
6367,Down with Love,2003,down_by_love,8.3,5,5,0,100,0,1,1,0,100,3.3,44,67,http://content6.flixster.com/movie/10/87/28/10872848_det.jpg
6368,Cinemania,2002,cinemania,6.8,37,32,5,86,7.3,10,9,1,90,3.3,411,59,http://content7.flixster.com/movie/30/11/301121_det.jpg
6369,Friends and Family,2001,friends_and_family,4.4,18,8,10,44,4,6,2,4,33,3.5,319,64,http://content7.flixster.com/movie/10/87/56/10875645_det.jpg
6370,L'auberge espagnole,2002,auberge_espagnol,6.5,89,68,21,76,6.7,32,27,5,84,3.9,9251,85,http://content6.flixster.com/movie/11/15/13/11151372_det.jpg
6371,Pok√©mon Heroes,2003,pokemon-heroes,3.6,37,6,31,16,3.7,14,4,10,28,3.4,3562,65,http://content9.flixster.com/movie/10/88/56/10885627_det.jpg
6373,Evan Almighty,2007,evan_almighty,4.5,190,44,146,23,4,39,3,36,7,3.2,369422,56,http://content8.flixster.com/movie/62/22/37/6222374_det.jpg
6374,The In-Laws,2003,inlaws,4.9,126,44,82,34,4.9,35,12,23,34,2.9,2546,42,http://content7.flixster.com/movie/26/40/264009_det.jpg
6375,Gigantic (A Tale of Two Johns),2002,gigantic_a_tale_of_two_johns,7.1,45,37,8,82,7,19,16,3,84,4,397,88,http://content9.flixster.com/movie/44/93/69/4493691_det.jpg
6376,Respiro,2002,respiro,6.6,84,64,20,76,6.5,26,19,7,73,3.9,757,82,http://content9.flixster.com/movie/26/20/262027_det.jpg
6377,Finding Nemo,2003,finding_nemo,8.5,198,195,3,98,8.5,40,40,0,100,3.8,252174,80,http://content6.flixster.com/movie/10/84/19/10841916_det.jpg
6378,The Italian Job,2003,italian_job,6.4,178,129,49,72,6.7,40,32,8,80,3.6,103062,79,http://content6.flixster.com/movie/10/89/11/10891136_det.jpg
6379,Wrong Turn,2003,wrong_turn,4.3,77,31,46,40,3.7,13,3,10,23,3.1,24686,63,http://content7.flixster.com/movie/10/92/04/10920473_det.jpg
6380,Capturing the Friedmans,2003,capturing_the_friedmans,8.4,146,142,4,97,8.4,39,38,1,97,3.9,2794,87,http://content8.flixster.com/movie/10/93/45/10934558_det.jpg
6382,He ni zai yi qi,2002,together,6.7,77,56,21,72,6.7,26,20,6,76,4.1,1005,88,http://content9.flixster.com/movie/10/88/85/10888527_det.jpg
6383,2 Fast 2 Furious,2003,2_fast_2_furious,4.8,155,56,99,36,4.8,33,13,20,39,3.1,176485,59,http://content9.flixster.com/movie/10/91/62/10916271_det.jpg
6384,Love the Hard Way,2001,love_the_hard_way,4.8,43,12,31,27,4.8,20,5,15,25,3.6,697,66,http://content7.flixster.com/movie/10/88/51/10885157_det.jpg
6385,Whale Rider,2002,whale_rider,7.7,143,129,14,90,7.5,35,30,5,85,3.8,9564,87,http://content8.flixster.com/movie/25/40/254098_det.jpg
6386,Nevada Smith,1966,nevada_smith,6.5,6,4,2,66,0,0,0,0,0,0,0,0,http://content8.flixster.com/movie/25/94/259498_det.jpg
6387,Zong heng si hai,1991,1068208-once_a_thief,6.5,5,3,2,60,0,0,0,0,0,0,0,0,http://content8.flixster.com/movie/11/14/07/11140726_det.jpg
6388,Regeneration,1997,regeneration_1998,0,0,0,0,0,0,0,0,0,0,0,0,0,http://content7.flixster.com/movie/19/64/23/1964233_det.jpg
6390,Silk Stockings,1957,silk_stockings,0,4,4,0,100,0,0,0,0,0,0,0,0,http://content6.flixster.com/movie/29/53/295308_det.jpg
6391,Snowball Express,1972,snowball_express,0,0,0,0,0,0,0,0,0,0,0,0,0,http://content9.flixster.com/movie/11/13/80/11138083_det.jpg
6392,A Man Called Horse,1970,man_called_horse,6.9,14,12,2,85,0,0,0,0,0,0,0,0,http://content6.flixster.com/movie/27/22/272204_det.jpg
6394,Big Jake,1971,big_jake,0,4,4,0,100,0,0,0,0,0,0,0,0,http://content7.flixster.com/movie/25/50/255017_det.jpg
6395,Movie Crazy,1932,movie_crazy,0,1,0,1,0,0,0,0,0,0,0,0,0,http://content6.flixster.com/movie/10/88/53/10885304_det.jpg
6396,Dementia 13,1963,dementia_13,5.7,17,10,7,58,0,1,0,1,0,3,1086,41,http://content8.flixster.com/movie/11/13/64/11136434_det.jpg
6397,Dr√¥le de drame ou L'√©trange aventure du Docteur Molyneux,1937,drole-de-drame,6.6,9,7,2,77,0,2,2,0,100,3.8,73,76,http://content7.flixster.com/movie/10/84/72/10847297_det.jpg
6398,Le Mans,1971,le_mans,5.8,6,3,3,50,0,0,0,0,0,0,0,0,http://content8.flixster.com/movie/25/11/251110_det.jpg
6400,Un coupable id√©al,2001,murder_on_a_sunday_morning,0,3,2,1,66,0,0,0,0,0,0,0,0,http://content6.flixster.com/movie/29/56/295624_det.jpg
6401,Rio Lobo,1970,rio_lobo,6.1,19,14,5,73,0,3,1,2,33,3.7,1553,75,http://content9.flixster.com/movie/10/90/17/10901723_det.jpg
6402,Siam Sunset,1999,siam_sunset,6,8,5,3,62,0,2,1,1,50,3.6,119,67,http://content6.flixster.com/movie/93/91/54/9391548_det.jpg
6403,The Swimmer,1968,swimmer,7.7,18,18,0,100,0,3,3,0,100,3.8,683,79,http://content8.flixster.com/movie/26/25/262530_det.jpg
6404,Lo sceicco bianco,1952,1023567-white_sheik,7.8,11,11,0,100,0,1,1,0,100,3.6,726,74,http://content9.flixster.com/movie/30/19/301911_det.jpg
6405,Treasure Island,1990,1021966-treasure_island,0,0,0,0,0,0,0,0,0,0,0,0,0,http://content9.flixster.com/movie/10/83/99/10839911_det.jpg
6406,Due occhi diabolici,1990,two_evil_eyes,5.2,9,4,5,44,0,0,0,0,0,0,0,0,http://content7.flixster.com/movie/28/01/280193_det.jpg
6407,Walk Don't Run,1966,walk_dont_run,6.4,5,4,1,80,0,0,0,0,0,0,0,0,http://content9.flixster.com/movie/29/49/294923_det.jpg
6408,Animals Are Beautiful People,1974,animals-are-beautiful-people-capricorns-beautiful-people,0,2,2,0,100,0,0,0,0,0,0,0,0,http://content9.flixster.com/movie/10/88/03/10880351_det.jpg
6409,Bend of the River,1952,bend_of_the_river,8.4,5,5,0,100,0,0,0,0,0,0,0,0,http://content9.flixster.com/movie/10/89/29/10892927_det.jpg
6410,Car Wash,1976,car_wash,6.7,21,18,3,85,0,4,4,0,100,3.2,1578,59,http://content9.flixster.com/movie/10/86/94/10869499_det.jpg
6411,Come September,1961,come_september,6.1,5,4,1,80,0,0,0,0,0,0,0,0,http://content6.flixster.com/movie/29/25/292524_det.jpg
6412,Destry Rides Again,1939,destry_rides_again,7.7,16,16,0,100,0,0,0,0,0,0,0,0,http://content6.flixster.com/movie/29/49/294920_det.jpg
6413,The Electric Horseman,1979,electric_horseman,5.6,18,11,7,61,0,3,2,1,66,3.1,713,53,http://content7.flixster.com/movie/26/54/265425_det.jpg
6414,Gay Purr-ee,1962,gay_purree,0,4,3,1,75,0,0,0,0,0,0,0,0,http://content9.flixster.com/movie/10/89/14/10891463_det.jpg
6415,Intervista,1987,intervista_1984,6.9,11,8,3,72,0,3,2,1,66,3.6,467,68,http://content7.flixster.com/movie/28/96/289625_det.jpg
6416,King Rat,1965,king_rat,0,3,3,0,100,0,0,0,0,0,0,0,0,http://content6.flixster.com/movie/10/90/12/10901276_det.jpg
6417,Live Wire,1992,1040204-live_wire,2.4,5,0,5,0,0,0,0,0,0,0,0,0,http://content8.flixster.com/movie/10/87/18/10871818_det.jpg
6419,Mr. & Mrs. Bridge,1990,mr_and_mrs_bridge,5.8,15,11,4,73,0,1,1,0,100,3.1,465,43,http://content6.flixster.com/movie/26/65/266512_det.jpg
6421,The Rare Breed,1966,1017201-rare_breed,5.1,6,2,4,33,0,0,0,0,0,0,0,0,http://content7.flixster.com/movie/29/54/295493_det.jpg
6422,Shenandoah,1965,shenandoah,0,3,3,0,100,0,0,0,0,0,0,0,0,http://content9.flixster.com/movie/29/32/293211_det.jpg
6423,Straight Talk,1992,straight_talk,5.2,9,4,5,44,0,1,0,1,0,2.9,1027,51,http://content7.flixster.com/movie/10/92/38/10923837_det.jpg
6424,Oscar,1991,1034151-oscar,3.4,15,2,13,13,0,1,0,1,0,2.8,3494,56,http://content9.flixster.com/movie/25/70/257011_det.jpg
6425,The Sixth Man,1997,sixth_man,3.8,13,3,10,23,0,4,0,4,0,3,1793,54,http://content8.flixster.com/movie/26/65/266526_det.jpg
6426,The Far Country,1954,1007101-far_country,7.8,10,10,0,100,0,0,0,0,0,0,0,0,http://content9.flixster.com/movie/29/52/295215_det.jpg
6427,The Railway Children,2000,1105025-railway_children,0,0,0,0,0,0,0,0,0,0,0,0,0,http://content9.flixster.com/movie/10/88/07/10880731_det.jpg
6428,Two Mules for Sister Sara,1970,two_mules_for_sister_sara,6.3,8,6,2,75,0,1,0,1,0,3.5,3250,69,http://content9.flixster.com/movie/25/64/256491_det.jpg
6429,Winchester '73,1950,1023739-winchester_73,8.2,16,16,0,100,0,3,3,0,100,3.8,1273,84,http://content8.flixster.com/movie/11/12/30/11123002_det.jpg
6430,Ziggy Stardust and the Spiders from Mars,1973,ziggy_stardust_and_the_spiders_from_mars_the_motion_picture,6.1,28,20,8,71,6.2,8,5,3,62,3.6,27,60,http://content6.flixster.com/movie/10/96/11/10961168_det.jpg
6431,Battle Cry,1955,battle_cry,0,3,3,0,100,0,0,0,0,0,0,0,0,http://content7.flixster.com/movie/29/44/294401_det.jpg
6432,The Courtship of Eddie's Father,1963,courtship_of_eddies_father,0,4,2,2,50,0,0,0,0,0,0,0,0,http://content6.flixster.com/movie/29/69/296920_det.jpg
6433,Chelovek s kino-apparatom,1929,chelovek-s-kino-apparatom-man-with-a-movie-camera,8.9,21,20,1,95,0,2,1,1,50,4.1,2142,88,http://content8.flixster.com/movie/30/11/301110_det.jpg
6434,"Objective, Burma!",1945,objective_burma,0,2,1,1,50,0,0,0,0,0,0,0,0,http://content6.flixster.com/movie/10/87/29/10872944_det.jpg
6435,Operation Pacific,1951,operation_pacific,0,3,1,2,33,0,0,0,0,0,0,0,0,http://content9.flixster.com/movie/29/27/292795_det.jpg
6436,This Boy's Life,1993,this_boys_life,6.3,34,26,8,76,5,10,4,6,40,3.5,5072,76,http://content7.flixster.com/movie/10/89/12/10891257_det.jpg
6437,13 Rue Madeleine,1947,13_rue_madeleine,6.2,6,5,1,83,0,0,0,0,0,0,0,0,http://content7.flixster.com/movie/29/75/297517_det.jpg
6438,633 Squadron,1964,633_squadron,0,3,2,1,66,0,0,0,0,0,0,0,0,http://content7.flixster.com/movie/29/42/294217_det.jpg
6439,Star Wars: Episode II - Attack of the Clones,2002,star_wars_episode_ii_attack_of_the_clones,6.5,215,142,73,66,5.5,40,16,24,40,3.3,108730,69,http://content7.flixster.com/movie/10/94/47/10944721_det.jpg
6440,Barton Fink,1991,barton_fink,7.6,50,45,5,90,7.6,10,9,1,90,3.9,12267,88,http://content9.flixster.com/movie/26/77/267723_det.jpg
6441,Battle of Britain,1969,battle_of_britain,5.5,8,5,3,62,0,1,0,1,0,3.8,2265,79,http://content6.flixster.com/movie/25/14/251496_det.jpg
6442,Belle epoque,1992,belle_epoque,7.5,15,14,1,93,0,3,3,0,100,3.6,1565,74,http://content9.flixster.com/movie/11/12/17/11121791_det.jpg
6443,The Big Trail,1930,big_trail,6.8,7,7,0,100,0,0,0,0,0,0,0,0,http://content8.flixster.com/movie/30/32/303294_det.jpg
6445,Cloak & Dagger,1984,1004370-cloak_and_dagger,5,5,2,3,40,0,0,0,0,0,0,0,0,http://content8.flixster.com/movie/25/49/254914_det.jpg
6446,The Comancheros,1961,comancheros,0,4,4,0,100,0,0,0,0,0,0,0,0,http://content7.flixster.com/movie/29/34/293425_det.jpg
6447,Duel at Diablo,1966,1006347-duel_at_diablo,0,3,3,0,100,0,0,0,0,0,0,0,0,http://content9.flixster.com/movie/97/89/45/9789451_det.jpg
6448,Flight of the Phoenix,2004,flight_of_the_phoenix,4.8,115,34,81,29,4.4,27,5,22,18,3,7566,48,http://content7.flixster.com/movie/10/87/00/10870025_det.jpg
6449,From the Terrace,1960,from_the_terrace,4.8,8,3,5,37,0,3,1,2,33,3.6,330,73,http://content9.flixster.com/movie/29/61/296111_det.jpg
6450,"Heaven Knows, Mr. Allison",1957,heaven_knows_mr_allison,7,7,6,1,85,0,0,0,0,0,0,0,0,http://content7.flixster.com/movie/29/40/294021_det.jpg
6451,The Hot Rock,1972,hot_rock,6,8,5,3,62,0,1,0,1,0,3.4,651,61,http://content6.flixster.com/movie/26/14/261492_det.jpg
6452,"The Long, Hot Summer",1958,1012662-long_hot_summer,7.2,15,13,2,86,0,4,2,2,50,3.8,1470,84,http://content6.flixster.com/movie/10/89/50/10895028_det.jpg
6453,Man of Aran,1934,man_of_aran,7.6,15,14,1,93,0,3,3,0,100,3.6,320,72,http://content7.flixster.com/movie/10/88/17/10881761_det.jpg
6454,Music Box,1989,1014451-music_box,6.4,14,9,5,64,0,1,0,1,0,0,0,0,http://content9.flixster.com/movie/26/25/262527_det.jpg
6455,North to Alaska,1960,north_to_alaska,4.7,6,2,4,33,0,0,0,0,0,0,0,0,http://content7.flixster.com/movie/29/23/292393_det.jpg
6456,Que la b√™te meure,1969,this_man_must_die,7.9,6,6,0,100,0,1,1,0,100,3.7,342,78,http://content9.flixster.com/movie/10/88/30/10883087_det.jpg
6457,Sink the Bismarck!,1960,sink_the_bismarck,0,4,3,1,75,0,0,0,0,0,0,0,0,http://content9.flixster.com/movie/29/14/291419_det.jpg
6458,The Blue Max,1966,blue_max,0,4,4,0,100,0,0,0,0,0,0,0,0,http://content8.flixster.com/movie/28/61/286126_det.jpg
6459,The Desert Fox: The Story of Rommel,1951,desert_fox,7,6,5,1,83,0,0,0,0,0,0,0,0,http://content7.flixster.com/movie/29/38/293825_det.jpg
6460,Le proc√®s,1962,1022001-trial,7.4,25,22,3,88,7.3,5,4,1,80,4,1771,88,http://content9.flixster.com/movie/10/91/93/10919379_det.jpg
6461,Unforgiven,1992,1041911-unforgiven,8.5,56,54,2,96,7.5,11,9,2,81,4,27203,91,http://content9.flixster.com/movie/10/93/21/10932195_det.jpg
6462,The Undefeated,1969,1022315-undefeated,0,4,1,3,25,0,1,0,1,0,3.6,1146,72,http://content9.flixster.com/movie/25/23/252311_det.jpg
6463,Divine Trash,1998,divine-trash,6.9,5,4,1,80,0,1,1,0,100,3.7,350,77,http://content8.flixster.com/movie/10/89/02/10890206_det.jpg
6464,Good Burger,1997,good_burger,4.3,26,8,18,30,4.7,9,3,6,33,2.7,7419,60,http://content7.flixster.com/movie/10/91/74/10917489_det.jpg
6465,Jubilee,1978,jubilee,0,3,3,0,100,0,0,0,0,0,0,0,0,http://content8.flixster.com/movie/31/30/313006_det.jpg
6466,Mississippi Masala,1991,mississippi_masala,6.7,19,15,4,78,0,4,4,0,100,3.4,1551,64,http://content7.flixster.com/movie/10/88/54/10885485_det.jpg
6467,Quai des Orf√®vres,1947,jenny_lamour,8.3,30,30,0,100,8.3,11,11,0,100,3.9,498,87,http://content9.flixster.com/movie/10/92/33/10923303_det.jpg
6468,A Stranger Among Us,1992,stranger_among_us,4.8,13,4,9,30,0,2,0,2,0,2.7,1243,35,http://content9.flixster.com/movie/27/44/274407_det.jpg
6469,Cahill U.S. Marshal,1973,cahill_us_marshal,0,1,0,1,0,0,0,0,0,0,0,0,0,http://content9.flixster.com/movie/10/90/45/10904515_det.jpg
6470,Chisum,1970,chisum,5.2,5,3,2,60,0,0,0,0,0,0,0,0,http://content9.flixster.com/movie/25/17/251727_det.jpg
6471,Defence of the Realm,1985,defense_of_the_realm,7.1,5,5,0,100,0,1,1,0,100,3.2,256,60,http://content9.flixster.com/movie/26/56/265619_det.jpg
6472,Eat a Bowl of Tea,1989,eat_a_bowl_of_tea,0,3,3,0,100,0,0,0,0,0,0,0,0,http://content8.flixster.com/movie/26/53/265394_det.jpg
6473,Half Moon Street,1986,half_moon_street,5.5,5,3,2,60,0,1,1,0,100,2.8,382,29,http://content8.flixster.com/movie/28/38/283818_det.jpg
6474,La tregua,1997,1083373-truce,6.1,15,8,7,53,5.9,6,3,3,50,3.6,202,63,http://content8.flixster.com/movie/27/98/279810_det.jpg
6475,Opportunity Knocks,1990,opportunity_knocks,4.5,8,2,6,25,0,1,0,1,0,2.9,523,45,http://content6.flixster.com/movie/26/29/262928_det.jpg
6476,Shattered Glass,2003,shattered_glass,7.7,163,148,15,90,7.5,37,31,6,83,3.5,4409,76,http://content6.flixster.com/movie/25/70/257024_det.jpg
6477,The Song of Bernadette,1943,song_of_bernadette,6.9,9,7,2,77,0,0,0,0,0,0,0,0,http://content7.flixster.com/movie/10/86/39/10863921_det.jpg
6478,The Life and Times of Judge Roy Bean,1972,life_and_times_of_judge_roy_bean,5.8,7,5,2,71,0,1,0,1,0,3.4,951,66,http://content9.flixster.com/movie/11/13/53/11135315_det.jpg
6479,The Spirit of '76,1990,,\N,\N,\N,\N,\N,\N,\N,\N,\N,\N,\N,\N,\N,\N
6480,Thoroughly Modern Millie,1967,thoroughly_modern_millie,7.6,9,9,0,100,0,0,0,0,0,0,0,0,http://content8.flixster.com/movie/25/10/251014_det.jpg
6481,Where the Heart Is,2000,1096832-where_the_heart_is,4.6,94,32,62,34,3.9,27,5,22,18,3.5,12595,78,http://content9.flixster.com/movie/25/56/255615_det.jpg
6482,Dumb and Dumberer: When Harry Met Lloyd,2003,dumb_and_dumberer_when_harry_met_lloyd,2.8,116,12,104,10,2.5,31,1,30,3,2.4,17380,37,http://content6.flixster.com/movie/55/35/64/5535640_det.jpg
6483,From Justin to Kelly,2003,from_justin_to_kelly,2.8,59,5,54,8,2.7,16,1,15,6,2,6715,39,http://content7.flixster.com/movie/10/92/94/10929453_det.jpg
6484,Hollywood Homicide,2003,hollywood_homicide,4.7,158,47,111,29,4.8,37,10,27,27,2.6,6121,32,http://content8.flixster.com/movie/10/84/02/10840222_det.jpg
6485,Rugrats Go Wild,2003,rugrats_go_wild,5,83,33,50,39,4.9,28,12,16,42,2.9,2842,47,http://content6.flixster.com/movie/11/13/75/11137544_det.jpg
6486,The Hard Word,2002,hard_word,5.5,82,33,49,40,5.5,26,10,16,38,3,615,45,http://content6.flixster.com/movie/10/88/51/10885176_det.jpg
6487,The Heart of Me,2002,heart_of_me,5.5,55,27,28,49,5.2,24,10,14,41,3.5,659,62,http://content9.flixster.com/movie/27/41/274123_det.jpg
6488,D√©calage horaire,2002,jet_lag,5.8,66,37,29,56,6.1,26,16,10,61,3.1,1234,49,http://content9.flixster.com/movie/27/86/278611_det.jpg
6489,"Mi Casa, Su Casa",2003,loco_love,0,4,1,3,25,0,2,1,1,50,2.7,164,33,http://content9.flixster.com/movie/26/38/263819_det.jpg
6490,Manito,2002,manito,7.3,31,29,2,93,7.8,14,14,0,100,3.5,124,65,http://content6.flixster.com/movie/30/37/303796_det.jpg
6491,Best of the Best 3: No Turning Back,1995,best_of_the_best_3_no_turning_back,0,0,0,0,0,0,0,0,0,0,0,0,0,http://content6.flixster.com/movie/11/14/40/11144072_det.jpg
6492,Oligarkh,2002,tycoon_a_new_russian,5.5,34,15,19,44,5.9,17,10,7,58,3.8,77,73,http://content9.flixster.com/movie/10/83/91/10839135_det.jpg
6493,Alex & Emma,2003,alex_and_emma,3.7,131,14,117,10,3.3,36,2,34,5,2.8,7767,42,http://content7.flixster.com/movie/10/16/22/10162241_det.jpg
6494,On_Line,2002,on_line,4.6,39,15,24,38,3.7,17,2,15,11,2.3,8,0,http://content9.flixster.com/movie/11/00/56/11005627_det.jpg
6495,Experiment in Terror,1962,experiment_in_terror,0,4,4,0,100,0,0,0,0,0,0,0,0,http://content9.flixster.com/movie/10/90/75/10907539_det.jpg
6496,√âxtasis,1996,extasis_2008,0,0,0,0,0,0,0,0,0,0,0,0,0,http://content7.flixster.com/movie/10/85/07/10850769_det.jpg
6497,Paris br√ªle-t-il?,1966,is_paris_burning,6.4,5,4,1,80,0,0,0,0,0,0,0,0,http://content6.flixster.com/movie/29/44/294428_det.jpg
6498,Murphy's War,1971,murphys_war,0,2,0,2,0,0,1,0,1,0,3.4,129,58,http://content8.flixster.com/movie/10/83/89/10838938_det.jpg
6499,Orphans of the Storm,1921,orphans_of_the_storm,0,4,3,1,75,0,0,0,0,0,0,0,0,http://content9.flixster.com/movie/10/86/16/10861619_det.jpg
6500,The Satanic Rites of Dracula,1973,count-dracula-his-vampire-bride,0,0,0,0,0,0,0,0,0,0,0,0,0,http://images.rottentomatoescdn.com/images/defaults/poster_default.gif
6502,28 Days Later...,2002,28_days_later,7.3,200,177,23,88,7.1,39,34,5,87,3.6,107149,82,http://content9.flixster.com/movie/55/37/32/5537323_det.jpg
6503,Charlie's Angels: Full Throttle,2003,charlies_angels_full_throttle,5,171,74,97,43,5,37,15,22,40,3,33126,54,http://content8.flixster.com/movie/11/13/33/11133370_det.jpg
6504,Benzina,2001,,\N,\N,\N,\N,\N,\N,\N,\N,\N,\N,\N,\N,\N,\N
6505,Ed and His Dead Mother,1993,ed_and_his_dead_mother,5.4,6,3,3,50,0,0,0,0,0,0,0,0,http://content6.flixster.com/movie/10/87/05/10870560_det.jpg
6506,Chuen jik sat sau,2001,fulltime_killer,6.2,32,18,14,56,5.8,10,5,5,50,3.7,2062,74,http://content8.flixster.com/movie/28/21/282110_det.jpg
6507,Just a Little Harmless Sex,1998,just_a_little_harmless_sex,4.4,5,1,4,20,0,0,0,0,0,0,0,0,http://content7.flixster.com/movie/11/12/77/11127781_det.jpg
6508,The Bank Job,2008,1189844-the_bank_job,6.7,137,108,29,78,7.1,31,28,3,90,3.5,60915,74,http://content7.flixster.com/movie/10/88/80/10888073_det.jpg
6509,Angst essen Seele auf,1974,fear_of_fear,9.2,16,16,0,100,0,2,2,0,100,4.1,1799,89,http://content6.flixster.com/movie/10/93/23/10932384_det.jpg
6510,"Bodies, Rest & Motion",1993,bodies_rest_and_motion,5,28,16,12,57,5.2,8,4,4,50,3,516,37,http://content7.flixster.com/movie/10/88/43/10884393_det.jpg
6511,The Blood of Jesus,1941,blood_of_jesus,0,1,1,0,100,0,0,0,0,0,0,0,0,http://content9.flixster.com/movie/10/96/51/10965127_det.jpg
6512,The Long Ships,1964,long_ships,4.7,6,3,3,50,0,0,0,0,0,0,0,0,http://content8.flixster.com/movie/29/48/294806_det.jpg
6513,Made for Each Other,1939,made_for_each_other,0,2,2,0,100,0,0,0,0,0,0,0,0,http://content7.flixster.com/movie/47/49/65/4749657_det.jpg
6514,Ring of Terror,1962,,\N,\N,\N,\N,\N,\N,\N,\N,\N,\N,\N,\N,\N,\N
6515,You Only Live Once,1937,you_only_live_once,9,5,5,0,100,0,0,0,0,0,0,0,0,http://content8.flixster.com/movie/51/06/02/5106026_det.jpg
6516,Anastasia,1997,1079818-anastasia,7.1,48,41,7,85,7.1,9,7,2,77,3.2,33076,70,http://content8.flixster.com/movie/10/93/87/10938762_det.jpg
6517,Babe,1995,1065598-babe,8.2,54,53,1,98,8.2,11,11,0,100,3,22954,54,http://content7.flixster.com/movie/25/32/253205_det.jpg
6518,Flight of the Intruder,1991,flight_of_the_intruder,4.3,11,3,8,27,0,2,0,2,0,3,858,50,http://content9.flixster.com/movie/10/87/58/10875891_det.jpg
6519,Fun with Dick and Jane,2005,fun_with_dick_and_jane,4.9,131,38,93,29,5.2,30,9,21,30,3.2,80127,58,http://content8.flixster.com/movie/31/17/311794_det.jpg
6520,Arthur! And the Square Knights of the Round Table,1966,,\N,\N,\N,\N,\N,\N,\N,\N,\N,\N,\N,\N,\N,\N
6521,The Main Event,1979,1013089-main_event,4.9,8,3,5,37,0,1,0,1,0,3,481,44,http://content7.flixster.com/movie/26/24/262417_det.jpg
6522,Man's Favorite Sport?,1964,mans_favorite_sport,6.2,15,9,6,60,0,3,1,2,33,3.5,622,71,http://content8.flixster.com/movie/29/22/292210_det.jpg
6523,Mr. Baseball,1992,mr_baseball,4.2,15,2,13,13,0,1,1,0,100,2.7,1578,36,http://content7.flixster.com/movie/10/93/32/10933213_det.jpg
6524,Pote tin Kyriaki,1960,1014832-never_on_sunday,6.8,7,6,1,85,0,0,0,0,0,0,0,0,http://content6.flixster.com/movie/29/47/294796_det.jpg
6525,Mixed Nuts,1994,mixed_nuts,2.8,28,2,26,7,2.5,6,0,6,0,2.9,2410,46,http://content9.flixster.com/movie/10/93/94/10939467_det.jpg
6526,Hachi-gatsu no ky√¥shikyoku,1991,rhapsody-in-august,5.8,8,5,3,62,5.6,5,3,2,60,3.6,1375,73,http://content8.flixster.com/movie/26/16/261602_det.jpg
6527,Scaramouche,1952,1018316-scaramouche,0,3,1,2,33,0,0,0,0,0,0,0,0,http://content7.flixster.com/movie/29/29/292909_det.jpg
6528,Start the Revolution Without Me,1970,start_the_revolution_without_me,6.6,5,4,1,80,0,0,0,0,0,0,0,0,http://content8.flixster.com/movie/10/86/47/10864718_det.jpg
6529,Strange Bedfellows,2004,strange_bedfellows,6.7,5,4,1,80,0,0,0,0,0,0,0,0,http://content9.flixster.com/movie/10/89/52/10895243_det.jpg
6530,Le locataire,1976,tenant,7.8,29,26,3,89,6.6,5,4,1,80,4,3556,87,http://content8.flixster.com/movie/10/87/07/10870718_det.jpg
6531,The Hour of the Pig,1993,advocate,5.6,8,6,2,75,0,2,2,0,100,3.3,530,54,http://content8.flixster.com/movie/27/02/270202_det.jpg
6532,Up the Sandbox,1972,up_the_sandbox,0,3,2,1,66,0,1,1,0,100,2.9,358,37,http://content6.flixster.com/movie/28/26/282696_det.jpg
6533,"What's Up, Doc?",1972,whats_up_doc,7.1,33,30,3,90,0,4,3,1,75,3.9,2794,87,http://content9.flixster.com/movie/10/91/86/10918647_det.jpg
6534,The Incredible Hulk,2008,the_incredible_hulk,6.1,210,138,72,65,5.7,38,21,17,55,3.6,124298,75,http://content6.flixster.com/movie/10/84/92/10849216_det.jpg
6535,"Legally Blonde 2: Red, White & Blonde",2003,legally_blonde_2_red_white_and_blonde,4.8,147,55,92,37,5,36,14,22,38,2.9,41399,57,http://content8.flixster.com/movie/11/13/81/11138190_det.jpg
6536,Sinbad: Legend of the Seven Seas,2003,sinbad_legend_of_the_seven_seas,5.6,119,54,65,45,5.7,32,15,17,46,3.1,9338,57,http://content8.flixster.com/movie/10/93/16/10931670_det.jpg
6537,Terminator 3: Rise of the Machines,2003,terminator_3_rise_of_the_machines,6.6,195,137,58,70,6,38,22,16,57,3.2,42333,54,http://content7.flixster.com/movie/10/94/47/10944773_det.jpg
6538,Swimming Pool,2003,swimming_pool,7.1,148,125,23,84,6.9,37,33,4,89,3.3,5988,65,http://content8.flixster.com/movie/10/88/91/10889182_det.jpg
6539,Pirates of the Caribbean: The Curse of the Black Pearl,2003,pirates_of_the_caribbean_the_curse_of_the_black_pearl,7.1,196,153,43,78,6.4,38,25,13,65,3.9,297546,86,http://content6.flixster.com/movie/10/87/11/10871100_det.jpg
6540,Madame Sat√£,2002,madame_sata,6.2,42,25,17,59,6.7,15,11,4,73,3.7,461,75,http://content6.flixster.com/movie/28/92/289200_det.jpg
6541,The League of Extraordinary Gentlemen,2003,league_of_extraordinary_gentlemen,4,174,30,144,17,3.9,37,5,32,13,3,42753,54,http://content6.flixster.com/movie/10/89/32/10893248_det.jpg
6542,Kukushka,2002,cuckoo,7,62,54,8,87,7.2,23,21,2,91,4,791,87,http://content6.flixster.com/movie/26/12/261216_det.jpg
6543,The Holy Land,2001,holy_land,5.8,54,28,26,51,5.8,19,10,9,52,3.6,173,68,http://content8.flixster.com/movie/10/88/43/10884330_det.jpg
6544,Une femme de m√©nage,2002,1120788-housekeeper,6.5,60,46,14,76,7,22,20,2,90,3,76,35,http://content8.flixster.com/movie/10/85/56/10855658_det.jpg
6545,I Capture the Castle,2003,i_capture_the_castle,6.7,81,65,16,80,6.4,27,19,8,70,3.7,1744,76,http://content6.flixster.com/movie/10/89/47/10894704_det.jpg
6546,Km. 0,2000,km0,5.6,44,24,20,54,5.6,16,8,8,50,3.6,424,72,http://content8.flixster.com/movie/27/25/272522_det.jpg
6547,Northfork,2003,northfork,5.9,99,56,43,56,5.6,32,16,16,50,3.5,992,68,http://content9.flixster.com/movie/26/09/260927_det.jpg
6548,Bad Boys II,2003,bad_boys_ii,4.1,154,36,118,23,3.8,38,6,32,15,3.6,76903,80,http://content6.flixster.com/movie/11/14/67/11146748_det.jpg
6549,How to Deal,2003,how_to_deal,4.5,92,26,66,28,4.7,32,9,23,28,3.1,6783,64,http://content8.flixster.com/movie/10/91/74/10917462_det.jpg
6550,Johnny English,2003,johnny_english,4.8,115,38,77,33,5.2,30,13,17,43,2.9,21762,54,http://content9.flixster.com/movie/10/88/86/10888659_det.jpg
6551,The Anarchist Cookbook,2002,anarchist_cookbook,4.2,18,7,11,38,3.7,6,2,4,33,3.3,718,58,http://content6.flixster.com/movie/10/50/22/10502220_det.jpg
6552,Dirty Pretty Things,2002,dirty_pretty_things,7.8,138,130,8,94,7.8,38,35,3,92,3.6,6668,79,http://content6.flixster.com/movie/10/90/62/10906244_det.jpg
6553,L'imbalsamatore,2002,1123900-embalmer,6.8,32,26,6,81,6.9,15,14,1,93,3.5,350,67,http://content6.flixster.com/movie/10/88/85/10888564_det.jpg
6554,Garage Days,2002,garage_days,5.1,52,23,29,44,4.7,17,6,11,35,3.3,1027,62,http://content9.flixster.com/movie/27/82/278211_det.jpg
6555,Cavale,2002,1125480-on_the_run,6.8,40,29,11,72,6.9,14,10,4,71,3.1,37,60,http://content9.flixster.com/movie/10/92/65/10926527_det.jpg
6556,Umi wa miteita,2002,sea_is_watching,6.1,26,15,11,57,5.6,11,5,6,45,3.6,398,72,http://content6.flixster.com/movie/27/68/276896_det.jpg
6557,Wild Hogs,2007,wild_hogs,3.8,139,20,119,14,3.4,34,3,31,8,3.4,86633,72,http://content6.flixster.com/movie/44/00/87/4400876_det.jpg
6558,Curly Sue,1991,curly_sue,3.8,11,1,10,9,0,2,1,1,50,2.8,3986,49,http://content8.flixster.com/movie/10/88/36/10883626_det.jpg
6559,Little Giants,1994,little_giants,3.9,9,3,6,33,0,1,0,1,0,3.1,9092,62,http://content7.flixster.com/movie/25/59/255997_det.jpg
6560,Loose Cannons,1990,loose_cannons,3,15,0,15,0,0,4,0,4,0,2.6,545,26,http://content7.flixster.com/movie/11/14/85/11148577_det.jpg
6561,The Mouse That Roared,1959,mouse_that_roared,7.1,18,16,2,88,0,0,0,0,0,0,0,0,http://content9.flixster.com/movie/28/65/286519_det.jpg
6562,Spencer's Mountain,1963,spencers_mountain,0,3,3,0,100,0,0,0,0,0,0,0,0,http://content7.flixster.com/movie/28/62/286209_det.jpg
6563,Masked and Anonymous,2003,masked_and_anonymous,4,77,19,58,24,3.4,28,3,25,10,3,954,46,http://content8.flixster.com/movie/26/67/266794_det.jpg
6564,Lara Croft Tomb Raider: The Cradle of Life,2003,lara_croft_tomb_raider_the_cradle_of_life,4.5,163,39,124,23,4.5,36,7,29,19,3.1,34884,60,http://content8.flixster.com/movie/10/82/13/10821386_det.jpg
6565,Seabiscuit,2003,seabiscuit-americas-legendary-racehorse,0,0,0,0,0,0,0,0,0,0,0,0,0,http://content7.flixster.com/movie/10/84/71/10847101_det.jpg
6566,Spy Kids 3-D: Game Over,2003,1127538-game_over,0,0,0,0,0,0,0,0,0,0,0,0,0,http://content7.flixster.com/movie/10/84/32/10843253_det.jpg
6567,Buffalo Soldiers,2001,buffalo-soldiers,6.6,110,79,31,71,6.3,34,23,11,67,3.4,3099,70,http://content8.flixster.com/movie/10/92/50/10925046_det.jpg
6568,Camp,2003,camp,6,100,62,38,62,6.4,27,19,8,70,3.5,3093,70,http://content7.flixster.com/movie/10/88/28/10882881_det.jpg
6569,Hotel,2001,1124189-hotel,4.5,25,9,16,36,4.6,11,4,7,36,2.6,446,34,http://content9.flixster.com/movie/10/87/04/10870491_det.jpg
6570,La hija del can√≠bal,2003,lucia_lucia,5.4,48,21,27,43,5.6,20,7,13,35,3.4,312,57,http://content8.flixster.com/movie/10/89/48/10894830_det.jpg
6571,Los lunes al sol,2002,mondays_in_the_sun,7,69,55,14,79,6.5,20,15,5,75,3.9,1360,86,http://content7.flixster.com/movie/28/10/281097_det.jpg
6572,Scorched,2003,scorched,4.6,6,1,5,16,0,1,1,0,100,3,906,43,http://content9.flixster.com/movie/26/35/263591_det.jpg
6573,Avanti!,1972,avanti,6.9,16,13,3,81,0,3,1,2,33,3.6,906,72,http://content8.flixster.com/movie/27/17/271706_det.jpg
6574,Eve of Destruction,1991,1033042-eve_of_destruction,2.8,6,0,6,0,0,0,0,0,0,0,0,0,http://content9.flixster.com/movie/28/48/284807_det.jpg
6575,Stoked: The Rise and Fall of Gator,2002,stoked_the_rise_and_fall_of_gator,6.6,47,37,10,78,6.6,19,15,4,78,3.8,199,78,http://content6.flixster.com/movie/10/89/72/10897248_det.jpg
6576,Juggernaut,1974,1011319-juggernaut,0,3,2,1,66,0,0,0,0,0,0,0,0,http://content9.flixster.com/movie/26/35/263599_det.jpg
6577,Kickboxer 2: The Road Back,1991,kickboxer_2,0,1,1,0,100,0,0,0,0,0,0,0,0,http://content9.flixster.com/movie/11/14/33/11143315_det.jpg
6578,"Kiss Me, Stupid",1964,kiss_me_stupid,6.4,20,15,5,75,6.4,6,5,1,83,3.4,784,66,http://content9.flixster.com/movie/10/86/99/10869999_det.jpg
6579,"One, Two, Three",1961,1015567-one_two_three,7.7,17,16,1,94,0,4,4,0,100,4,1286,88,http://content9.flixster.com/movie/10/91/67/10916727_det.jpg
6580,Amores Poss√≠veis,2001,possible_loves,0,2,2,0,100,0,0,0,0,0,0,0,0,http://content6.flixster.com/movie/30/49/304904_det.jpg
6581,The Private Life of Sherlock Holmes,1970,private_life_of_sherlock_holmes,7.6,21,20,1,95,7,5,4,1,80,3.5,1066,70,http://content6.flixster.com/movie/11/14/28/11142876_det.jpg
6582,Remo Williams: The Adventure Begins,1985,remo_williams_the_adventure_begins,4.6,12,6,6,50,0,0,0,0,0,0,0,0,http://content7.flixster.com/movie/25/83/258393_det.jpg
6583,The Blood of Heroes,1989,the-blood-of-heroes1990,0,1,0,1,0,0,1,0,1,0,3.6,841,72,http://content6.flixster.com/movie/10/85/50/10855064_det.jpg
6584,"What's Up, Tiger Lily?",1966,whats_up_tiger_lily,7,18,16,2,88,0,0,0,0,0,0,0,0,http://content9.flixster.com/movie/25/76/257623_det.jpg
6585,White Lightning,1973,white_lightning,6.7,5,4,1,80,0,0,0,0,0,0,0,0,http://content9.flixster.com/movie/10/91/89/10918919_det.jpg
6586,American Wedding,2003,american_wedding,5.8,149,83,66,55,5.2,33,14,19,42,3.4,73646,72,http://content7.flixster.com/movie/10/84/19/10841917_det.jpg
6587,Gigli,2003,straight-tripping,0,0,0,0,0,0,0,0,0,0,0,0,0,http://content7.flixster.com/movie/10/92/38/10923825_det.jpg
6588,And Now... Ladies and Gentlemen...,2002,and_now_ladies_and_gentlemen,5.4,72,34,38,47,5.5,26,12,14,46,3.3,642,51,http://content6.flixster.com/movie/10/89/32/10893260_det.jpg
6589,Boys Life 4: Four Play,2003,four-play,0,0,0,0,0,0,0,0,0,0,0,0,0,http://content7.flixster.com/movie/21/87/54/2187545_det.jpg
6590,I'll Be There,2003,ill_be_there,5.2,6,3,3,50,0,1,1,0,100,3.3,685,59,http://content9.flixster.com/movie/10/91/52/10915271_det.jpg
6591,The Magdalene Sisters,2002,magdalene_sisters,7.6,143,129,14,90,8.1,38,38,0,100,3.9,3422,87,http://content8.flixster.com/movie/27/05/270594_det.jpg
6592,The Secret Lives of Dentists,2002,secret_lives_of_dentists,7.2,93,79,14,84,7.3,33,29,4,87,3.2,653,54,http://content7.flixster.com/movie/10/88/77/10887717_det.jpg
6593,Freaky Friday,2003,freaky_friday,7,140,123,17,87,7,34,29,5,85,2.9,73112,60,http://content8.flixster.com/movie/55/05/69/5505698_det.jpg
6595,S.W.A.T.,2003,swat,5.4,162,77,85,47,5.3,39,15,24,38,3.1,23455,63,http://content9.flixster.com/movie/10/79/85/10798543_det.jpg
6596,Le divorce,2003,1124832-divorce,5.2,133,49,84,36,5.7,37,16,21,43,2.5,3545,25,http://content9.flixster.com/movie/10/89/11/10891123_det.jpg
6597,Shura Yukihime,2001,princess_blade,5.9,28,16,12,57,5.8,10,6,4,60,3.3,1979,55,http://content8.flixster.com/movie/10/89/44/10894430_det.jpg
6598,Step Into Liquid,2003,step_into_liquid,6.9,77,63,14,81,7.1,28,26,2,92,4.1,1308,91,http://content9.flixster.com/movie/25/39/253991_det.jpg
6599,Accattone,1961,accattone,7.6,13,13,0,100,0,3,3,0,100,4.1,471,88,http://content8.flixster.com/movie/89/15/46/8915462_det.jpg
6600,The Making of '...And God Spoke',1993,and_god_spoke,7,8,8,0,100,0,0,0,0,0,0,0,0,http://content9.flixster.com/movie/10/87/80/10878063_det.jpg
6601,Big Trouble,2002,1109942-big_trouble,5.4,110,53,57,48,4.8,31,9,22,29,2.9,3337,52,http://content9.flixster.com/movie/10/92/12/10921251_det.jpg
6602,Brain Damage,1988,,\N,\N,\N,\N,\N,\N,\N,\N,\N,\N,\N,\N,\N,\N
6603,La double vie de V√©ronique,1991,double_life_of_veronique,7.6,25,21,4,84,7.6,5,5,0,100,4.3,5676,92,http://content8.flixster.com/movie/10/94/04/10940458_det.jpg
6604,Uccellacci e uccellini,1966,hawks_and_the_sparrows,6.5,10,8,2,80,0,3,3,0,100,4.1,399,84,http://content6.flixster.com/movie/10/88/33/10883332_det.jpg
6605,The Man in the Glass Booth,1975,man_in_the_glass_booth,0,3,3,0,100,0,1,1,0,100,4,91,88,http://content6.flixster.com/movie/99/59/22/9959228_det.jpg
6607,The Red Pony,1949,red_pony,0,2,2,0,100,0,0,0,0,0,0,0,0,http://content8.flixster.com/movie/10/83/96/10839650_det.jpg
6608,Sex & the Other Man,1995,sex_and_the_other_man,0,0,0,0,0,0,0,0,0,0,0,0,0,http://content7.flixster.com/movie/10/88/69/10886969_det.jpg
6609,Il vangelo secondo Matteo,1964,gospel_according_to_st_matthew,8.4,27,25,2,92,0,4,4,0,100,4.1,1125,86,http://content9.flixster.com/movie/10/93/87/10938703_det.jpg
6610,The Honeymoon Killers,1969,honeymoon_killers,8,18,17,1,94,0,3,3,0,100,3.5,670,67,http://content7.flixster.com/movie/11/14/29/11142909_det.jpg
6611,Umberto D.,1952,umberto_d,8.9,25,24,1,96,8.9,7,7,0,100,4.3,1981,93,http://content9.flixster.com/movie/29/82/298223_det.jpg
6612,My Brother's Keeper,2002,1116004-brothers_keeper,6,5,2,3,40,0,0,0,0,0,0,0,0,http://content8.flixster.com/movie/10/88/41/10884186_det.jpg
6613,The Day of the Dolphin,1973,day_of_the_dolphin,5.4,17,9,8,52,0,3,0,3,0,3.1,307,43,http://content7.flixster.com/movie/26/19/261917_det.jpg
6614,I Love You to Death,1990,i_love_you_to_death,5.6,17,10,7,58,0,2,1,1,50,3.3,2330,60,http://content7.flixster.com/movie/10/89/31/10893117_det.jpg
6615,Freddy vs. Jason,2003,freddy_vs_jason,4.9,152,62,90,40,4.2,32,8,24,25,2.9,31156,60,http://content8.flixster.com/movie/10/93/47/10934758_det.jpg
6616,Grind,2003,1124859-grind,3.1,71,6,65,8,3,23,2,21,8,3.5,8588,79,http://content9.flixster.com/movie/48/48/25/4848255_det.jpg
6617,Open Range,2003,open_range,6.8,170,134,36,78,6.7,33,23,10,69,3.5,8881,80,http://content6.flixster.com/movie/10/93/20/10932004_det.jpg
6618,Siu lam juk kau,2001,shaolin_soccer,7.1,87,79,8,90,7.4,28,28,0,100,3.7,17693,82,http://content9.flixster.com/movie/28/57/285719_det.jpg
6619,Uptown Girls,2003,uptown_girls,3.8,108,14,94,12,3.9,30,5,25,16,3.1,32370,64,http://content8.flixster.com/movie/55/04/87/5504874_det.jpg
6620,American Splendor,2003,american_splendor,8.3,178,167,11,93,8.6,42,42,0,100,3.7,9157,85,http://content9.flixster.com/movie/10/85/16/10851667_det.jpg
6622,Carnages,2002,1124952-carnage,6.9,36,28,8,77,7.1,11,9,2,81,3.7,239,71,http://content6.flixster.com/movie/28/95/289520_det.jpg
6623,Passionada,2002,passionada,5.6,45,26,19,57,5.8,16,9,7,56,3.2,457,55,http://content6.flixster.com/movie/26/32/263208_det.jpg
6624,Agent Cody Banks,2003,agent_cody_banks,5.1,99,38,61,38,4.8,24,8,16,33,2.6,21724,41,http://content9.flixster.com/movie/26/10/261011_det.jpg
6625,Camp Nowhere,1994,camp_nowhere,3.6,10,1,9,10,0,2,1,1,50,2.8,2929,53,http://content7.flixster.com/movie/10/91/97/10919725_det.jpg
6626,The Cemetery Club,1993,cemetery_club,5.8,7,4,3,57,0,3,2,1,66,2.9,263,36,http://content7.flixster.com/movie/10/87/59/10875981_det.jpg
6627,Changing Habits,1997,changing_habits,0,2,0,2,0,0,0,0,0,0,0,0,0,http://content6.flixster.com/movie/31/10/311024_det.jpg
6628,Hot Dog... The Movie,1984,hot_dog_the_movie,0,0,0,0,0,0,0,0,0,0,0,0,0,http://content9.flixster.com/movie/27/14/271499_det.jpg
6629,House of Wax,2005,house_of_wax,4.3,148,37,111,25,4.5,30,6,24,20,2.8,39495,54,http://content9.flixster.com/movie/10/92/43/10924347_det.jpg
6630,The Inn of the Sixth Happiness,1958,inn_of_the_sixth_happiness,0,2,2,0,100,0,0,0,0,0,0,0,0,http://content9.flixster.com/movie/29/15/291519_det.jpg
6631,Man's Best Friend,1993,,\N,\N,\N,\N,\N,\N,\N,\N,\N,\N,\N,\N,\N,\N
6633,Prince of Jutland,1994,prince-of-jutland-royal-deceit,0,0,0,0,0,0,0,0,0,0,0,0,0,http://content8.flixster.com/movie/27/35/273598_det.jpg
6634,Remando al viento,1988,rowing_with_the_wind,0,1,0,1,0,0,0,0,0,0,0,0,0,http://content8.flixster.com/movie/10/89/09/10890902_det.jpg
6635,The Rachel Papers,1989,rachel_papers,0,2,1,1,50,0,0,0,0,0,0,0,0,http://content6.flixster.com/movie/27/82/278200_det.jpg
6636,The Sure Thing,1985,sure_thing,6.8,26,23,3,88,6.8,5,4,1,80,3.5,2781,75,http://content8.flixster.com/movie/20/77/15/2077150_det.jpg
6637,Thrashin',1986,thrashin,0,0,0,0,0,0,0,0,0,0,0,0,0,http://content7.flixster.com/movie/26/01/260117_det.jpg
6638,Valley Girl,1983,virginias_run,0,2,1,1,50,0,2,1,1,50,3.7,550,73,http://content9.flixster.com/movie/96/60/52/9660523_det.jpg
6639,Wait Until Dark,1967,wait_until_dark,7.8,17,16,1,94,0,0,0,0,0,0,0,0,http://content8.flixster.com/movie/29/15/291514_det.jpg
6641,Code inconnu: R√©cit incomplet de divers voyages,2000,code_unknown,6.9,37,26,11,70,7.2,9,7,2,77,3.8,1347,78,http://content7.flixster.com/movie/30/36/303693_det.jpg
6642,Showdown in Little Tokyo,1991,showdown_in_little_tokyo,4.3,6,2,4,33,0,0,0,0,0,0,0,0,http://content7.flixster.com/movie/10/87/13/10871333_det.jpg
6643,T√¥ky√¥ monogatari,1953,tokyo_story,9.6,34,34,0,100,0,3,3,0,100,4.4,3458,94,http://content9.flixster.com/movie/11/15/03/11150391_det.jpg
6644,Le rayon vert,1986,1020432-summer,7.7,12,11,1,91,0,3,3,0,100,4.1,525,84,http://content8.flixster.com/movie/10/88/70/10887078_det.jpg
6645,THX 1138,1971,thx_1138,7,56,50,6,89,6.9,10,9,1,90,3.6,7990,73,http://content7.flixster.com/movie/27/09/270993_det.jpg
6646,Beyond the Valley of the Dolls,1970,beyond_the_valley_of_the_dolls,6.1,22,15,7,68,0,3,1,2,33,0,0,0,http://content9.flixster.com/movie/10/93/41/10934191_det.jpg
6647,The Business of Fancydancing,2002,business_of_fancydancing,5.7,30,17,13,56,5.2,8,4,4,50,3.6,262,70,http://content6.flixster.com/movie/29/55/295512_det.jpg
6648,Chunhyangdyun,2000,chunhyang,7,40,34,6,85,7.5,11,11,0,100,3.6,318,71,http://content6.flixster.com/movie/27/58/275896_det.jpg
6649,Tunes of Glory,1960,tunes_of_glory,5.7,6,4,2,66,0,0,0,0,0,0,0,0,http://content6.flixster.com/movie/29/79/297912_det.jpg
6650,Kind Hearts and Coronets,1949,kind_hearts_and_coronets,8.8,26,26,0,100,0,4,4,0,100,4.3,2828,93,http://content6.flixster.com/movie/29/52/295204_det.jpg
6651,Ash Wednesday,2002,1119133-ash_wednesday,4,14,4,10,28,0,4,1,3,25,3.1,670,46,http://content6.flixster.com/movie/28/01/280192_det.jpg
6652,Joe Kidd,1972,joe_kidd,6.8,6,5,1,83,0,1,0,1,0,3.2,1890,50,http://content7.flixster.com/movie/10/87/97/10879781_det.jpg
6653,The Keep,1983,keep,4.1,9,1,8,11,0,0,0,0,0,0,0,0,http://content9.flixster.com/movie/28/10/21/2810219_det.jpg
6654,Kaitei gunkan,1963,atragon_1965,0,0,0,0,0,0,0,0,0,0,0,0,0,http://content6.flixster.com/movie/31/02/75/3102756_det.jpg
6655,Chiky√ª B√¥eigun,1957,mysterians,0,4,3,1,75,0,0,0,0,0,0,0,0,http://content7.flixster.com/movie/29/37/293721_det.jpg
6656,Attack of the Puppet People,1958,attack_of_the_puppet_people,0,1,0,1,0,0,0,0,0,0,0,0,0,http://content6.flixster.com/movie/30/17/301724_det.jpg
6657,"The Beast from 20,000 Fathoms",1953,beast_from_20000_fathoms,6.8,10,9,1,90,0,0,0,0,0,0,0,0,http://content9.flixster.com/movie/11/15/32/11153219_det.jpg
6658,Enchanted,2007,enchanted,7.3,157,145,12,92,7.4,34,31,3,91,3.8,188655,80,http://content6.flixster.com/movie/10/87/94/10879424_det.jpg
6659,Tremors,1990,tremors,7,24,21,3,87,0,1,1,0,100,3,16973,63,http://content7.flixster.com/movie/25/56/255605_det.jpg
6660,The Red Shoes,1948,1017346-red_shoes,9.1,41,40,1,97,8.2,6,6,0,100,4.2,2989,89,http://content7.flixster.com/movie/29/36/293617_det.jpg
6661,Me & Isaac Newton,1999,me_and_isaac_newton,7,9,8,1,88,0,2,2,0,100,3.2,135,40,http://content9.flixster.com/movie/30/69/306911_det.jpg
6662,The Pink Panther,2006,pink_panther,4.1,139,31,108,22,4.1,32,6,26,18,3,52976,59,http://content9.flixster.com/movie/10/87/61/10876159_det.jpg
6663,The Pink Panther Strikes Again,1976,pink_panther_strikes_again,7.1,17,14,3,82,0,1,0,1,0,3.4,5835,80,http://content6.flixster.com/movie/10/87/22/10872252_det.jpg
6664,Commando,1985,1004567-commando,6,31,22,9,70,0,3,2,1,66,3.1,18349,65,http://content6.flixster.com/movie/27/18/271824_det.jpg
6665,Dracula,1931,1006234-dracula,7.7,42,39,3,92,7.7,6,6,0,100,3.6,8598,76,http://content9.flixster.com/movie/29/22/292203_det.jpg
6666,Le charme discret de la bourgeoisie,1972,discreet_charm_of_the_bourgeoisie,8.4,38,37,1,97,7.6,10,10,0,100,4.2,3780,90,http://content9.flixster.com/movie/10/93/75/10937587_det.jpg
6667,Waco: The Rules of Engagement,1997,waco_the_rules_of_engagement,7.8,16,14,2,87,0,3,2,1,66,3.8,380,82,http://content6.flixster.com/movie/10/87/96/10879652_det.jpg
6668,Wo de fu qin mu qin,1999,1108624-road_home,7.4,79,70,9,88,7.6,23,21,2,91,4.1,2770,88,http://content9.flixster.com/movie/10/90/46/10904691_det.jpg
6669,Ikiru,1952,ikiru,8.6,30,30,0,100,8.3,9,9,0,100,4.5,5818,96,http://content9.flixster.com/movie/11/14/66/11146651_det.jpg
6670,Comic Book Villains,2002,comic_book_villains,0,4,3,1,75,0,0,0,0,0,0,0,0,http://content9.flixster.com/movie/10/93/95/10939535_det.jpg
6671,An Angel at My Table,1990,angel_at_my_table,7.6,13,12,1,92,0,2,2,0,100,4,986,87,http://content9.flixster.com/movie/10/90/70/10907047_det.jpg
6672,War Photographer,2001,war_photographer,6.9,25,20,5,80,7,9,7,2,77,4.3,673,91,http://content8.flixster.com/movie/29/30/293006_det.jpg
6673,"¬°Ay, Carmela!",1990,ay_carmela,0,2,1,1,50,0,0,0,0,0,0,0,0,http://content6.flixster.com/movie/10/84/10/10841000_det.jpg
6674,Jang Aur Aman,2001,war-and-peace-jang-aur-aman,0,0,0,0,0,0,0,0,0,0,0,0,0,http://images.rottentomatoescdn.com/images/defaults/poster_default.gif
6675,Loin,2001,loin,0,1,1,0,100,0,0,0,0,0,0,0,0,http://images.rottentomatoescdn.com/images/defaults/poster_default.gif
6676,Incident at Oglala,1992,incident-at-oglala,7.7,12,12,0,100,0,1,1,0,100,4.1,260,85,http://content8.flixster.com/movie/65/83/76/6583766_det.jpg
6678,The Handmaid's Tale,1990,handmaids_tale,4.6,12,3,9,25,0,2,0,2,0,3,1026,44,http://content8.flixster.com/movie/27/14/271426_det.jpg
6679,Revolution OS,2001,revolution-os,5.8,14,6,8,42,0,3,0,3,0,3.7,350,74,http://content9.flixster.com/movie/10/89/01/10890147_det.jpg
6680,Live Nude Girls Unite!,2000,live_nude_girls_unite,7.1,17,14,3,82,0,4,4,0,100,3.8,355,63,http://content6.flixster.com/movie/10/09/72/10097244_det.jpg
6681,All the Little Animals,1998,all_the_little_animals,5.4,21,13,8,61,5.3,6,4,2,66,3.8,1085,76,http://content6.flixster.com/movie/35/55/88/3555880_det.jpg
6682,Earth,2007,1197228-earth,7.2,88,76,12,86,7.1,23,20,3,86,3.8,80150,74,http://content7.flixster.com/movie/10/92/40/10924053_det.jpg
6683,Man on Fire,2004,man_on_fire,5.2,157,61,96,38,5.1,38,14,24,36,3.9,67139,89,http://content7.flixster.com/movie/10/87/18/10871825_det.jpg
6684,Morte a Venezia,1971,1005512-death_in_venice,7.1,15,11,4,73,0,2,0,2,0,4,1986,83,http://content9.flixster.com/movie/95/83/67/9583679_det.jpg
6685,Marci X,2003,marci_x,2.9,52,5,47,9,3.3,14,2,12,14,2.3,826,28,http://content7.flixster.com/movie/27/97/279709_det.jpg
6686,The Medallion,2003,medallion,3.9,122,22,100,18,4.3,32,9,23,28,2.7,7847,42,http://content6.flixster.com/movie/26/28/262896_det.jpg
6687,My Boss's Daughter,2003,my_bosss_daughter,2.4,66,6,60,9,2.6,15,2,13,13,2.5,6043,32,http://content6.flixster.com/movie/10/92/22/10922280_det.jpg
6688,Bab√≠ l√©to,2001,autumn_spring,7.3,37,36,1,97,7,13,12,1,92,3.7,349,81,http://content7.flixster.com/movie/10/88/81/10888129_det.jpg
6689,The Battle of Shaker Heights,2003,battle_of_shaker_heights,5.1,57,24,33,42,4.4,23,5,18,21,3.2,1504,52,http://content9.flixster.com/movie/26/56/265695_det.jpg
6690,Sin noticias de Dios,2001,dont_tempt_me,5.1,29,11,18,37,5.2,9,4,5,44,3.5,1529,66,http://content8.flixster.com/movie/38/55/86/3855862_det.jpg
6691,Ask the Dust,2006,ask_the_dust,5.1,103,37,66,35,5.5,32,16,16,50,2.8,14077,37,http://content7.flixster.com/movie/10/89/83/10898381_det.jpg
6692,Stoked: The Rise and Fall of Gator,2002,stoked_the_rise_and_fall_of_gator,6.6,47,37,10,78,6.6,19,15,4,78,3.8,199,78,http://content6.flixster.com/movie/10/89/72/10897248_det.jpg
6693,Venus Boyz,2002,venus-boyz,6.1,16,13,3,81,5.9,6,5,1,83,3.4,203,70,http://content7.flixster.com/movie/10/88/75/10887549_det.jpg
6694,Tan de repente,2002,1125073-suddenly,6.6,21,20,1,95,6.9,8,8,0,100,3.1,56,22,http://content9.flixster.com/movie/10/93/54/10935499_det.jpg
6695,Jeepers Creepers II,2003,jeepers_creepers_2,4.2,119,26,93,21,3.9,26,4,22,15,2.8,17496,53,http://content9.flixster.com/movie/10/95/36/10953695_det.jpg
6696,Bollywood/Hollywood,2002,bollywoodhollywood,5,45,18,27,40,4.6,15,4,11,26,3.2,1101,57,http://content8.flixster.com/movie/26/65/266518_det.jpg
6697,Civil Brand,2002,civil_brand,3.8,19,3,16,15,3.9,9,2,7,22,3.8,954,73,http://content6.flixster.com/movie/27/68/276812_det.jpg
6698,Nola,2003,nola,3.1,13,0,13,0,2.9,8,0,8,0,3.1,258,38,http://content9.flixster.com/movie/10/88/23/10882371_det.jpg
6699,Once Upon a Time in the Midlands,2002,once_upon_a_time_in_the_midlands,5.7,74,38,36,51,5.9,25,16,9,64,3.1,886,45,http://content7.flixster.com/movie/10/88/22/10882277_det.jpg
6700,El otro lado de la cama,2002,other_side_of_the_bed,5,41,19,22,46,5,16,8,8,50,3.5,1042,66,http://content7.flixster.com/movie/10/88/23/10882349_det.jpg
6701,Day Zero,2007,1177706-day_zero,4.1,19,4,15,21,4,7,0,7,0,3.1,1008,45,http://content8.flixster.com/movie/10/83/92/10839226_det.jpg
6702,Dickie Roberts: Former Child Star,2003,dickie_roberts_former_child_star,4.5,114,26,88,22,4.5,32,7,25,21,2.8,8342,52,http://content8.flixster.com/movie/26/21/262102_det.jpg
6703,Law & Order: Special Victims Unit,1999,,\N,\N,\N,\N,\N,\N,\N,\N,\N,\N,\N,\N,\N,\N
6704,Home Room,2002,home_room,5.5,21,11,10,52,4.6,9,2,7,22,3.7,861,79,http://content6.flixster.com/movie/10/88/83/10888384_det.jpg
6705,Party Monster,2003,party_monster,4.4,75,20,55,26,4,28,5,23,17,3.5,6775,77,http://content9.flixster.com/movie/26/92/269219_det.jpg
6706,Taking Sides,2001,sides,0,0,0,0,0,0,0,0,0,0,0,0,0,http://images.rottentomatoescdn.com/images/defaults/poster_default.gif
6707,Cabin Fever,2002,1125409-cabin_fever,5.9,134,84,50,62,5.2,31,15,16,48,2.6,15690,45,http://content8.flixster.com/movie/10/89/04/10890498_det.jpg
6708,Matchstick Men,2003,matchstick_men,7.1,180,148,32,82,6.6,38,29,9,76,3.3,14261,76,http://content7.flixster.com/movie/46/71/43/4671437_det.jpg
6709,Once Upon a Time in Mexico,2003,once_upon_a_time_in_mexico,6.3,159,108,51,67,6.3,33,22,11,66,3.2,31247,66,http://content9.flixster.com/movie/10/89/38/10893899_det.jpg
6710,Dummy,2002,1125540-dummy,6.2,32,23,9,71,5.8,10,7,3,70,3.6,2069,74,http://content9.flixster.com/movie/27/27/272719_det.jpg
6711,Lost in Translation,2003,lost_in_translation,8.4,215,203,12,94,8.5,41,40,1,97,3.6,84187,84,http://content9.flixster.com/movie/40/80/70/4080707_det.jpg
6712,Luster,2002,luster,4.6,10,5,5,50,0,3,1,2,33,2.9,329,40,http://content6.flixster.com/movie/10/88/98/10889892_det.jpg
6713,Sennen joy√ª,2001,millennium-actress,7.6,49,45,4,91,7.7,13,12,1,92,4.1,4498,87,http://content6.flixster.com/movie/10/90/41/10904120_det.jpg
6714,Chik yeung tin si,2002,so_close,6.7,37,30,7,81,6,9,5,4,55,3.9,2855,80,http://content8.flixster.com/movie/27/32/273210_det.jpg
6715,Children of the Night,1991,children_of_the_night,0,1,0,1,0,0,0,0,0,0,0,0,0,http://content7.flixster.com/movie/10/88/07/10880737_det.jpg
6716,Daisy Miller,1974,daisy_miller,6,5,4,1,80,0,0,0,0,0,0,0,0,http://content9.flixster.com/movie/10/85/64/10856411_det.jpg
6717,Erleuchtung garantiert,1999,enlightenment-guaranteed,6.6,13,8,5,61,0,3,2,1,66,3.9,316,88,http://content8.flixster.com/movie/10/89/04/10890422_det.jpg
6718,Gotcha!,1985,gotcha,4.8,9,4,5,44,0,1,0,1,0,3,845,47,http://content7.flixster.com/movie/25/78/257821_det.jpg
6719,Hard to Hold,1984,hard_to_hold,0,1,0,1,0,0,0,0,0,0,0,0,0,http://content7.flixster.com/movie/10/89/22/10892281_det.jpg
6720,Kuffs,1992,kuffs,4.5,15,4,11,26,0,1,0,1,0,2.9,2235,46,http://content7.flixster.com/movie/25/92/259213_det.jpg
6721,Wong Fei Hung,1991,once_upon_a_time_in_china,7.3,25,22,3,88,0,2,2,0,100,3.8,4888,85,http://content7.flixster.com/movie/28/52/285297_det.jpg
6722,Wong Fei Hung II: Nam yi dong ji keung,1992,once_upon_a_time_in_china_2,6.9,14,13,1,92,0,3,2,1,66,3.8,3504,82,http://content6.flixster.com/movie/28/53/285324_det.jpg
6723,Wong Fei Hung ji saam: Si wong jaang ba,1993,once_upon_a_time_in_china_3,6,8,5,3,62,0,0,0,0,0,0,0,0,http://content9.flixster.com/movie/10/88/10/10881099_det.jpg
6724,Paper Moon,1973,paper_moon,8.4,29,26,3,89,8,6,4,2,66,4,3053,91,http://content6.flixster.com/movie/10/88/37/10883792_det.jpg
6725,Sgt. Pepper's Lonely Hearts Club Band,1978,sgt-peppers-lonely-hearts-club-band,2.9,20,3,17,15,0,3,0,3,0,2.9,1491,52,http://content9.flixster.com/movie/25/58/255815_det.jpg
6726,En s√•ng f√∂r Martin,2001,song_for_martin,7.3,27,23,4,85,7,12,9,3,75,3.5,333,70,http://content7.flixster.com/movie/10/88/68/10886825_det.jpg
6727,Targets,1968,targets,7.5,24,21,3,87,6.4,5,3,2,60,3.7,829,78,http://content9.flixster.com/movie/27/90/279023_det.jpg
6728,The Ugly American,1963,ugly_american,6.1,5,4,1,80,0,0,0,0,0,0,0,0,http://content6.flixster.com/movie/30/32/303292_det.jpg
6729,The Bostonians,1984,bostonians,6.2,5,3,2,60,0,1,1,0,100,2.9,265,32,http://content7.flixster.com/movie/31/14/311409_det.jpg
6730,Convoy,1978,1004703-convoy,4.1,8,4,4,50,0,1,0,1,0,3.6,2494,73,http://content8.flixster.com/movie/25/62/256222_det.jpg
6731,Day of the Dead,1985,,6.5,27,21,6,77,0,2,1,1,50,3.5,16164,72,http://content8.flixster.com/movie/11/12/40/11124022_det.jpg
6732,"Hello, Dolly!",1969,1009483-hello_dolly,5.9,16,8,8,50,0,0,0,0,0,0,0,0,http://content9.flixster.com/movie/25/10/251007_det.jpg
6733,Je rentre √† la maison,2001,im_going_home,7.7,52,50,2,96,8.2,19,19,0,100,3.4,322,63,http://content8.flixster.com/movie/10/85/74/10857410_det.jpg
6734,Memoirs of an Invisible Man,1992,memoirs_of_an_invisible_man,4.6,25,6,19,24,0,2,0,2,0,2.6,2632,30,http://content7.flixster.com/movie/10/87/08/10870825_det.jpg
6735,La m√¥me,2007,stalags,5.8,12,6,6,50,0,4,1,3,25,3.8,33,80,http://content9.flixster.com/movie/10/84/43/10844375_det.jpg
6736,See No Evil,2006,1158185-see_no_evil,2.6,57,5,52,8,2.5,14,1,13,7,3.3,46137,61,http://content9.flixster.com/movie/31/42/314215_det.jpg
6737,Super Sucker,2002,super_sucker,4.1,14,4,10,28,0,4,1,3,25,2.9,303,42,http://content6.flixster.com/movie/27/95/279504_det.jpg
6738,Stazione Termini,1953,indiscretion_of_an_american_wife,6.2,6,4,2,66,0,0,0,0,0,0,0,0,http://content7.flixster.com/movie/73/02/21/7302213_det.jpg
6739,At War with the Army,1950,at_war_with_the_army,0,2,0,2,0,0,0,0,0,0,0,0,0,http://content8.flixster.com/movie/31/14/311406_det.jpg
6740,Bingo,1991,1036537-bingo,0,1,0,1,0,0,1,0,1,0,2.7,1322,36,http://content6.flixster.com/movie/26/49/264924_det.jpg
6741,God Told Me To,1976,god_told_me_to,6.1,7,5,2,71,0,1,0,1,0,3.3,590,57,http://content7.flixster.com/movie/10/89/62/10896289_det.jpg
6742,"I, Madman",1989,i_madman,0,4,3,1,75,0,1,1,0,100,3,387,44,http://content6.flixster.com/movie/28/13/281300_det.jpg
6743,The Jungle Book,1967,1031385-jungle_book,7.3,27,24,3,88,0,2,1,1,50,3.5,35715,70,http://content7.flixster.com/movie/25/07/250701_det.jpg
6744,Once Bitten,1985,once_bitten,3.4,10,1,9,10,0,0,0,0,0,0,0,0,http://content7.flixster.com/movie/26/09/260909_det.jpg
6745,The Shrimp on the Barbie,1990,camaron-en-eo-asador,0,0,0,0,0,0,0,0,0,0,0,0,0,http://images.rottentomatoescdn.com/images/defaults/poster_default.gif
6746,Squirm,1976,squirm,4.3,10,3,7,30,0,0,0,0,0,0,0,0,http://content9.flixster.com/movie/27/73/277391_det.jpg
6747,The Adventures of Huck Finn,1993,adventures_of_huck_finn,5.9,13,8,5,61,0,4,3,1,75,2.9,2408,47,http://content7.flixster.com/movie/25/77/257717_det.jpg
6748,The Brood,1979,brood,7,14,11,3,78,0,1,0,1,0,3.5,2752,65,http://content6.flixster.com/movie/27/35/273516_det.jpg
6749,The Prince and the Pauper,1990,the-prince-and-the-pauper-1990,0,0,0,0,0,0,0,0,0,0,0,0,0,http://content9.flixster.com/movie/11/15/30/11153003_det.jpg
6750,Anything Else,2003,anything_else,5.2,130,53,77,40,5,35,12,23,34,2.9,4837,45,http://content7.flixster.com/movie/10/22/31/10223173_det.jpg
6751,Cold Creek Manor,2003,cold_creek_manor,3.8,108,13,95,12,4.5,27,6,21,22,2.6,4032,31,http://content7.flixster.com/movie/10/86/99/10869965_det.jpg
6752,The Fighting Temptations,2003,fighting_temptations,5.4,105,44,61,41,5.8,30,17,13,56,3.2,5134,69,http://content7.flixster.com/movie/11/13/29/11132913_det.jpg
6753,Secondhand Lions,2003,secondhand_lions,6.1,132,78,54,59,5.2,31,11,20,35,3.7,13936,83,http://content9.flixster.com/movie/10/94/01/10940171_det.jpg
6754,Underworld,2003,underworld,4.7,155,47,108,30,4.4,32,5,27,15,3.6,101467,82,http://content9.flixster.com/movie/10/88/49/10884903_det.jpg
6755,BubbaHo-Tep,2002,bubba_hotep,6.8,102,80,22,78,6,27,19,8,70,3.6,14170,78,http://content7.flixster.com/movie/55/37/46/5537469_det.jpg
6756,Casa de los babys,2003,casa_de_los_babys,6,105,61,44,58,5.8,29,16,13,55,3.2,515,50,http://content7.flixster.com/movie/10/86/91/10869185_det.jpg
6757,Demonlover,2002,demonlover,5.5,75,36,39,48,6,21,14,7,66,2.9,692,43,http://content6.flixster.com/movie/10/88/88/10888844_det.jpg
6759,Doctor Sleep,2002,close-your-eyes,5.7,36,17,19,47,5.2,13,7,6,53,3,925,39,http://content9.flixster.com/movie/10/89/25/10892555_det.jpg
6760,Where in the World Is Osama Bin Laden?,2008,where_in_the_world_is_osama_bin_laden,4.9,102,38,64,37,4.6,29,9,20,31,3.3,2558,55,http://content9.flixster.com/movie/10/85/36/10853683_det.jpg
6761,Tibet: Cry of the Snow Lion,2002,tibet_cry_of_the_snow_lion,7.4,49,42,7,85,7.6,20,18,2,90,4,721,82,http://content8.flixster.com/movie/10/90/51/10905118_det.jpg
6762,Yossi & Jagger,2002,yossi_and_jagger,6.8,41,36,5,87,7.2,15,14,1,93,3.7,822,74,http://content6.flixster.com/movie/11/14/09/11140912_det.jpg
6763,Duplex,2003,duplex,5,104,38,66,36,4.8,28,9,19,32,2.9,11260,46,http://content6.flixster.com/movie/10/87/48/10874864_det.jpg
6764,The Rundown,2003,rundown,6.4,143,102,41,71,6.1,31,20,11,64,3.3,18070,72,http://content8.flixster.com/movie/10/58/45/10584506_det.jpg
6765,Under the Tuscan Sun,2003,under_the_tuscan_sun,6.2,143,87,56,60,6.3,35,21,14,60,3.4,14219,77,http://content9.flixster.com/movie/25/50/255095_det.jpg
6766,Camera Obscura,2000,camera_obscura,5,7,3,4,42,0,1,0,1,0,3,37,50,http://content9.flixster.com/movie/10/85/39/10853963_det.jpg
6768,Luther,2003,1125461-luther,5.2,61,27,34,44,5,21,9,12,42,3.7,2529,76,http://content6.flixster.com/movie/25/36/253696_det.jpg
6769,Mambo italiano,2003,mambo_italiano,4.7,72,23,49,31,5,23,8,15,34,3.3,1531,64,http://content9.flixster.com/movie/10/91/63/10916359_det.jpg
6770,My Life Without Me,2003,love-my-life,0,0,0,0,0,0,0,0,0,0,0,0,0,http://content8.flixster.com/movie/10/84/10/10841046_det.jpg
6771,Dorm Daze 2,2006,national-lampoons-dorm-daze-2,0,0,0,0,0,0,0,0,0,0,0,0,0,http://content9.flixster.com/movie/25/74/80/2574803_det.jpg
6772,√ätre et avoir,2002,to_be_and_to_have,8.1,58,56,2,96,8.1,21,20,1,95,4.1,1542,89,http://content6.flixster.com/movie/10/89/22/10892280_det.jpg
6773,Les triplettes de Belleville,2003,acid-drinkers-15-screwed-years2004,0,0,0,0,0,0,0,0,0,0,0,0,0,http://content8.flixster.com/movie/10/85/10/10851046_det.jpg
6774,Videodrome,1983,videodrome,7.1,44,35,9,79,0,3,3,0,100,3.6,9415,79,http://content6.flixster.com/movie/10/04/07/10040772_det.jpg
6775,Life and Debt,2001,life_and_debt,7.3,42,38,4,90,7.6,12,12,0,100,4.1,552,90,http://content6.flixster.com/movie/11/14/65/11146556_det.jpg
6776,Lagaan: Once Upon a Time in India,2001,lagaan,7.9,59,56,3,94,7.9,19,19,0,100,4.2,4800,90,http://content6.flixster.com/movie/10/87/07/10870712_det.jpg
6777,Judgment at Nuremberg,1961,judgment_at_nuremburg,7.7,19,17,2,89,0,2,1,1,50,4,2099,90,http://content8.flixster.com/movie/10/41/75/10417594_det.jpg
6778,Reise der Hoffnung,1990,1036156-journey_of_hope,6.4,5,4,1,80,0,2,1,1,50,4.2,163,87,http://content6.flixster.com/movie/54/11/51/5411512_det.jpg
6779,"Same Time, Next Year",1978,same_time_next_year,4.5,5,2,3,40,0,0,0,0,0,0,0,0,http://content7.flixster.com/movie/25/43/254301_det.jpg
6780,A Brief History of Time,1991,brief_history_of_time,7.3,12,11,1,91,0,2,1,1,50,3.9,305,86,http://content9.flixster.com/movie/10/91/79/10917979_det.jpg
6781,"Jakob, der L√ºgner",1975,jacob_the_liar,6.3,5,5,0,100,0,0,0,0,0,0,0,0,http://content9.flixster.com/movie/10/53/56/10535615_det.jpg
6782,Leningrad Cowboys Go America,1989,leningrad_cowboys_go_america,7.5,5,5,0,100,0,0,0,0,0,0,0,0,http://content9.flixster.com/movie/11/14/84/11148443_det.jpg
6783,La r√®gle du jeu,1939,1017971-rules_of_the_game,9.1,37,36,1,97,9,10,10,0,100,4.3,2952,91,http://content8.flixster.com/movie/31/13/311306_det.jpg
6784,The Song Remains the Same,1976,song_remains_the_same,6.6,11,8,3,72,0,0,0,0,0,0,0,0,http://content8.flixster.com/movie/10/92/34/10923410_det.jpg
6785,Seven Brides for Seven Brothers,1954,seven_brides_for_seven_brothers,7.5,18,15,3,83,0,0,0,0,0,0,0,0,http://content7.flixster.com/movie/10/87/80/10878085_det.jpg
6786,Kiss of the Spider Woman,1985,kiss_of_the_spider_woman,7.5,24,21,3,87,0,3,3,0,100,3.6,2040,78,http://content6.flixster.com/movie/10/93/46/10934664_det.jpg
6787,All the President's Men,1976,all_the_presidents_men,9,40,40,0,100,0,3,3,0,100,3.9,11562,89,http://content8.flixster.com/movie/10/85/76/10857662_det.jpg
6788,Angie,1994,angie,5.2,15,6,9,40,0,3,1,2,33,2.7,642,31,http://content8.flixster.com/movie/28/44/284418_det.jpg
6789,L'appartement,1996,appartement,0,2,2,0,100,0,0,0,0,0,0,0,0,http://content7.flixster.com/movie/11/15/13/11151373_det.jpg
6790,The Mists of Avalon,2001,mists_of_avalon,5.6,7,3,4,42,0,1,1,0,100,3.7,4639,74,http://content9.flixster.com/movie/10/93/48/10934803_det.jpg
6791,Babettes g√¶stebud,1987,babettes_feast,8.6,14,13,1,92,0,1,0,1,0,4.2,3211,90,http://content6.flixster.com/movie/10/87/63/10876392_det.jpg
6792,Sibirskiy tsiryulnik,1998,barber_of_siberia,0,3,0,3,0,0,0,0,0,0,0,0,0,http://content6.flixster.com/movie/88/71/66/8871668_det.jpg
6793,Beethoven,1992,1038726-beethoven,4.8,23,7,16,30,6.1,5,4,1,80,2.8,16534,41,http://content9.flixster.com/movie/96/89/51/9689511_det.jpg
6794,Beethoven's 2nd,1993,beethovens_2nd,4.4,10,2,8,20,0,2,0,2,0,2.6,7881,35,http://content7.flixster.com/movie/10/85/38/10853881_det.jpg
6795,Black Moon Rising,1986,black_moon_rising,3.9,9,3,6,33,0,2,1,1,50,2.8,1020,32,http://content9.flixster.com/movie/28/05/280515_det.jpg
6796,Boyz n the Hood,1991,boyz_n_the_hood,8.3,45,44,1,97,7.7,9,9,0,100,3.7,22104,88,http://content9.flixster.com/movie/10/93/45/10934591_det.jpg
6797,Bugsy,1991,bugsy,7,32,29,3,90,0,2,2,0,100,3.2,1987,62,http://content8.flixster.com/movie/27/22/272202_det.jpg
6798,Bugsy Malone,1976,bugsy_malone,6.4,16,12,4,75,0,1,1,0,100,3.5,3796,76,http://content8.flixster.com/movie/31/21/312110_det.jpg
6799,By the Sword,1991,by_the_sword,0,2,0,2,0,0,1,0,1,0,3.6,301,69,http://content6.flixster.com/movie/28/97/63/2897632_det.jpg
6800,Cobra,1986,1004407-cobra,2.5,14,1,13,7,0,3,1,2,33,2.7,5821,43,http://content7.flixster.com/movie/27/54/275401_det.jpg
6801,La comunidad,2000,comunidad,0,3,3,0,100,0,0,0,0,0,0,0,0,http://content9.flixster.com/movie/95/54/955459_det.jpg
6802,Consenting Adults,1992,1040755-consenting_adults,4.2,10,3,7,30,0,1,0,1,0,2.8,822,29,http://content7.flixster.com/movie/27/94/279425_det.jpg
6803,Phenomenon,1996,phenomenon,5.9,32,16,16,50,5.5,6,1,5,16,3,9166,62,http://content9.flixster.com/movie/25/58/255899_det.jpg
6804,Crimewave,1985,,\N,\N,\N,\N,\N,\N,\N,\N,\N,\N,\N,\N,\N,\N
6805,Crying Freeman,1995,crying_freeman,0,1,1,0,100,0,0,0,0,0,0,0,0,http://content8.flixster.com/movie/11/14/24/11142462_det.jpg
6806,Shun liu Ni liu,2000,1108520-1108520-time_and_tide,6.1,43,27,16,62,6.4,15,10,5,66,3.6,915,71,http://content6.flixster.com/movie/28/01/280100_det.jpg
6807,The Meaning of Life,1983,monty_pythons_the_meaning_of_life,7.5,26,23,3,88,0,0,0,0,0,0,0,0,http://content9.flixster.com/movie/10/94/54/10945435_det.jpg
6808,Where Eagles Dare,1968,where_eagles_dare,6.5,17,15,2,88,0,3,2,1,66,3.8,5588,85,http://content8.flixster.com/movie/10/92/60/10926050_det.jpg
6809,Tightrope,1984,tightrope,6.8,11,9,2,81,0,1,1,0,100,3.1,1687,46,http://content8.flixster.com/movie/27/33/273326_det.jpg
6810,Sleeping with the Enemy,1991,sleeping_with_the_enemy,4.4,31,7,24,22,3.8,7,1,6,14,3.2,11187,67,http://content8.flixster.com/movie/10/92/07/10920710_det.jpg
6811,PCU,1994,pcu,5.2,15,7,8,46,0,2,0,2,0,3.5,3192,73,http://content6.flixster.com/movie/25/69/256900_det.jpg
6812,The Rookie,2002,1112954-rookie,7.2,140,115,25,82,7.4,32,29,3,90,3.3,10597,68,http://content7.flixster.com/movie/25/13/251397_det.jpg
6813,The Ghost and Mr. Chicken,1966,ghost_and_mr_chicken,6.2,6,4,2,66,0,0,0,0,0,0,0,0,http://content7.flixster.com/movie/10/86/94/10869441_det.jpg
6814,City Heat,1984,city_heat,3.8,13,3,10,23,0,4,1,3,25,2.8,1089,30,http://content8.flixster.com/movie/26/19/261998_det.jpg
6815,30 Days of Night,2007,30_days_of_night,5.5,150,73,77,48,5.1,28,13,15,46,3.3,146766,57,http://content7.flixster.com/movie/10/18/32/10183253_det.jpg
6816,Three O'Clock High,1987,three_oclock_high,5.6,8,5,3,62,0,1,0,1,0,3.4,1098,70,http://content8.flixster.com/movie/25/72/257206_det.jpg
6817,White Hunter Black Heart,1990,white_hunter_black_heart,7,32,28,4,87,6.6,8,6,2,75,3.2,1489,54,http://content7.flixster.com/movie/26/35/263505_det.jpg
6818,Idi i smotri,1985,1036052-come_and_see,8,20,19,1,95,0,4,3,1,75,4.5,2288,96,http://content8.flixster.com/movie/30/95/309526_det.jpg
6819,A Rage in Harlem,1991,rage_in_harlem,6.7,11,9,2,81,0,2,1,1,50,3.2,878,54,http://content9.flixster.com/movie/27/55/275511_det.jpg
6820,Ginger Snaps,2000,ginger_snaps,7.4,46,41,5,89,7.1,8,7,1,87,3.4,8664,76,http://content9.flixster.com/movie/10/87/99/10879955_det.jpg
6821,More American Graffiti,1979,more_american_graffiti,4.2,9,2,7,22,0,0,0,0,0,0,0,0,http://content7.flixster.com/movie/10/93/41/10934173_det.jpg
6822,The Ballad of Little Jo,1993,ballad_of_little_jo,5.8,8,6,2,75,0,2,2,0,100,3.1,555,50,http://content7.flixster.com/movie/10/86/73/10867305_det.gif
6823,Under Suspicion,2000,1100197-under_suspicion,5.3,44,22,22,50,5.2,12,6,6,50,3.2,1858,49,http://content9.flixster.com/movie/27/62/276215_det.jpg
6824,Tais-toi!,2003,taistoi,0,1,1,0,100,0,0,0,0,0,0,0,0,http://content7.flixster.com/movie/25/74/36/2574365_det.jpg
6825,The Reluctant Astronaut,1967,reluctant_astronaut,0,0,0,0,0,0,0,0,0,0,0,0,0,http://content9.flixster.com/movie/65/83/95/6583959_det.jpg
6826,The Shakiest Gun in the West,1968,shakiest_gun_in_the_west,0,0,0,0,0,0,0,0,0,0,0,0,0,http://content6.flixster.com/movie/10/89/13/10891304_det.jpg
6827,It's Pat,1994,,2.3,11,0,11,0,0,2,0,2,0,2,1188,24,http://content8.flixster.com/movie/10/92/94/10929458_det.jpg
6828,Un dimanche √† la campagne,1984,sunday_in_the_country,8.4,6,6,0,100,0,1,1,0,100,3.5,302,71,http://content7.flixster.com/movie/10/86/75/10867549_det.jpg
6829,The Gun in Betty Lou's Handbag,1992,gun_in_betty_lous_handbag,3.6,11,1,10,9,0,0,0,0,0,0,0,0,http://content7.flixster.com/movie/26/46/264613_det.jpg
6830,Sudden Fear,1952,sudden_fear,6.8,5,5,0,100,0,0,0,0,0,0,0,0,http://content7.flixster.com/movie/30/00/300017_det.jpg
6831,Nobody's Baby,2001,nobodys_baby,4,5,0,5,0,0,0,0,0,0,0,0,0,http://content6.flixster.com/movie/83/86/16/8386168_det.jpg
6832,Regarding Henry,1991,regarding_henry,5.1,25,12,13,48,0,2,0,2,0,3.3,3801,64,http://content7.flixster.com/movie/25/66/256613_det.jpg
6833,The Debut,2000,the-debut2000,0,0,0,0,0,0,0,0,0,0,0,0,0,http://content6.flixster.com/movie/10/84/73/10847308_det.jpg
6834,Wilder Napalm,1993,wilder_napalm,3.6,7,2,5,28,0,1,0,1,0,3,367,42,http://content9.flixster.com/movie/21/89/45/2189451_det.jpg
6835,Contamination,1980,contamination,0,2,0,2,0,0,0,0,0,0,0,0,0,http://content9.flixster.com/movie/10/91/71/10917187_det.jpg
6836,The Amazing Transparent Man,1960,amazing_transparent_man,5,5,2,3,40,0,0,0,0,0,0,0,0,http://content6.flixster.com/movie/10/85/43/10854368_det.jpg
6837,Love Affair,1994,1056341-love_affair,4.8,26,8,18,30,0,3,1,2,33,3.5,1260,71,http://content8.flixster.com/movie/25/75/257510_det.jpg
6839,Try Seventeen,2002,all_i_want,3.5,7,0,7,0,0,0,0,0,0,0,0,0,http://content7.flixster.com/movie/10/88/39/10883993_det.jpg
6840,Kingdom Hospital,2004,,\N,\N,\N,\N,\N,\N,\N,\N,\N,\N,\N,\N,\N,\N
6841,Article 99,1992,article_99,5.4,12,6,6,50,0,2,0,2,0,3.2,709,53,http://content6.flixster.com/movie/10/86/87/10868724_det.jpg
6842,Picture This,2008,picture_this,0,0,0,0,0,0,0,0,0,0,0,0,0,http://content8.flixster.com/movie/10/85/17/10851706_det.jpg
6843,Eureka,2006,,\N,\N,\N,\N,\N,\N,\N,\N,\N,\N,\N,\N,\N,\N
6844,Oleanna,1994,oleanna,5.8,16,9,7,56,0,2,1,1,50,3.3,398,59,http://content7.flixster.com/movie/29/54/295425_det.jpg
6845,Chattahoochee,1989,chattahoochee,4.9,5,1,4,20,0,2,0,2,0,3.3,468,54,http://content8.flixster.com/movie/28/11/281110_det.jpg
6846,Tough Guys Don't Dance,1987,tough_guys_dont_dance,4.9,18,7,11,38,0,4,2,2,50,3.3,251,49,http://content7.flixster.com/movie/10/27/21/10272101_det.jpg
6847,There Goes My Baby,1994,there_goes_my_baby,0,1,0,1,0,0,0,0,0,0,0,0,0,http://content7.flixster.com/movie/10/91/77/10917793_det.jpg
6848,Kingdom of the Spiders,1977,kingdom_of_the_spiders,5.5,9,4,5,44,0,0,0,0,0,0,0,0,http://content8.flixster.com/movie/11/14/66/11146690_det.jpg
6849,Scrooge,1970,1018413-scrooge,6.8,16,11,5,68,0,3,2,1,66,3.4,1834,72,http://content9.flixster.com/movie/25/08/250823_det.jpg
6850,Leap of Faith,1992,1042059-leap_of_faith,5.8,18,12,6,66,0,1,1,0,100,2.7,1901,38,http://content7.flixster.com/movie/11/14/29/11142965_det.jpg
6851,"Gas, Food Lodging",1992,gas_food_lodging,6.5,13,10,3,76,0,2,2,0,100,3.5,533,73,http://content6.flixster.com/movie/10/88/06/10880612_det.jpg
6852,In Cold Blood,1967,1010448-in_cold_blood,8.3,25,22,3,88,7.8,5,4,1,80,3.8,2614,83,http://content6.flixster.com/movie/10/87/75/10877588_det.jpg
6853,Campus Man,1987,campus_man,0,0,0,0,0,0,0,0,0,0,0,0,0,http://content9.flixster.com/movie/26/50/265091_det.jpg
6854,The Bedford Incident,1965,bedford_incident,6.9,7,7,0,100,0,0,0,0,0,0,0,0,http://content8.flixster.com/movie/29/45/294502_det.jpg
6855,Les blessures assassines,2000,murderous_maids,7.3,47,43,4,91,7.8,13,13,0,100,3.7,64,74,http://content6.flixster.com/movie/10/84/92/10849276_det.jpg
6856,Yankee Doodle Dandy,1942,yankee_doodle_dandy,7.9,23,21,2,91,0,3,3,0,100,3.8,1924,83,http://content6.flixster.com/movie/88/97/26/8897268_det.jpg
6857,J√ªb√™ ninp√ªch√¥,1993,ninja-scroll,8.3,5,5,0,100,0,0,0,0,0,0,0,0,http://content7.flixster.com/movie/10/86/72/10867205_det.jpg
6858,N√≥z w wodzie,1962,knife_in_the_water,8.2,30,30,0,100,0,4,4,0,100,3.9,2383,85,http://content6.flixster.com/movie/10/93/52/10935220_det.jpg
6859,All That Money Can Buy,1941,devil_and_daniel_webster,7.9,16,16,0,100,0,0,0,0,0,0,0,0,http://content6.flixster.com/movie/29/92/299296_det.jpg
6860,Mobsters,1991,mobsters,3.8,11,1,10,9,0,2,0,2,0,3.1,2921,54,http://content6.flixster.com/movie/27/35/273520_det.jpg
6861,Charlotte Sometimes,2002,charlotte_sometimes,6.8,44,36,8,81,7.6,11,11,0,100,3.5,200,66,http://content7.flixster.com/movie/28/05/280597_det.jpg
6862,Out of Time,2003,time-to-pay,0,0,0,0,0,0,0,0,0,0,0,0,0,http://content7.flixster.com/movie/10/86/86/10868609_det.jpg
6863,The School of Rock,2003,school_of_rock,7.8,188,172,16,91,8.2,39,38,1,97,3.2,183700,63,http://content6.flixster.com/movie/10/84/98/10849856_det.jpg
6864,Concert for George,2003,concert_for_george,7.6,18,17,1,94,7.3,9,8,1,88,4.3,31,90,http://content9.flixster.com/movie/11/00/78/11007847_det.jpg
6865,Lemony Snicket's A Series of Unfortunate Events,2004,lemony_snicket,6.6,154,109,45,70,6.6,32,19,13,59,3.2,60437,61,http://content8.flixster.com/movie/40/88/39/4088394_det.jpg
6866,9 Dead Gay Guys,2002,nine_dead_gay_guys,4,23,5,18,21,2.6,9,1,8,11,3.4,768,61,http://content9.flixster.com/movie/27/82/278291_det.jpg
6867,The Station Agent,2003,station_agent,8,149,142,7,95,8,33,33,0,100,3.9,7193,90,http://content7.flixster.com/movie/26/76/267605_det.jpg
6868,Wonderland,2003,wonderland,5,98,34,64,34,4.5,32,7,25,21,3.3,3666,67,http://content7.flixster.com/movie/26/94/269429_det.jpg
6869,√înibus 174,2002,bus_174,8.3,73,73,0,100,8.1,22,22,0,100,3.9,1380,87,http://content6.flixster.com/movie/10/89/58/10895812_det.jpg
6870,Mystic River,2003,mystic_river,7.8,193,168,25,87,8,40,38,2,95,3.7,30024,86,http://content6.flixster.com/movie/43/97/38/4397384_det.jpg
6871,Good Boy!,2003,1126165-good_boy,5.3,84,37,47,44,5.6,26,15,11,57,3,2701,49,http://content6.flixster.com/movie/10/86/51/10865120_det.jpg
6872,House of the Dead,2003,1126175-house_of_the_dead,1.9,53,2,51,3,2,12,1,11,8,1.9,6777,20,http://content6.flixster.com/movie/27/38/273892_det.jpg
6873,Intolerable Cruelty,2003,intolerable_cruelty,6.7,178,133,45,74,6.8,41,31,10,75,2.9,12106,43,http://content9.flixster.com/movie/55/36/85/5536851_det.jpg
6874,Kill Bill: Vol. 2,2004,kill_bill_vol_2,7.7,226,193,33,85,7.7,43,35,8,81,3.8,162324,87,http://content9.flixster.com/movie/26/69/266911_det.jpg
6875,Dopamine,2003,dopamine,5.5,51,26,25,50,5.4,20,8,12,40,3.1,357,51,http://content7.flixster.com/movie/28/15/281525_det.jpg
6876,La fleur du mal,2003,flower_of_evil,6.2,60,39,21,65,6.8,20,15,5,75,3.1,468,43,http://content9.flixster.com/movie/10/91/64/10916479_det.jpg
6877,Girls Will Be Girls,2003,girls_will_be_girls,5.6,31,18,13,58,5,13,6,7,46,3.6,1305,71,http://content9.flixster.com/movie/10/88/47/10884783_det.jpg
6879,Runaway Jury,2003,runaway_jury,6.6,152,111,41,73,6.6,38,28,10,73,3.4,11578,73,http://content7.flixster.com/movie/25/81/258113_det.jpg
6880,The Texas Chainsaw Massacre,2003,texas_chainsaw_massacre,4.8,152,55,97,36,4.2,33,6,27,18,3.2,36030,67,http://content7.flixster.com/movie/11/13/31/11133149_det.jpg
6881,Pieces of April,2003,pieces_of_april,7.1,145,122,23,84,7.2,36,31,5,86,3.3,5487,68,http://content8.flixster.com/movie/10/87/94/10879446_det.jpg
6882,The Return,2006,return,3.9,55,8,47,14,3.9,15,2,13,13,2.9,26258,38,http://content6.flixster.com/movie/29/81/34/2981344_det.jpg
6883,Sylvia,2003,1126413-sylvia,5.3,126,46,80,36,5.2,34,9,25,26,3.3,2530,58,http://content6.flixster.com/movie/27/29/272912_det.jpg
6884,Veronica Guerin,2003,veronica_guerin,6,135,73,62,54,5.5,35,15,20,42,3.6,2866,72,http://content6.flixster.com/movie/27/23/272304_det.jpg
6885,In the Cut,2003,in_the_cut,4.8,144,48,96,33,5,37,11,26,29,2.7,3073,36,http://content7.flixster.com/movie/63/26/12/6326125_det.jpg
6886,Beyond Borders,2003,beyond_borders,4.3,101,14,87,13,4.2,34,4,30,11,3.5,6426,75,http://content7.flixster.com/movie/27/36/273605_det.jpg
6887,Radio,2003,radio,5,115,41,74,35,4.9,32,8,24,25,3.6,23763,83,http://content9.flixster.com/movie/10/85/25/10852579_det.jpg
6888,Scary Movie 3,2003,scary_movie_3,4.8,124,45,79,36,4.8,30,11,19,36,3,92592,68,http://content6.flixster.com/movie/25/95/259504_det.jpg
6889,Brother Bear,2003,brother_bear,5.5,122,46,76,37,5.3,30,10,20,33,3.3,23328,68,http://content6.flixster.com/movie/50/26/74/5026744_det.jpg
6890,Elephant,2003,elephant,7,142,100,42,70,7.1,35,27,8,77,3.6,15005,79,http://content7.flixster.com/movie/72/69/79/7269797_det.jpg
6891,Gypsy 83,2001,gypsy_83,5.5,26,14,12,53,5.2,12,6,6,50,3.9,728,77,http://content6.flixster.com/movie/27/78/277816_det.jpg
6892,The Singing Detective,2003,singing_detective,5.1,106,41,65,38,5,28,9,19,32,3,2164,42,http://content9.flixster.com/movie/11/14/20/11142027_det.jpg
6893,The Italian Job,2003,italian_job,6.4,178,129,49,72,6.7,40,32,8,80,3.6,103062,79,http://content6.flixster.com/movie/10/89/11/10891136_det.jpg
6894,Impulse,2008,impulse,0,2,0,2,0,0,0,0,0,0,0,0,0,http://content8.flixster.com/movie/10/87/85/10878514_det.jpg
6895,Normal,2003,normal,7.2,6,6,0,100,0,2,2,0,100,3.6,624,71,http://content6.flixster.com/movie/10/88/24/10882448_det.jpg
6896,Shoah,1985,shoah,8.8,12,12,0,100,0,1,1,0,100,4.6,400,96,http://content7.flixster.com/movie/91/59/60/9159601_det.jpg
6897,Unconditional Love,2002,1124362-unconditional_love,3.7,6,1,5,16,0,1,0,1,0,3.5,739,65,http://content8.flixster.com/movie/25/87/258718_det.jpg
6898,Super Sweet 16: The Movie,2007,super-sweet-16-the-movie,0,1,0,1,0,0,0,0,0,0,0,0,0,http://content6.flixster.com/movie/10/90/76/10907660_det.jpg
6899,Alien from L.A.,1988,alien-from-la-odeon-wanda,1.3,6,0,6,0,0,0,0,0,0,0,0,0,http://content8.flixster.com/movie/10/34/76/10347610_det.jpg
6900,Black Sunday,1977,1002526-black_sunday,7.4,11,11,0,100,0,0,0,0,0,0,0,0,http://content8.flixster.com/movie/27/84/278426_det.jpg
6901,Men of Respect,1990,men_of_respect,0,3,0,3,0,0,1,0,1,0,3.1,107,47,http://content7.flixster.com/movie/55/29/02/5529021_det.jpg
6902,Interstate 60: Episodes of the Road,2002,interstate_60,6.4,5,4,1,80,0,0,0,0,0,0,0,0,http://content8.flixster.com/movie/10/68/75/10687594_det.jpg
6903,Lipstick,1976,lipstick,4.4,5,1,4,20,0,1,0,1,0,3,279,43,http://content7.flixster.com/movie/27/65/276521_det.jpg
6905,Storyville,1992,storyville,6,5,3,2,60,0,1,1,0,100,2.7,221,23,http://content7.flixster.com/movie/28/27/282705_det.jpg
6906,That Was Then... This Is Now,1985,that-was-then-this-is-now,3.2,5,0,5,0,0,0,0,0,0,0,0,0,http://content7.flixster.com/movie/27/03/270317_det.jpg
6907,Holy Matrimony,1943,holy-matrimony1943,0,0,0,0,0,0,0,0,0,0,0,0,0,http://content9.flixster.com/movie/10/66/74/10667483_det.jpg
6908,Ye yan,2006,legend_of_the_black_scorpion,4.4,8,3,5,37,0,2,0,2,0,3.5,2288,62,http://content6.flixster.com/movie/10/87/64/10876432_det.jpg
6909,Gin gwai,2002,eye,6.1,102,65,37,63,6.3,30,21,9,70,3.5,8843,71,http://content6.flixster.com/movie/27/08/270800_det.jpg
6910,Kronos,1957,kronos,5,6,4,2,66,0,0,0,0,0,0,0,0,http://content6.flixster.com/movie/28/77/287704_det.jpg
6911,The Jolson Story,1946,jolson_story,0,4,4,0,100,0,0,0,0,0,0,0,0,http://content8.flixster.com/movie/29/46/294602_det.jpg
6912,You'll Never Get Rich,1941,youll_never_get_rich,0,2,1,1,50,0,0,0,0,0,0,0,0,http://content7.flixster.com/movie/10/88/21/10882153_det.jpg
6913,Frankenstein and the Monster from Hell,1974,frankenstein-and-the-monster-from-hell,0,0,0,0,0,0,0,0,0,0,0,0,0,http://content9.flixster.com/movie/28/17/281723_det.jpg
6914,Preaching to the Perverted,1997,preaching_to_the_perverted,0,4,2,2,50,0,0,0,0,0,0,0,0,http://content7.flixster.com/movie/31/09/310929_det.jpg
6915,Chicago Joe and the Showgirl,1990,chicago_joe_and_the_showgirl,0,4,1,3,25,0,1,0,1,0,2.9,170,31,http://content9.flixster.com/movie/44/92/53/4492531_det.jpg
6916,Quest for Camelot,1998,quest_for_camelot,5.3,21,7,14,33,5.9,6,2,4,33,3.1,4042,62,http://content6.flixster.com/movie/10/91/52/10915264_det.jpg
6917,Promised Land,1996,,\N,\N,\N,\N,\N,\N,\N,\N,\N,\N,\N,\N,\N,\N
6918,Aparajito,1956,aparajito,8.4,14,13,1,92,8.2,7,6,1,85,4.3,811,92,http://content8.flixster.com/movie/30/37/303726_det.jpg
6919,The Hired Hand,1971,hired_hand,7.4,11,10,1,90,0,3,2,1,66,3.4,491,67,http://content8.flixster.com/movie/28/43/284302_det.jpg
6920,Le cercle rouge,1970,le_cercle_rouge,8.3,57,54,3,94,8.5,19,19,0,100,4.2,1875,92,http://content7.flixster.com/movie/29/57/295709_det.jpg
6921,Czlowiek z marmuru,1977,man_of_marble,0,2,2,0,100,0,0,0,0,0,0,0,0,http://content8.flixster.com/movie/31/15/311518_det.jpg
6923,Sherlock Holmes and the Voice of Terror,1942,sherlock_holmes_and_the_voice_of_terror,0,3,2,1,66,0,0,0,0,0,0,0,0,http://content7.flixster.com/movie/29/80/298025_det.jpg
6924,Sherlock Holmes Faces Death,1943,sherlock_holmes_faces_death,0,2,2,0,100,0,0,0,0,0,0,0,0,http://content6.flixster.com/movie/10/83/91/10839136_det.jpg
6925,Sherlock Holmes in Washington,1943,sherlock_holmes_in_washington,0,2,2,0,100,0,0,0,0,0,0,0,0,http://content7.flixster.com/movie/10/77/45/10774529_det.jpg
6926,The Solid Gold Cadillac,1956,solid_gold_cadillac,7.5,5,5,0,100,0,0,0,0,0,0,0,0,http://content6.flixster.com/movie/10/87/38/10873860_det.jpg
6927,The Human Stain,2003,human_stain,5.5,147,62,85,42,5.6,38,15,23,39,3.1,3875,50,http://content8.flixster.com/movie/10/88/77/10887758_det.jpg
6928,"Die, Mommie, Die!",2003,die_mommie_die,6,59,38,21,64,6.5,21,16,5,76,3.5,839,67,http://content6.flixster.com/movie/10/87/89/10878936_det.jpg
6929,Joe Dirt,2001,joe_dirt,3,74,8,66,10,2.7,24,1,23,4,2.8,16165,63,http://content6.flixster.com/movie/25/79/257912_det.jpg
6930,Girlhood,2003,girlhood,7.7,33,31,2,93,7.5,11,10,1,90,3.5,176,65,http://content8.flixster.com/movie/30/23/302302_det.jpg
6931,Mail Order Wife,2004,mail_order_wife,6,32,20,12,62,6.2,9,6,3,66,3.5,426,68,http://content8.flixster.com/movie/10/25/33/10253310_det.jpg
6932,Shattered Glass,2003,shattered_glass,7.7,163,148,15,90,7.5,37,31,6,83,3.5,4409,76,http://content6.flixster.com/movie/25/70/257024_det.jpg
6934,The Matrix Revolutions,2003,matrix_revolutions,5.3,203,74,129,36,5,37,10,27,27,3.4,111917,70,http://content9.flixster.com/movie/35/84/17/3584171_det.jpg
6935,Chavez: Inside the Coup,2003,revolution_will_not_be_televised,7.9,48,47,1,97,7.9,20,20,0,100,4.2,655,90,http://content8.flixster.com/movie/10/26/87/10268758_det.jpg
6936,Elf,2003,elf,6.9,166,139,27,83,6.5,38,29,9,76,3.2,66072,73,http://content6.flixster.com/movie/55/04/81/5504816_det.jpg
6937,Anything But Love,1989,anything-but-love,0,0,0,0,0,0,0,0,0,0,0,0,0,http://content6.flixster.com/movie/10/84/28/10842848_det.jpg
6938,Billabong Odyssey,2003,billabong_odyssey,4.9,11,4,7,36,4,5,1,4,20,4.1,417,88,http://content8.flixster.com/movie/10/87/32/10873282_det.jpg
6939,Gloomy Sunday - Ein Lied von Liebe und Tod,1999,gloomy_sunday,7,64,54,10,84,6.8,16,13,3,81,4.1,1350,91,http://content8.flixster.com/movie/95/84/21/9584214_det.jpg
6940,Dans ma peau,2002,in-my-skin,6,41,26,15,63,5.5,12,7,5,58,3.6,899,68,http://content7.flixster.com/movie/10/87/40/10874021_det.jpg
6942,Love Actually,2003,love_actually,6.4,187,118,69,63,6.3,42,25,17,59,3.1,191514,71,http://content9.flixster.com/movie/11/13/76/11137679_det.jpg
6944,Father of the Bride,1991,1037864-father_of_the_bride,5.8,29,21,8,72,0,2,2,0,100,3.2,22336,67,http://content9.flixster.com/movie/25/83/258323_det.jpg
6945,My Architect,2003,my-architect,7.5,90,84,6,93,7.7,26,26,0,100,3.8,825,81,http://content6.flixster.com/movie/29/09/290924_det.jpg
6946,Looney Tunes: Back in Action,2003,looney_tunes_back_in_action,6,130,73,57,56,5.9,32,20,12,62,2.7,8974,43,http://content8.flixster.com/movie/96/80/21/9680214_det.jpg
6947,Master and Commander: The Far Side of the World,2003,master_and_commander_the_far_side_of_the_world,7.6,205,174,31,84,7.8,41,38,3,92,3.3,17643,75,http://content8.flixster.com/movie/25/41/254198_det.jpg
6948,Tupac: Resurrection,2003,tupac_resurrection,6.7,85,66,19,77,6.6,32,26,6,81,4,2964,87,http://content8.flixster.com/movie/10/92/14/10921402_det.jpg
6949,The Big Empty,2003,1127652-big_empty,5.3,7,5,2,71,0,1,1,0,100,3.1,888,48,http://content9.flixster.com/movie/27/62/276219_det.jpg
6950,The Missing,2003,1127407-missing,6.1,168,98,70,58,6.1,39,21,18,53,3,6895,52,http://content8.flixster.com/movie/11/12/76/11127650_det.jpg
6951,The Cat in the Hat,2003,cat_in_the_hat,3.2,148,16,132,10,3.4,37,5,32,13,2.5,15383,41,http://content6.flixster.com/movie/26/53/265308_det.jpg
6952,Gothika,2003,gothika,4.1,161,24,137,14,3.9,34,2,32,5,3,23666,56,http://content8.flixster.com/movie/55/37/30/5537306_det.jpg
6953,21 Grams,2003,21_grams,7.5,175,142,33,81,8.1,36,32,4,88,3.6,38037,83,http://content8.flixster.com/movie/55/36/53/5536534_det.jpg
6954,Les invasions barbares,2003,barbarian_invasions,7.2,125,103,22,82,7.3,35,29,6,82,3.9,4434,88,http://content8.flixster.com/movie/10/88/29/10882926_det.jpg
6955,Blindness,2008,1188215-blindness,5.2,150,63,87,42,5,30,8,22,26,3.1,17761,49,http://content6.flixster.com/movie/10/85/34/10853428_det.jpg
6956,Lan se da men,2002,blue-gate-crossing,7.1,12,10,2,83,6.8,6,5,1,83,3.9,931,86,http://content9.flixster.com/movie/10/87/78/10877839_det.jpg
6957,Bad Santa,2003,bad_santa,6.7,187,144,43,77,6.9,40,32,8,80,3.2,17921,73,http://content9.flixster.com/movie/10/85/09/10850919_det.jpg
6958,The Haunted Mansion,2003,haunted_mansion,4.2,134,18,116,13,4.4,31,6,25,19,2.6,14063,41,http://content7.flixster.com/movie/25/87/258797_det.jpg
6959,Timeline,2003,timeline,3.7,135,15,120,11,3.8,33,5,28,15,2.9,8959,52,http://content8.flixster.com/movie/10/83/83/10838378_det.jpg
6960,Marquis de Sade: Justine,1969,marquis-de-sade-justine,0,1,0,1,0,0,0,0,0,0,0,0,0,http://content8.flixster.com/movie/11/15/24/11152426_det.jpg
6961,Damage,1992,damage,6.7,19,14,5,73,0,3,2,1,66,0,0,0,http://content8.flixster.com/movie/27/14/271414_det.jpg
6962,OT: Our Town,2002,1124927-ot_our_town,7,24,21,3,87,6.9,6,5,1,83,3.6,67,82,http://content8.flixster.com/movie/10/87/48/10874866_det.jpg
6963,The Devil's Playground,1976,the-devils-playground,0,0,0,0,0,0,0,0,0,0,0,0,0,http://content8.flixster.com/movie/29/35/293510_det.jpg
6964,Dance with a Stranger,1985,dance_with_a_stranger,7.4,10,9,1,90,0,1,1,0,100,3.4,510,64,http://content9.flixster.com/movie/28/21/282103_det.jpg
6965,Journeys with George,2002,journeys_with_george,6.6,10,8,2,80,0,3,2,1,66,3.4,435,71,http://content7.flixster.com/movie/10/88/49/10884981_det.jpg
6966,Darkman,1990,darkman,6.6,46,36,10,78,7.1,8,7,1,87,2.9,9871,50,http://content9.flixster.com/movie/12/27/85/1227851_det.jpg
6967,Dead of Night,1945,dead-of-night-mirror-of-death,0,0,0,0,0,0,0,0,0,0,0,0,0,http://content7.flixster.com/movie/10/91/62/10916205_det.jpg
6968,Death Machine,1994,death_by_design,0,1,1,0,100,0,0,0,0,0,0,0,0,http://content7.flixster.com/movie/10/85/90/10859017_det.jpg
6969,Le dernier combat,1983,le_dernier_combat,0,3,2,1,66,0,0,0,0,0,0,0,0,http://content8.flixster.com/movie/10/92/20/10922098_det.jpg
6970,Desk Set,1957,desk_set,6.8,16,16,0,100,0,2,2,0,100,3.9,1337,81,http://content7.flixster.com/movie/51/03/510393_det.jpg
6971,Europa,1991,zentropa,7.2,12,10,2,83,0,1,1,0,100,4,2055,88,http://content8.flixster.com/movie/10/89/21/10892126_det.jpg
6972,The Watermelon Woman,1996,watermelon_woman,7.3,5,5,0,100,0,1,1,0,100,3.2,237,54,http://content7.flixster.com/movie/30/61/306117_det.jpg
6973,Final Analysis,1992,final_analysis,5.3,22,11,11,50,5.8,6,3,3,50,2.8,1422,37,http://content9.flixster.com/movie/27/82/278215_det.jpg
6974,The Freshman,1990,10009001-the_freshman,7.3,32,30,2,93,7.2,8,7,1,87,3.1,2525,52,http://content6.flixster.com/movie/11/14/93/11149316_det.jpg
6975,Funny Games U.S.,2007,1175174-funny_games,5.6,138,71,67,51,4.7,34,13,21,38,3.2,16153,54,http://content8.flixster.com/movie/10/88/03/10880338_det.jpg
6976,Tales from the Crypt,1989,tales_from_the_crypt,0,1,1,0,100,0,0,0,0,0,0,0,0,http://content8.flixster.com/movie/10/96/02/10960298_det.jpg
6977,New Jack City,1991,new_jack_city,6.4,28,22,6,78,7.2,7,6,1,85,0,0,0,http://content7.flixster.com/movie/11/14/58/11145817_det.jpg
6978,Slackers,2002,slackers,3.1,104,11,93,10,2.4,30,1,29,3,2.8,4294,52,http://content6.flixster.com/movie/10/93/77/10937732_det.jpg
6979,WarGames,1983,wargames,7.4,27,26,1,96,0,4,3,1,75,3.3,7636,68,http://content8.flixster.com/movie/11/14/87/11148730_det.jpg
6980,Mr. Hobbs Takes a Vacation,1962,mr_hobbs_takes_a_vacation,5.8,9,8,1,88,0,0,0,0,0,0,0,0,http://content6.flixster.com/movie/29/08/290828_det.jpg
6981,Ordet,1955,ordet,9.4,11,11,0,100,0,1,1,0,100,4.4,1138,91,http://content9.flixster.com/movie/10/08/38/10083867_det.jpg
6982,Jeux interdits,1952,1007681-forbidden_games,8.8,9,9,0,100,0,0,0,0,0,0,0,0,http://content7.flixster.com/movie/36/02/62/3602621_det.jpg
6983,Jane Eyre,2006,,\N,\N,\N,\N,\N,\N,\N,\N,\N,\N,\N,\N,\N,\N
6984,A Tale of Two Cities,1958,1020815-tale_of_two_cities,0,0,0,0,0,0,0,0,0,0,0,0,0,http://content6.flixster.com/movie/10/86/16/10861668_det.jpg
6985,La passion de Jeanne d'Arc,1928,passion_of_joan_of_arc,8.9,31,30,1,96,8.1,6,5,1,83,4.4,3362,94,http://content9.flixster.com/movie/10/92/71/10927155_det.jpg
6986,Ben-Hur,1959,benhur,7.8,33,30,3,90,0,4,3,1,75,3.7,25817,80,http://content9.flixster.com/movie/10/93/53/10935339_det.jpg
6987,Das Cabinet des Dr. Caligari.,1920,1003361-cabinet_of_dr_caligari,8.9,34,34,0,100,0,1,1,0,100,4.1,6812,88,http://content9.flixster.com/movie/28/67/286791_det.jpg
6988,Broken Blossoms or The Yellow Man and the Girl,1919,,8.1,13,13,0,100,0,1,1,0,100,3.7,970,73,http://content8.flixster.com/movie/10/87/21/10872150_det.jpg
6989,Gorky Park,1983,gorky_park,6.6,22,17,5,77,0,4,3,1,75,3.3,824,57,http://content9.flixster.com/movie/27/25/272591_det.jpg
6990,The Great Train Robbery,1903,the-great-train-robbery1903,7.6,6,6,0,100,0,0,0,0,0,0,0,0,http://content7.flixster.com/movie/10/87/70/10877081_det.jpg
6991,"Greystoke: The Legend of Tarzan, Lord of the Apes",1984,greystoke_the_legend_of_tarzan_lord_of_the_apes,5.8,10,6,4,60,0,0,0,0,0,0,0,0,http://content8.flixster.com/movie/10/54/79/10547962_det.jpg
6992,Guarding Tess,1994,guarding_tess,5.6,31,18,13,58,6.7,7,5,2,71,3,2875,51,http://content7.flixster.com/movie/91/03/40/9103405_det.jpg
6993,Hannah and Her Sisters,1986,hannah_and_her_sisters,8.4,40,37,3,92,8.5,5,5,0,100,3.9,7548,88,http://content9.flixster.com/movie/25/64/256419_det.jpg
6994,The Hard Way,1991,hard_way,5.8,18,14,4,77,0,2,1,1,50,3,2056,46,http://content8.flixster.com/movie/10/88/51/10885158_det.jpg
6995,Hercules in New York,1969,hercules_in_new_york,2.8,5,1,4,20,0,0,0,0,0,0,0,0,http://content7.flixster.com/movie/25/21/252193_det.jpg
6996,Highlander II: The Quickening,1991,highlander_2_the_quickening,2.6,21,0,21,0,0,3,0,3,0,2.6,7551,37,http://content8.flixster.com/movie/10/94/47/10944762_det.jpg
6997,Hoffa,1992,hoffa,5.6,20,11,9,55,0,2,1,1,50,3.3,2678,58,http://content7.flixster.com/movie/26/97/269797_det.jpg
6998,House of Cards,1993,,\N,\N,\N,\N,\N,\N,\N,\N,\N,\N,\N,\N,\N,\N
6999,HouseSitter,1992,housesitter,5.1,17,7,10,41,0,2,1,1,50,2.7,3753,46,http://content6.flixster.com/movie/95/33/72/9533720_det.jpg
7000,Hudson Hawk,1991,hudson_hawk,3.6,30,6,24,20,0,4,1,3,25,2.9,6827,54,http://content7.flixster.com/movie/27/18/271897_det.jpg
7001,Invasion of the Body Snatchers,1956,1010678-invasion_of_the_body_snatchers,8.9,36,36,0,100,0,2,2,0,100,3.6,3820,81,http://content8.flixster.com/movie/10/95/44/10954478_det.jpg
7002,Mindwalk,1990,mind_walk,6.6,8,7,1,87,0,0,0,0,0,0,0,0,http://content7.flixster.com/movie/56/48/07/5648077_det.jpg
7003,Kafka,1991,kafka-1992,0,0,0,0,0,0,0,0,0,0,0,0,0,http://images.rottentomatoescdn.com/images/defaults/poster_default.gif
7004,Kindergarten Cop,1990,kindergarten_cop,5.1,32,16,16,50,5.7,6,3,3,50,3,22205,53,http://content8.flixster.com/movie/10/94/40/10944042_det.jpg
7005,King Ralph,1991,king_ralph,4.7,9,2,7,22,0,1,0,1,0,2.4,1885,26,http://content9.flixster.com/movie/26/51/265119_det.jpg
7006,Knight Moves,1992,knight_moves,3.7,5,1,4,20,0,1,0,1,0,2.9,884,37,http://content6.flixster.com/movie/15/97/13/1597132_det.jpg
7007,The Last Boy Scout,1991,last_boy_scout,5.1,30,13,17,43,0,4,2,2,50,3.3,11177,66,http://content9.flixster.com/movie/10/92/20/10922043_det.jpg
7008,Ultimo tango a Parigi,1972,last_tango_in_paris,7.8,26,21,5,80,0,4,3,1,75,3.6,6478,76,http://content8.flixster.com/movie/10/86/71/10867138_det.jpg
7009,Lorenzo's Oil,1992,lorenzos_oil,6.8,23,22,1,95,0,3,3,0,100,3.5,2829,76,http://content7.flixster.com/movie/10/84/21/10842145_det.jpg
7010,L'amant,1992,lover,4.8,15,4,11,26,0,4,0,4,0,3.8,2726,80,http://content9.flixster.com/movie/26/76/267607_det.jpg
7011,The Matador,2008,10009680-matador,6.7,14,11,3,78,6.7,5,4,1,80,3.4,113,56,http://content8.flixster.com/movie/10/86/12/10861230_det.jpg
7012,Mr. Destiny,1990,mr_destiny,4.7,15,6,9,40,0,2,0,2,0,3,1673,47,http://content6.flixster.com/movie/10/87/45/10874572_det.jpg
7013,The Night of the Hunter,1955,night_of_the_hunter,8.7,41,40,1,97,8,8,7,1,87,4.2,5852,91,http://content7.flixster.com/movie/29/13/291397_det.jpg
7014,Nowhere to Run,1993,1042212-nowhere_to_run,3.9,19,5,14,26,3,6,0,6,0,2.7,2820,39,http://content7.flixster.com/movie/27/72/277201_det.jpg
7015,Only the Lonely,1991,only_the_lonely,5.9,18,11,7,61,0,1,0,1,0,2.9,1292,45,http://content6.flixster.com/movie/25/96/259600_det.jpg
7016,Over the Top,1987,,\N,\N,\N,\N,\N,\N,\N,\N,\N,\N,\N,\N,\N,\N
7017,Passenger 57,1992,passenger_57,3.9,21,5,16,23,0,1,0,1,0,2.9,8383,48,http://content8.flixster.com/movie/11/15/20/11152054_det.jpg
7018,Presumed Innocent,1990,presumed_innocent,7.2,31,29,2,93,7.5,8,8,0,100,3.2,3836,60,http://content9.flixster.com/movie/27/17/271707_det.jpg
7019,Project X,1987,1016832-project_x,6.2,9,7,2,77,0,1,1,0,100,3.1,1570,53,http://content6.flixster.com/movie/26/00/260008_det.jpg
7020,Proof,2005,proof,6.4,138,87,51,63,6.4,34,20,14,58,3.2,15629,57,http://content7.flixster.com/movie/10/89/83/10898325_det.jpg
7021,Pure Luck,1991,pure_luck,4,9,1,8,11,0,2,0,2,0,0,0,0,http://content9.flixster.com/movie/10/89/89/10898951_det.jpg
7022,Batoru rowaiaru,2000,1217514-battle_royale,7.2,22,18,4,81,0,0,0,0,0,0,0,0,http://content7.flixster.com/movie/10/93/51/10935129_det.jpg
7023,Xi yan,1993,wedding_banquet,7.5,16,15,1,93,0,2,2,0,100,3.9,2178,86,http://content9.flixster.com/movie/11/12/06/11120683_det.jpg
7024,Sal√≤ o le 120 giornate di Sodoma,1975,salo,6.1,21,15,6,71,0,2,1,1,50,3.6,4630,68,http://content7.flixster.com/movie/10/93/75/10937577_det.jpg
7025,A Midnight Clear,1992,1039575-1039575-midnight_clear,7.5,25,21,4,84,0,4,3,1,75,3.7,801,79,http://content9.flixster.com/movie/27/01/270191_det.jpg
7026,Summer School,1987,1020451-summer_school,5.5,28,17,11,60,0,4,1,3,25,2.9,3011,55,http://content7.flixster.com/movie/10/93/77/10937789_det.jpg
7027,Silverado,1985,silverado,6.8,29,22,7,75,5.8,5,3,2,60,3.5,5005,75,http://content8.flixster.com/movie/21/37/26/2137262_det.jpg
7028,Quick Change,1990,quick_change,6.5,27,22,5,81,5.3,8,4,4,50,3.3,2142,63,http://content8.flixster.com/movie/10/86/04/10860482_det.jpg
7029,Rabid,1977,rabid,5.8,18,11,7,61,0,1,0,1,0,3.1,1745,48,http://content6.flixster.com/movie/28/50/285000_det.jpg
7030,Radio Flyer,1992,radio_flyer,4.7,28,12,16,42,4.4,7,2,5,28,3.4,2859,73,http://content9.flixster.com/movie/31/01/72/3101727_det.png
7031,The Real McCoys,1957,,\N,\N,\N,\N,\N,\N,\N,\N,\N,\N,\N,\N,\N,\N
7032,Star Wars: Episode III - Revenge of the Sith,2005,star_wars_3,7.2,253,202,51,79,6.6,43,29,14,67,3.1,198824,64,http://content8.flixster.com/movie/10/94/47/10944718_det.jpg
7033,The Secret of My Succe$s,1987,secret_of_my_success,5.4,19,11,8,57,0,4,2,2,50,3,3534,57,http://content9.flixster.com/movie/10/88/77/10887723_det.jpg
7034,Fucking √Öm√•l,1998,show_me_love,7.6,39,35,4,89,7.8,10,9,1,90,3.9,4417,84,http://content8.flixster.com/movie/10/25/11/10251154_det.jpg
7035,Streets of Fire,1984,streets_of_fire,5.9,20,12,8,60,0,1,1,0,100,3.5,2031,70,http://content9.flixster.com/movie/10/74/54/10745447_det.jpg
7036,Teen Wolf,1985,teen_wolf,4.6,17,8,9,47,0,0,0,0,0,0,0,0,http://content8.flixster.com/movie/10/88/03/10880370_det.jpg
7037,Tacones lejanos,1991,1038770-high_heels,5.9,12,7,5,58,0,4,1,3,25,3.9,2771,85,http://content6.flixster.com/movie/26/09/45/2609452_det.jpg
7038,Things You Can Tell Just by Looking at Her,1999,things_you_can_tell_just_by_looking_at_her,6.5,19,14,5,73,0,4,4,0,100,3.3,1417,61,http://content9.flixster.com/movie/10/91/55/10915567_det.jpg
7039,Thunderheart,1992,thunderheart,6.4,15,13,2,86,0,2,1,1,50,3.4,2637,70,http://content6.flixster.com/movie/10/86/31/10863140_det.jpg
7040,To Live and Die in L.A.,1985,to_live_and_die_in_la,7.1,23,20,3,86,0,1,1,0,100,3.6,2714,74,http://content7.flixster.com/movie/10/85/62/10856229_det.jpg
7041,Trapped in Paradise,1994,trapped_in_paradise,3.1,20,2,18,10,2.8,7,1,6,14,2.9,2272,42,http://content7.flixster.com/movie/11/12/22/11122249_det.jpg
7042,37¬∞2 le matin,1986,betty_blue,6.4,25,19,6,76,5.6,9,5,4,55,4.1,3961,90,http://content9.flixster.com/movie/29/16/291615_det.jpg
7043,Vivre sa vie: Film en douze tableaux,1962,my_life_to_live,7.9,26,24,2,92,7.5,6,5,1,83,4.3,2190,92,http://content9.flixster.com/movie/10/89/04/10890435_det.jpg
7044,Wild at Heart,1990,wild_at_heart,5.8,42,27,15,64,5,8,3,5,37,3.7,11690,81,http://content9.flixster.com/movie/10/84/75/10847519_det.jpg
7045,The Witches,1990,1029830-witches,7.5,13,13,0,100,0,2,2,0,100,3.2,8849,61,http://content9.flixster.com/movie/11/15/31/11153119_det.jpg
7046,The Witches of Eastwick,1987,witches_of_eastwick,6.2,26,19,7,73,0,1,1,0,100,3.2,12158,60,http://content9.flixster.com/movie/10/88/46/10884655_det.jpg
7047,Year of the Dragon,1985,1024232-year_of_the_dragon,6.1,15,9,6,60,0,0,0,0,0,0,0,0,http://content7.flixster.com/movie/88/70/10/8870105_det.jpg
7048,Nothing to Lose,1997,1077642-nothing_to_lose,5.1,23,6,17,26,5.7,5,1,4,20,3.1,5245,67,http://content7.flixster.com/movie/10/45/21/10452197_det.jpg
7049,Flying Down to Rio,1933,flying_down_to_rio,7.5,5,5,0,100,0,0,0,0,0,0,0,0,http://content6.flixster.com/movie/10/87/46/10874680_det.jpg
7050,Follow the Fleet,1936,follow_the_fleet,7.1,8,6,2,75,0,0,0,0,0,0,0,0,http://content9.flixster.com/movie/10/95/41/10954111_det.jpg
7051,What's New Pussycat,1965,whats_new_pussycat,5.5,10,4,6,40,0,3,1,2,33,3.3,1538,57,http://content6.flixster.com/movie/11/13/14/11131424_det.jpg
7052,Mary of Scotland,1936,mary_of_scotland,0,0,0,0,0,0,0,0,0,0,0,0,0,http://content8.flixster.com/movie/51/04/510406_det.jpg
7053,Roberta,1935,roberta,6.6,5,4,1,80,0,0,0,0,0,0,0,0,http://content6.flixster.com/movie/37/40/88/3740884_det.jpg
7054,Little Women,1994,1190049-little_women,0,0,0,0,0,0,0,0,0,0,0,0,0,http://content7.flixster.com/movie/10/86/52/10865225_det.jpg
7055,Swing Time,1936,1020729-swing_time,8.6,19,19,0,100,0,4,4,0,100,0,0,0,http://content6.flixster.com/movie/10/87/48/10874800_det.jpg
7056,The Public Enemy,1931,1016885-public_enemy,8.4,26,26,0,100,0,2,2,0,100,3.9,1936,84,http://content9.flixster.com/movie/11/14/29/11142995_det.jpg
7057,A Midsummer Night's Dream,1999,tales-of-the-night-fairies,0,0,0,0,0,0,0,0,0,0,0,0,0,http://images.rottentomatoescdn.com/images/defaults/poster_default.gif
7058,Life with Father,1947,life_with_father,7.1,7,7,0,100,0,0,0,0,0,0,0,0,http://content9.flixster.com/movie/31/13/311319_det.jpg
7059,National Velvet,1944,national_velvet,7.8,11,11,0,100,0,0,0,0,0,0,0,0,http://content6.flixster.com/movie/25/33/253320_det.jpg
7060,Jesus Christ Superstar,1973,1011028-jesus_christ_superstar,5.9,21,12,9,57,0,2,1,1,50,3.4,5991,75,http://content6.flixster.com/movie/25/24/252400_det.jpg
7061,Dark Victory,1939,dark_victory,7.2,19,16,3,84,0,1,1,0,100,3.9,1297,83,http://content7.flixster.com/movie/11/14/87/11148789_det.jpg
7062,Birdman of Alcatraz,1962,birdman_of_alcatraz,6.9,15,12,3,80,0,0,0,0,0,0,0,0,http://content8.flixster.com/movie/10/61/21/10612186_det.jpg
7063,"Aguirre, der Zorn Gottes",1972,aguirre_the_wrath_of_god,8.9,32,31,1,96,0,3,3,0,100,4.2,6781,91,http://content8.flixster.com/movie/29/36/293618_det.jpg
7064,La belle et la b√™te,1946,belle-and-the-beast-a-christian-romance,0,0,0,0,0,0,0,0,0,0,0,0,0,http://content7.flixster.com/movie/10/88/19/10881933_det.jpg
7065,The Birth of a Nation,1915,birth_of_a_nation,8,31,31,0,100,0,4,4,0,100,3.3,1249,58,http://content9.flixster.com/movie/10/88/58/10885819_det.jpg
7066,Lan feng zheng,1993,the-blue-kite,8,8,8,0,100,0,2,2,0,100,3.9,476,85,http://content8.flixster.com/movie/10/91/36/10913658_det.jpg
7067,Giulietta degli spiriti,1965,juliet_of_the_spirits,7.2,21,18,3,85,7.1,7,6,1,85,4,1862,85,http://content8.flixster.com/movie/10/86/83/10868330_det.jpg
7068,L'ann√©e derni√®re √† Marienbad,1961,l-annee-derniere-a-marienbad-last-year-at-marienbad,8.1,34,32,2,94,8.8,7,7,0,100,4.2,2222,86,http://content8.flixster.com/movie/30/77/307794_det.jpg
7069,The Tragedy of Macbeth,1971,1012952-macbeth,7.7,24,20,4,83,0,4,2,2,50,3.3,1824,65,http://content7.flixster.com/movie/26/84/268401_det.jpg
7070,Red River,1948,red_river,8.6,18,18,0,100,0,3,3,0,100,0,0,0,http://content7.flixster.com/movie/11/15/10/11151073_det.jpg
7071,A Woman Under the Influence,1974,woman_under_the_influence,8,19,17,2,89,0,3,3,0,100,4.3,2367,93,http://content9.flixster.com/movie/10/88/19/10881963_det.jpg
7072,Stagecoach,1939,1019774-stagecoach,8.9,26,26,0,100,0,0,0,0,0,0,0,0,http://content8.flixster.com/movie/28/62/286214_det.jpg
7073,A Shot in the Dark,1964,1018909-shot_in_the_dark,7.9,20,20,0,100,0,0,0,0,0,0,0,0,http://content7.flixster.com/movie/26/13/261321_det.jpg
7074,Flight of the Navigator,1986,flight_of_the_navigator,5.7,7,5,2,71,0,0,0,0,0,0,0,0,http://content9.flixster.com/movie/25/42/254223_det.jpg
7075,The Court Jester,1955,court_jester,7.6,13,13,0,100,0,0,0,0,0,0,0,0,http://content6.flixster.com/movie/29/06/290696_det.jpg
7076,Bullitt,1968,bullitt,7.7,33,32,1,96,7.1,5,4,1,80,3.8,8312,84,http://content8.flixster.com/movie/10/80/53/10805334_det.jpg
7077,Way Down East,1920,way_down_east,8.3,8,7,1,87,0,0,0,0,0,0,0,0,http://content9.flixster.com/movie/30/30/303023_det.jpg
7078,Jezebel,1938,jezebel,7.5,13,13,0,100,0,0,0,0,0,0,0,0,http://content6.flixster.com/movie/95/33/26/9533264_det.jpg
7079,The Hunchback of Notre Dame,1939,1010215-hunchback_of_notre_dame,8.3,9,9,0,100,0,0,0,0,0,0,0,0,http://content9.flixster.com/movie/29/39/293991_det.jpg
7080,42nd Street,1933,42nd_street,7.8,20,19,1,95,0,2,1,1,50,3.5,1572,71,http://content6.flixster.com/movie/29/29/292904_det.jpg
7081,I'm No Angel,1933,im_no_angel,7.7,8,8,0,100,0,0,0,0,0,0,0,0,http://content8.flixster.com/movie/10/86/72/10867242_det.jpg
7082,That Touch of Mink,1962,that-touch-of-mink,5.4,9,6,3,66,0,0,0,0,0,0,0,0,http://content6.flixster.com/movie/29/15/291516_det.jpg
7083,Sweet Dreams,1985,sweet_dreams,6.4,12,11,1,91,0,1,0,1,0,3.7,1151,77,http://content6.flixster.com/movie/25/73/257324_det.jpg
7084,"Play It Again, Sam",1972,play_it_again_sam,7.4,32,31,1,96,0,1,1,0,100,3.9,3355,86,http://content9.flixster.com/movie/10/92/17/10921731_det.jpg
7085,Send Me No Flowers,1964,send_me_no_flowers,6.4,7,5,2,71,0,0,0,0,0,0,0,0,http://content7.flixster.com/movie/29/37/293793_det.jpg
7086,Pygmalion,1938,1016943-pygmalion,8.2,16,15,1,93,0,3,3,0,100,3.7,900,82,http://content9.flixster.com/movie/29/83/298315_det.jpg
7087,A Passage to India,1984,passage_to_india,7.3,20,17,3,85,0,4,3,1,75,3.6,1652,74,http://content9.flixster.com/movie/25/79/257991_det.jpg
7088,Orfeu Negro,1959,black_orpheus,7.8,21,19,2,90,0,4,4,0,100,4,1619,86,http://content8.flixster.com/movie/25/74/257422_det.jpg
7089,Amarcord,1973,amarcord,8.2,39,36,3,92,8.4,10,9,1,90,4.2,5273,90,http://content6.flixster.com/movie/10/93/39/10933992_det.gif
7090,Ying xiong,2002,the-hero2004,0,0,0,0,0,0,0,0,0,0,0,0,0,http://content7.flixster.com/movie/10/84/81/10848177_det.jpg
7091,Horse Feathers,1932,horse_feathers,8.2,24,23,1,95,0,3,3,0,100,3.9,2168,86,http://content9.flixster.com/movie/30/08/300807_det.jpg
7092,Anna Karenina,1935,1001063-anna_karenina,7.4,7,7,0,100,0,0,0,0,0,0,0,0,http://content7.flixster.com/movie/10/94/46/10944689_det.jpg
7093,The Front Page,1974,1037105-front_page,5.8,24,16,8,66,0,1,1,0,100,3.6,905,73,http://content9.flixster.com/movie/10/91/11/10911135_det.gif
7094,The Rules of Attraction,2002,rules_of_attraction,5.3,134,59,75,44,4.9,27,9,18,33,3.2,10253,71,http://content8.flixster.com/movie/26/92/269226_det.jpg
7095,Looking for Mr. Goodbar,1977,looking_for_mr_goodbar,6.4,19,15,4,78,0,2,2,0,100,0,0,0,http://content9.flixster.com/movie/10/91/36/10913647_det.jpg
7096,Rivers and Tides,2001,rivers-and-tides,8.1,70,69,1,98,7.8,21,20,1,95,4.2,236,86,http://content8.flixster.com/movie/10/85/12/10851218_det.jpg
7097,Une hirondelle a fait le printemps,2001,girl_from_paris,6.9,41,37,4,90,7.2,15,13,2,86,3.5,505,64,http://content7.flixster.com/movie/28/97/06/2897065_det.jpg
7099,Kaze no tani no Naushika,1984,nausicaa_of_the_valley_of_the_wind,8.2,8,8,0,100,0,0,0,0,0,0,0,0,http://content7.flixster.com/movie/10/89/09/10890909_det.jpg
7100,CrissCross,1992,crisscross,0,0,0,0,0,0,0,0,0,0,0,0,0,http://content6.flixster.com/movie/28/23/282300_det.jpg
7101,Doc Hollywood,1991,doc_hollywood,5.9,24,18,6,75,0,1,1,0,100,2.7,3776,43,http://content7.flixster.com/movie/11/15/26/11152629_det.jpg
7102,Dragnet,1987,1006250-dragnet,4.9,28,13,15,46,6.4,6,5,1,83,0,0,0,http://content7.flixster.com/movie/10/60/75/10607577_det.jpg
7103,Madhouse,2004,1139602-madhouse,0,1,0,1,0,0,0,0,0,0,0,0,0,http://content9.flixster.com/movie/10/88/03/10880391_det.jpg
7104,1941,1979,1941,5.2,21,7,14,33,0,1,0,1,0,3,5333,48,http://content8.flixster.com/movie/25/85/258518_det.jpg
7105,A Shot at Glory,2000,shot_at_glory,6,21,14,7,66,0,4,4,0,100,3.3,476,61,http://content7.flixster.com/movie/28/05/280501_det.jpg
7106,Noirs et blancs en couleur,1976,black_and_white_in_color,0,4,4,0,100,0,0,0,0,0,0,0,0,http://content7.flixster.com/movie/10/87/61/10876125_det.jpg
7107,Foul Play,1978,1007739-foul_play,6.2,20,14,6,70,0,3,1,2,33,3.4,1837,67,http://content9.flixster.com/movie/10/86/37/10863791_det.jpg
7108,Zhong an zu,1993,1074827-crime_story,6.6,15,14,1,93,0,1,1,0,100,3.3,1708,60,http://content9.flixster.com/movie/28/26/282623_det.jpg
7109,Al di l√† delle nuvole,1995,beyond_the_clouds,6.4,20,13,7,65,0,4,3,1,75,3.6,976,68,http://content7.flixster.com/movie/10/89/20/10892009_det.jpg
7110,M√¥j√ª tai Issunb√¥shi,2001,,\N,\N,\N,\N,\N,\N,\N,\N,\N,\N,\N,\N,\N,\N
7111,Ryan's Daughter,1970,ryans_daughter,5.5,16,8,8,50,5.5,5,2,3,40,3.9,717,79,http://content8.flixster.com/movie/44/33/07/4433070_det.jpg
7112,Crash,2004,1144992-crash,7.1,197,148,49,75,7.1,39,30,9,76,4,98746,89,http://content7.flixster.com/movie/24/97/249717_det.jpg
7113,Cabeza de Vaca,1991,cabeza-de-vaca,0,0,0,0,0,0,0,0,0,0,0,0,0,http://content8.flixster.com/movie/28/43/284310_det.jpg
7114,The Bone Collector,1999,bone_collector,4.7,84,23,61,27,4.7,23,7,16,30,3.3,26317,68,http://content7.flixster.com/movie/10/88/63/10886301_det.jpg
7115,Profondo rosso,1975,deep_red_the_hatchet_murders,8,18,18,0,100,0,0,0,0,0,0,0,0,http://content6.flixster.com/movie/10/89/14/10891472_det.jpg
7116,Les diaboliques,1955,1032980-diabolique,8.2,23,22,1,95,7.8,5,4,1,80,4.1,3066,91,http://content9.flixster.com/movie/28/69/286991_det.jpg
7117,Leprechaun,1993,leprechaun,4,10,3,7,30,0,1,0,1,0,2.5,4764,38,http://content8.flixster.com/movie/27/38/273894_det.jpg
7118,√îritsu uch√ªgun Oneamisu no tsubasa,1987,wings_of_honneamise,6.9,9,9,0,100,0,3,3,0,100,3.7,1212,75,http://content6.flixster.com/movie/10/86/72/10867208_det.jpg
7119,Movie Crazy,1932,movie_crazy,0,1,0,1,0,0,0,0,0,0,0,0,0,http://content6.flixster.com/movie/10/88/53/10885304_det.jpg
7120,Dark Wolf,2003,dark-wolf,0,0,0,0,0,0,0,0,0,0,0,0,0,http://images.rottentomatoescdn.com/images/defaults/poster_default.gif
7121,Adam's Rib,1949,1000253-adams_rib,8.2,23,23,0,100,0,3,3,0,100,3.9,3056,85,http://content6.flixster.com/movie/70/91/29/7091296_det.jpg
7122,Le roi de coeur,1966,1011624-king_of_hearts,7.4,10,9,1,90,0,2,1,1,50,4,779,86,http://content9.flixster.com/movie/10/54/32/10543255_det.jpg
7123,Naked Lunch,1991,naked_lunch,6.8,31,21,10,67,0,2,1,1,50,3.6,7592,78,http://content9.flixster.com/movie/26/96/269695_det.jpg
7124,The Grass Is Greener,1960,grass_is_greener,6.6,7,7,0,100,0,0,0,0,0,0,0,0,http://content7.flixster.com/movie/29/78/297817_det.jpg
7125,Spring Forward,1999,spring_forward,7.5,22,19,3,86,0,2,2,0,100,3.8,237,78,http://content6.flixster.com/movie/28/00/280024_det.jpg
7126,The Killing of a Chinese Bookie,1976,killing_of_a_chinese_bookie,6.2,15,12,3,80,0,2,1,1,50,3.9,1173,83,http://content9.flixster.com/movie/32/87/79/3287795_det.jpg
7127,Run Fatboy Run,2007,10008621-run_fat_boy_run,5.5,143,69,74,48,5.5,31,17,14,54,3.5,43462,66,http://content7.flixster.com/movie/10/86/16/10861685_det.jpg
7128,Things to Come,1936,things_to_come,7.5,20,19,1,95,0,3,2,1,66,3.3,608,54,http://content7.flixster.com/movie/31/03/310325_det.jpg
7129,Queen of Hearts,1989,queen_of_hearts,0,3,2,1,66,0,1,1,0,100,0,0,0,http://content9.flixster.com/movie/10/95/94/10959419_det.jpg
7130,My Darling Clementine,1946,my_darling_clementine,8.7,22,22,0,100,0,1,1,0,100,3.8,1741,83,http://content6.flixster.com/movie/10/36/01/10360144_det.jpg
7131,A Summer Place,1959,summer_place,6,6,5,1,83,0,0,0,0,0,0,0,0,http://content7.flixster.com/movie/51/25/06/5125065_det.jpg
7132,A Night at the Opera,1935,1015002-night_at_the_opera,8.5,33,32,1,96,0,3,2,1,66,4.1,4515,90,http://content6.flixster.com/movie/44/42/04/4442040_det.jpg
7133,Metalstorm: The Destruction of Jared-Syn,1983,metalstorm_the_destruction_of_jaredsyn,0,0,0,0,0,0,0,0,0,0,0,0,0,http://content8.flixster.com/movie/63/52/67/6352670_det.jpg
7134,Forbrydelsens element,1984,element_of_crime,6.3,13,10,3,76,0,0,0,0,0,0,0,0,http://content9.flixster.com/movie/10/94/16/10941679_det.jpg
7135,Tirez sur le pianiste,1960,shoot_the_piano_player,8.6,18,17,1,94,0,3,2,1,66,0,0,0,http://content6.flixster.com/movie/11/12/67/11126796_det.jpg
7136,Baisers vol√©s,1968,stolen_kisses,7.7,16,15,1,93,0,1,1,0,100,4,1610,88,http://content8.flixster.com/movie/10/88/70/10887038_det.jpg
7137,The Cooler,2003,cooler,6.7,168,129,39,76,7.2,36,32,4,88,3.3,3858,68,http://content8.flixster.com/movie/27/05/270598_det.jpg
7138,El bonaerense,2002,el_bonaerense,6.7,11,10,1,90,6.6,5,4,1,80,3.1,27,53,http://content9.flixster.com/movie/10/89/21/10892191_det.jpg
7139,In America,2002,in_america,7.7,170,151,19,88,7.8,40,37,3,92,3.8,6695,89,http://content7.flixster.com/movie/10/87/20/10872045_det.jpg
7141,My Flesh and Blood,2003,my_flesh_and_blood,7.6,30,27,3,90,7.8,11,10,1,90,4,459,89,http://content6.flixster.com/movie/10/88/75/10887528_det.jpg
7142,Honey,2003,honey,4.1,111,22,89,19,4.1,30,5,25,16,3.4,89773,76,http://content8.flixster.com/movie/10/87/98/10879830_det.jpg
7143,The Last Samurai,2003,last_samurai,6.4,213,138,75,64,5.9,41,23,18,56,3.7,87574,82,http://content8.flixster.com/movie/10/93/21/10932166_det.jpg
7144,Forget Baghdad: Jews and Arabs - The Iraqi Connection,2002,forget_baghdad,6.9,12,9,3,75,0,4,3,1,75,3.5,42,56,http://content6.flixster.com/movie/10/90/11/10901116_det.jpg
7146,What Alice Found,2003,what_alice_found,6.3,38,26,12,68,6.8,11,9,2,81,3.1,213,46,http://content6.flixster.com/movie/11/13/19/11131960_det.jpg
7147,Big Fish,2003,1127787-big_fish,7.2,211,161,50,76,6.4,41,25,16,60,3.7,112139,86,http://content7.flixster.com/movie/10/91/40/10914061_det.jpg
7148,Love Don't Cost a Thing,2003,love_dont_cost_a_thing,3.7,71,9,62,12,4.1,24,4,20,16,3.1,6106,70,http://content8.flixster.com/movie/55/28/29/5528294_det.jpg
7149,Something's Gotta Give,2003,somethings_gotta_give,6.5,163,115,48,70,6.8,39,29,10,74,3.2,24174,68,http://content8.flixster.com/movie/55/35/97/5535970_det.jpg
7150,Stuck on You,2003,stuck_2003,0,0,0,0,0,0,0,0,0,0,0,0,0,http://content7.flixster.com/movie/10/84/70/10847097_det.jpg
7151,Girl with a Pearl Earring,2003,girl_with_a_pearl_earring,6.8,172,123,49,71,6.7,39,30,9,76,3.4,16783,67,http://content9.flixster.com/movie/25/47/254707_det.jpg
7152,The Statement,2003,statement,4.7,106,25,81,23,4.5,32,6,26,18,3,654,38,http://content7.flixster.com/movie/27/70/277013_det.jpg
7153,The Lord of the Rings: The Return of the King,2003,lord_of_the_rings_the_return_of_the_king,8.6,239,225,14,94,8.6,43,42,1,97,3.7,288649,83,http://content7.flixster.com/movie/10/84/07/10840741_det.jpg
7154,Mona Lisa Smile,2003,mona_lisa_smile,4.9,147,51,96,34,5.2,41,18,23,43,3.1,23577,61,http://content9.flixster.com/movie/25/59/255923_det.jpg
7155,Calendar Girls,2003,calendar_girls,6.5,118,87,31,73,6.5,33,23,10,69,3.1,8453,59,http://content6.flixster.com/movie/10/90/15/10901532_det.jpg
7156,The Fog of War: Eleven Lessons from the Life of Robert S. McNamara,2003,fog_of_war,8.4,135,132,3,97,8.4,35,34,1,97,4.1,4231,92,http://content8.flixster.com/movie/10/93/01/10930110_det.jpg
7157,The Hebrew Hammer,2003,hebrew_hammer,5.1,23,12,11,52,4.8,12,6,6,50,3.2,1577,61,http://content7.flixster.com/movie/10/88/46/10884649_det.jpg
7158,House of Sand and Fog,2003,house_of_sand_and_fog,7.1,168,126,42,75,7.9,33,29,4,87,3.6,8761,81,http://content6.flixster.com/movie/10/91/80/10918068_det.jpg
7159,Two Men Went to War,2002,two_men_went_to_war,5.6,27,17,10,62,5.1,8,4,4,50,3.3,218,63,http://content7.flixster.com/movie/87/77/63/8777637_det.jpg
7160,Monster,2003,1128647-monster,7.2,182,149,33,81,7.4,37,33,4,89,3.5,17719,78,http://content9.flixster.com/movie/26/82/268215_det.jpg
7161,Cheaper by the Dozen,2003,cheaper_by_the_dozen,4.6,111,26,85,23,4.9,31,10,21,32,3.1,62198,65,http://content8.flixster.com/movie/10/92/26/10922674_det.jpg
7162,Cold Mountain,2003,cold_mountain,6.7,221,156,65,70,7.5,42,38,4,90,3.3,26002,74,http://content7.flixster.com/movie/26/72/267229_det.jpg
7163,Paycheck,2003,paycheck,4.7,151,42,109,27,4.5,31,4,27,12,2.9,19654,52,http://content7.flixster.com/movie/10/85/07/10850741_det.jpg
7164,Peter Pan,2003,1128577-peter_pan,6.8,132,100,32,75,6.3,33,23,10,69,3.3,47413,68,http://content7.flixster.com/movie/10/91/88/10918857_det.jpg
7165,The Company,2003,1128345-company,6.6,124,86,38,69,6.6,31,20,11,64,3,1840,43,http://content6.flixster.com/movie/10/85/24/10852432_det.jpg
7166,The Young Black Stallion,2003,young_black_stallion,5.4,39,17,22,43,5.7,14,7,7,50,3.6,930,72,http://content8.flixster.com/movie/25/20/252014_det.jpg
7167,Japanese Story,2003,japanese_story,6.4,89,60,29,67,6.5,30,21,9,70,3.5,1232,70,http://content9.flixster.com/movie/39/52/80/3952803_det.jpg
7168,Choses secr√®tes,2002,secret_things,5.6,49,24,25,48,5.3,19,8,11,42,3,168,40,http://content8.flixster.com/movie/10/86/67/10866742_det.jpg
7169,Chasing Liberty,2004,italians-in-america-our-contribution,0,0,0,0,0,0,0,0,0,0,0,0,0,http://content6.flixster.com/movie/10/87/20/10872044_det.jpg
7170,My Baby's Daddy,2004,my_babys_daddy,2.8,51,2,49,3,3.1,17,1,16,5,3.1,1999,57,http://content8.flixster.com/movie/26/67/266710_det.jpg
7171,Aileen: Life and Death of a Serial Killer,2003,aileen_the_life_and_death_of_a_serial_killer,7.1,57,49,8,85,7.3,20,18,2,90,3.5,1623,72,http://content7.flixster.com/movie/10/90/85/10908573_det.jpg
7172,Uzak,2002,distant,7.8,43,38,5,88,7.9,16,15,1,93,3.9,1453,82,http://content9.flixster.com/movie/10/92/04/10920463_det.jpg
7173,Along Came Polly,2004,along_came_polly,4.8,152,39,113,25,4.7,36,8,28,22,3.1,42224,54,http://content6.flixster.com/movie/10/89/41/10894152_det.jpg
7174,Teacher's Pet,2004,1129129-teachers_pet,6.5,72,54,18,75,6.7,25,19,6,76,2.8,370,38,http://content6.flixster.com/movie/41/61/80/4161808_det.jpg
7175,Torque,2004,1129132-torque,4.2,111,25,86,22,4.3,30,6,24,20,2.9,17598,55,http://content9.flixster.com/movie/55/35/33/5535335_det.jpg
7176,Talaye sorkh,2003,crimson_gold,7.5,73,63,10,86,8,25,24,1,96,3.7,506,77,http://content7.flixster.com/movie/10/88/01/10880149_det.jpg
7177,Osama,2003,osama,7.8,101,97,4,96,8,35,34,1,97,3.9,1868,86,http://content6.flixster.com/movie/25/95/259500_det.jpg
7178,The Great Gatsby,1974,1008799-great_gatsby,4.8,26,10,16,38,0,4,0,4,0,3.2,3750,56,http://content6.flixster.com/movie/25/49/254992_det.jpg
7179,Wuthering Heights,1939,1024192-wuthering_heights,7.9,16,16,0,100,0,1,1,0,100,3.9,2525,84,http://content7.flixster.com/movie/31/37/313797_det.jpg
7180,Odds Against Tomorrow,1959,odds_against_tomorrow,0,2,2,0,100,0,0,0,0,0,0,0,0,http://content6.flixster.com/movie/10/87/41/10874180_det.jpg
7181,Ship of Fools,1965,ship_of_fools,6.8,16,13,3,81,0,3,2,1,66,3.6,400,74,http://content6.flixster.com/movie/10/88/28/10882832_det.jpg
7182,Lord Love a Duck,1966,lord-love-a-duck,6.9,7,5,2,71,0,0,0,0,0,0,0,0,http://content7.flixster.com/movie/10/86/73/10867357_det.jpg
7183,There's a Girl in My Soup,1970,theres_a_girl_in_my_soup,0,2,1,1,50,0,0,0,0,0,0,0,0,http://content9.flixster.com/movie/10/89/73/10897339_det.jpg
7184,This Property Is Condemned,1966,this_property_is_condemned,5.5,14,9,5,64,0,3,2,1,66,3.8,780,75,http://content7.flixster.com/movie/28/65/286505_det.jpg
7185,What Doesn't Kill You,2008,what_doesnt_kill_you,6,32,21,11,65,6.3,10,8,2,80,3.1,2596,45,http://content8.flixster.com/movie/10/88/46/10884686_det.jpg
7186,Once Upon a Crime...,1992,once_upon_a_crime,3.7,6,0,6,0,0,0,0,0,0,0,0,0,http://content6.flixster.com/movie/10/84/64/10846412_det.jpg
7187,Beyond Therapy,1987,beyond_therapy,4.2,8,2,6,25,0,3,0,3,0,2.7,388,34,http://content9.flixster.com/movie/28/39/283907_det.jpg
7188,The General,1926,1008166-general,8.9,38,35,3,92,0,4,2,2,50,4.4,3785,93,http://content6.flixster.com/movie/10/84/02/10840232_det.jpg
7189,"Car 54, Where Are You?",1994,car_54_where_are_you,1.9,13,0,13,0,0,3,0,3,0,2.2,859,22,http://content9.flixster.com/movie/10/89/34/10893459_det.jpg
7190,Jane Eyre,2006,,\N,\N,\N,\N,\N,\N,\N,\N,\N,\N,\N,\N,\N,\N
7191,Blame It on the Bellboy,1992,blame_it_on_the_bellboy,2.4,9,1,8,11,0,0,0,0,0,0,0,0,http://content9.flixster.com/movie/26/54/265411_det.jpg
7192,Only the Strong,1993,only_the_strong,2.8,7,0,7,0,2.5,5,0,5,0,3.7,1259,79,http://content9.flixster.com/movie/10/86/99/10869927_det.jpg
7193,The Adventures of Ford Fairlane,1990,adventures_of_ford_fairlane,3.5,22,6,16,27,0,2,0,2,0,3.2,2144,66,http://content9.flixster.com/movie/10/91/49/10914999_det.jpg
7194,Bonjour tristesse,1958,bonjour_tristesse,6.7,13,11,2,84,0,3,1,2,33,3.6,458,67,http://content9.flixster.com/movie/30/34/303403_det.jpg
7195,The Enforcer,1976,1006646-enforcer,6.3,26,20,6,76,0,1,1,0,100,3.4,3350,61,http://content8.flixster.com/movie/27/65/276594_det.jpg
7196,X-Men,2000,xmen,7,152,124,28,81,5.8,32,19,13,59,3.7,133573,83,http://content7.flixster.com/movie/10/92/95/10929501_det.jpg
7197,Ransom,1996,1074298-ransom,6.4,30,21,9,70,5.7,7,4,3,57,3.1,10364,61,http://content9.flixster.com/movie/10/91/77/10917783_det.jpg
7198,The Pick-up Artist,1987,pickup_artist,5,20,11,9,55,5.2,6,3,3,50,2.8,1355,34,http://content7.flixster.com/movie/10/21/45/10214521_det.jpg
7199,Melvin Goes to Dinner,2003,melvin_goes_to_dinner,7.3,11,11,0,100,0,3,3,0,100,3.6,651,77,http://content9.flixster.com/movie/10/91/04/10910431_det.jpg
7200,The Court-Martial of Billy Mitchell,1955,the-courtmartial-of-billy-mitchell,7.4,5,5,0,100,0,1,1,0,100,3.5,225,60,http://content8.flixster.com/movie/11/13/81/11138194_det.jpg
7201,Crime Spree,2003,crime_spree,5.8,6,3,3,50,0,4,2,2,50,3.3,616,57,http://content9.flixster.com/movie/10/86/91/10869175_det.jpg
7202,Beyond Re-Animator,2003,beyond_reanimator,5.2,11,5,6,45,0,1,0,1,0,3,2279,42,http://content7.flixster.com/movie/10/93/47/10934781_det.jpg
7203,The Final Cut,2004,final_cut,5.4,75,29,46,38,4.9,26,8,18,30,3,4745,48,http://content7.flixster.com/movie/10/93/73/10937377_det.jpg
7204,Hells Angels on Wheels,1967,1009470-hells_angels_on_wheels,4.4,7,2,5,28,0,1,0,1,0,3,814,39,http://content9.flixster.com/movie/10/87/70/10877099_det.jpg
7205,The Wind and the Lion,1975,wind_and_the_lion,6,10,6,4,60,0,0,0,0,0,0,0,0,http://content8.flixster.com/movie/10/84/67/10846762_det.jpg
7206,Mon oncle,1958,mon_oncle,8.5,17,16,1,94,0,2,1,1,50,4.2,2439,89,http://content6.flixster.com/movie/11/15/03/11150364_det.jpg
7207,Where the Boys Are,1960,1023508-where_the_boys_are,0,4,3,1,75,0,0,0,0,0,0,0,0,http://content9.flixster.com/movie/11/13/77/11137731_det.jpg
7208,Dr. Jekyll and Mr. Hyde,2008,dr_jekyll_and_mr_hyde,0,1,0,1,0,0,0,0,0,0,0,0,0,http://content9.flixster.com/movie/11/12/32/11123215_det.jpg
7209,Les vacances de Monsieur Hulot,1953,mr_hulots_holiday,8.8,24,24,0,100,0,3,3,0,100,4,2052,86,http://content8.flixster.com/movie/29/38/293802_det.jpg
7210,My Darling Clementine,1946,my_darling_clementine,8.7,22,22,0,100,0,1,1,0,100,3.8,1741,83,http://content6.flixster.com/movie/10/36/01/10360144_det.jpg
7211,People Will Talk,1951,people_will_talk,0,4,4,0,100,0,0,0,0,0,0,0,0,http://content7.flixster.com/movie/29/14/291413_det.jpg
7212,I Was a Male War Bride,1949,i_was_a_male_war_bride,6.7,14,11,3,78,0,2,1,1,50,3.6,1412,71,http://content8.flixster.com/movie/29/37/293718_det.jpg
7213,Divorce American Style,1967,divorce_american_style,6.6,5,4,1,80,0,1,1,0,100,3.2,434,44,http://content9.flixster.com/movie/10/89/11/10891119_det.jpg
7214,Kiss Them for Me,1957,kiss_them_for_me,0,1,0,1,0,0,0,0,0,0,0,0,0,http://content9.flixster.com/movie/10/91/34/10913471_det.jpg
7215,To Have and Have Not,1944,to_have_and_have_not,8.1,21,21,0,100,0,3,3,0,100,4.1,3565,90,http://content8.flixster.com/movie/10/89/22/10892282_det.jpg
7216,High Sierra,1941,high_sierra,7.8,16,15,1,93,0,0,0,0,0,0,0,0,http://content9.flixster.com/movie/29/89/298903_det.jpg
7217,Dark Passage,1947,dark_passage,7.6,14,13,1,92,0,0,0,0,0,0,0,0,http://content6.flixster.com/movie/29/39/293912_det.jpg
7218,The Ox-Bow Incident,1943,oxbow_incident,8.1,17,16,1,94,0,0,0,0,0,0,0,0,http://content7.flixster.com/movie/10/85/60/10856077_det.jpg
7219,They Drive by Night,1940,1021214-they_drive_by_night,6.8,17,16,1,94,0,0,0,0,0,0,0,0,http://content6.flixster.com/movie/11/12/46/11124664_det.jpg
7220,Micki + Maude,1984,micki_and_maude,5.3,6,4,2,66,0,1,1,0,100,2.9,446,41,http://content9.flixster.com/movie/26/17/261715_det.jpg
7221,Platinum Blonde,1931,1038237-platinum_blonde,7.2,6,6,0,100,0,0,0,0,0,0,0,0,http://content6.flixster.com/movie/30/35/303596_det.jpg
7222,Tell Your Children,1936,reefer_madness,4.8,24,11,13,45,0,1,1,0,100,3,2726,45,http://content7.flixster.com/movie/10/94/74/10947481_det.jpg
7223,DOA: Dead or Alive,2006,doa_dead_or_alive,4.5,44,15,29,34,4.2,10,2,8,20,2.7,71044,43,http://content7.flixster.com/movie/10/93/50/10935009_det.jpg
7224,The Boy with Green Hair,1948,boy_with_green_hair,7.1,8,6,2,75,0,0,0,0,0,0,0,0,http://content9.flixster.com/movie/10/92/36/10923631_det.jpg
7225,Pumping Iron,1977,pumping_iron,7.3,23,22,1,95,0,4,4,0,100,0,0,0,http://content8.flixster.com/movie/53/81/47/5381478_det.jpg
7226,No Good Deed,2002,no_good_deed,4,10,2,8,20,4.3,5,1,4,20,2.9,933,34,http://content6.flixster.com/movie/28/04/280492_det.jpg
7227,The Trouble with Angels,1966,trouble_with_angels,0,4,4,0,100,0,0,0,0,0,0,0,0,http://content9.flixster.com/movie/10/91/88/10918867_det.jpg
7228,Cool World,1992,1040378-cool_world,3.2,31,2,29,6,0,4,0,4,0,2.6,8556,35,http://content7.flixster.com/movie/26/03/260309_det.jpg
7229,Money for Nothing,1993,money_for_nothing,0,4,1,3,25,0,1,0,1,0,2.8,839,31,http://content7.flixster.com/movie/10/88/31/10883197_det.jpg
7230,The Silencers,1966,1111123-silencers,0,1,0,1,0,0,0,0,0,0,0,0,0,http://content7.flixster.com/movie/30/28/302893_det.jpg
7231,Where Angels Go Trouble Follows!,1968,where_angels_go_trouble_follows,0,1,0,1,0,0,0,0,0,0,0,0,0,http://content8.flixster.com/movie/25/22/252202_det.jpg
7232,Heat and Dust,1983,heat_and_dust,0,4,4,0,100,0,1,1,0,100,3.5,237,54,http://content8.flixster.com/movie/10/88/45/10884570_det.jpg
7234,La strada,1954,la_strada,8.7,31,30,1,96,0,4,3,1,75,4.3,5992,94,http://content6.flixster.com/movie/10/93/75/10937560_det.jpg
7235,Koroshiya 1,2001,ichi_the_killer,6.1,35,22,13,62,4.2,8,2,6,25,3.9,12533,83,http://content8.flixster.com/movie/10/89/01/10890166_det.jpg
7236,A Boy and His Dog,1975,boy_and_his_dog,6.6,30,23,7,76,0,3,0,3,0,3.4,2758,62,http://content8.flixster.com/movie/26/99/269922_det.jpg
7237,The Last Tycoon,1976,last_tycoon,5.4,18,8,10,44,0,3,1,2,33,3.2,859,49,http://content7.flixster.com/movie/26/31/263101_det.jpg
7238,Popi√≥l i diament,1958,ashes_and_diamonds,8.4,8,7,1,87,0,0,0,0,0,0,0,0,http://content7.flixster.com/movie/10/92/31/10923137_det.jpg
7239,Marooned,1969,marooned,6.7,5,5,0,100,0,1,1,0,100,3,377,40,http://content9.flixster.com/movie/10/94/53/10945343_det.jpg
7240,King David,1985,king_david,3,8,1,7,12,0,0,0,0,0,0,0,0,http://content6.flixster.com/movie/25/82/258200_det.jpg
7241,Kanal,1957,kanal-1957,0,0,0,0,0,0,0,0,0,0,0,0,0,http://content8.flixster.com/movie/89/61/23/8961238_det.jpg
7242,Cat Chaser,1989,cat_chaser,4.8,5,2,3,40,0,0,0,0,0,0,0,0,http://content7.flixster.com/movie/10/87/19/10871905_det.jpg
7243,Intolerance: Love's Struggle Throughout the Ages,1916,1010644-intolerance,7.8,23,22,1,95,0,3,3,0,100,3.8,1397,77,http://content6.flixster.com/movie/31/14/311408_det.jpg
7244,The Beast of Yucca Flats,1961,beast_of_yucca_flats,0,3,0,3,0,0,0,0,0,0,0,0,0,http://content9.flixster.com/movie/10/91/67/10916719_det.jpg
7245,Hets,1944,1021711-torment,7,6,5,1,83,0,2,1,1,50,3.8,348,76,http://content8.flixster.com/movie/54/91/18/5491186_det.jpg
7247,Chitty Chitty Bang Bang,1968,chitty_chitty_bang_bang,5.4,22,13,9,59,0,2,2,0,100,3.2,18830,65,http://content6.flixster.com/movie/25/07/250720_det.jpg
7248,Suriyothai,2001,legend_of_suriyothai,5.6,58,31,27,53,5.3,19,8,11,42,3.4,414,60,http://content6.flixster.com/movie/10/87/98/10879860_det.jpg
7249,Plaza Suite,1971,plaza_suite,5.5,6,3,3,50,0,0,0,0,0,0,0,0,http://content9.flixster.com/movie/29/21/61/2921611_det.jpg
7250,The Out-of-Towners,1999,1087047-outoftowners,5,34,8,26,23,4.9,5,1,4,20,2.6,2186,33,http://content6.flixster.com/movie/26/24/262496_det.jpg
7251,Where the Day Takes You,1992,where_the_day_takes_you,5.6,5,3,2,60,0,1,1,0,100,3.6,904,72,http://content6.flixster.com/movie/10/89/34/10893460_det.jpg
7252,The Three Stooges in Orbit,1962,three_stooges_three_stooges_in_orbit,0,0,0,0,0,0,0,0,0,0,0,0,0,http://content6.flixster.com/movie/43/86/09/4386092_det.jpg
7253,It,1927,1010770-it,6.6,8,8,0,100,0,1,1,0,100,3.7,773,78,http://content8.flixster.com/movie/30/59/305902_det.jpg
7254,The Butterfly Effect,2004,butterfly_effect,4.8,166,55,111,33,3.8,34,6,28,17,3.6,109956,81,http://content8.flixster.com/movie/11/14/18/11141874_det.jpg
7255,Win a Date with Tad Hamilton!,2004,win_a_date_with_tad_hamilton,5.6,142,74,68,52,5.2,35,14,21,40,2.9,10675,48,http://content8.flixster.com/movie/56/19/50/5619502_det.jpg
7256,Touching the Void,2003,touching_the_void,8,136,127,9,93,7.6,37,34,3,91,4.1,3095,91,http://content9.flixster.com/movie/65/08/650851_det.jpg
7257,The Big Bounce,2004,big_bounce,4,132,21,111,15,3.8,35,4,31,11,2.5,3228,26,http://content8.flixster.com/movie/11/13/81/11138182_det.jpg
7258,The Perfect Score,2004,perfect_score,3.7,107,18,89,16,3.7,30,6,24,20,2.9,7659,50,http://content6.flixster.com/movie/26/19/261912_det.jpg
7259,You Got Served,2004,omarion-invitation-only,0,0,0,0,0,0,0,0,0,0,0,0,0,http://content7.flixster.com/movie/10/88/53/10885385_det.jpg
7260,Latter Days,2003,latter_days,5.4,46,20,26,43,5.4,16,7,9,43,4,3579,82,http://content7.flixster.com/movie/28/56/285629_det.jpg
7261,Barbershop 2: Back in Business,2004,barbershop_2_back_in_business,6.3,123,84,39,68,6.4,34,23,11,67,3.1,7601,58,http://content7.flixster.com/movie/10/86/73/10867301_det.jpg
7262,Catch That Kid,2004,catch_that_kid,3.8,84,9,75,10,3.7,27,2,25,7,3.1,5038,56,http://content7.flixster.com/movie/26/20/262093_det.jpg
7263,Miracle,2004,miracle,7,156,124,32,79,6.8,37,29,8,78,3.7,11958,88,http://content6.flixster.com/movie/25/36/253692_det.jpg
7264,Un couple √©patant,2002,un-couple-epatant-trilogy-two,0,0,0,0,0,0,0,0,0,0,0,0,0,http://content9.flixster.com/movie/11/12/45/11124563_det.jpg
7265,The Dreamers,2003,,6.2,154,93,61,60,6,39,20,19,51,3.7,12547,78,http://content9.flixster.com/movie/11/14/85/11148547_det.jpg
7266,The Lost Skeleton of Cadavra,2001,lost_skeleton_of_cadavra,5.9,68,36,32,52,6.1,19,11,8,57,3.9,1458,84,http://content9.flixster.com/movie/25/79/257915_det.jpg
7267,Who's the Man?,1993,whos_the_man,5.3,7,3,4,42,0,2,1,1,50,2.9,682,50,http://content9.flixster.com/movie/10/90/05/10900515_det.jpg
7269,Hangin' with the Homeboys,1991,hangin_with_the_homeboys,7.1,5,4,1,80,0,2,2,0,100,3.3,433,57,http://content6.flixster.com/movie/28/29/282908_det.jpg
7270,Sleep with Me,1994,sleep_with_me,4.6,12,2,10,16,0,3,0,3,0,3.2,521,48,http://content9.flixster.com/movie/10/89/25/10892563_det.jpg
7271,Just Between Friends,1986,just_between_friends,4.6,6,2,4,33,0,1,0,1,0,3,662,39,http://content7.flixster.com/movie/10/86/57/10865733_det.jpg
7272,Super Fly,1972,superfly,7.1,21,19,2,90,0,3,3,0,100,3.5,1082,70,http://content7.flixster.com/movie/10/88/24/10882477_det.jpg
7273,A Piece of the Action,1977,piece_of_the_action,0,1,1,0,100,0,0,0,0,0,0,0,0,http://content7.flixster.com/movie/25/84/258401_det.jpg
7274,Let's Do It Again,1953,lets-do-it-again-1953,0,0,0,0,0,0,0,0,0,0,0,0,0,http://content6.flixster.com/movie/10/90/53/10905336_det.jpg
7275,Uptown Saturday Night,1974,uptown_saturday_night,6.4,7,5,2,71,0,0,0,0,0,0,0,0,http://content6.flixster.com/movie/83/54/43/8354436_det.jpg
7276,Hell's Kitchen,1998,hells_kitchen,4.6,5,2,3,40,0,0,0,0,0,0,0,0,http://content8.flixster.com/movie/31/09/310918_det.jpg
7277,Presumed Innocent,1990,presumed_innocent,7.2,31,29,2,93,7.5,8,8,0,100,3.2,3836,60,http://content9.flixster.com/movie/27/17/271707_det.jpg
7278,Daddy and Them,2001,daddy_and_them,6.3,6,5,1,83,0,0,0,0,0,0,0,0,http://content7.flixster.com/movie/10/91/34/10913465_det.jpg
7279,The Wilby Conspiracy,1975,wilby_conspiracy,0,3,2,1,66,0,0,0,0,0,0,0,0,http://content8.flixster.com/movie/26/52/265202_det.jpg
7280,Blacula,1972,blacula,5.1,19,8,11,42,0,2,1,1,50,2.8,1108,42,http://content9.flixster.com/movie/95/83/95/9583951_det.jpg
7281,Scream Blacula Scream,1973,scream_blacula_scream,0,3,1,2,33,0,0,0,0,0,0,0,0,http://content7.flixster.com/movie/10/90/42/10904261_det.jpg
7282,Da Hip Hop Witch,2000,,\N,\N,\N,\N,\N,\N,\N,\N,\N,\N,\N,\N,\N,\N
7283,Swing Shift,1984,swing_shift,7.2,6,6,0,100,0,1,1,0,100,2.9,671,31,http://content8.flixster.com/movie/10/92/09/10920938_det.jpg
7284,Trespass,1992,trespass,6.1,22,15,7,68,5.5,6,3,3,50,3,1402,48,http://content8.flixster.com/movie/10/88/93/10889366_det.jpg
7285,Ocean's Thirteen,2007,oceans_thirteen,6.4,195,136,59,69,6,43,25,18,58,3.6,846364,74,http://content6.flixster.com/movie/46/92/23/4692232_det.jpg
7286,Simple Men,1992,simple_men,7.1,10,9,1,90,0,2,1,1,50,3.9,685,88,http://content7.flixster.com/movie/10/88/38/10883861_det.jpg
7288,Foolish Wives,1922,foolish-wives,9,7,7,0,100,0,0,0,0,0,0,0,0,http://content6.flixster.com/movie/10/93/43/10934300_det.jpg
7289,"Silent Night, Bloody Night",1974,silent_night_bloody_night,0,2,0,2,0,0,0,0,0,0,0,0,0,http://content6.flixster.com/movie/10/89/48/10894820_det.jpg
7290,The Sin of Harold Diddlebock,1947,sin_of_harold_diddlebock,6.7,9,8,1,88,0,2,2,0,100,3.3,264,54,http://content9.flixster.com/movie/30/52/305211_det.jpg
7291,Pontiac Moon,1994,across_the_moon,0,0,0,0,0,0,0,0,0,0,0,0,0,http://content7.flixster.com/movie/10/83/92/10839253_det.jpg
7292,Best Defense,1984,1002061-best_defense,0,4,0,4,0,0,1,0,1,0,2.4,1191,19,http://content7.flixster.com/movie/28/22/282201_det.jpg
7293,50 First Dates,2004,50_first_dates,5.4,172,76,96,44,5.3,38,18,20,47,3.4,217959,68,http://content6.flixster.com/movie/11/15/32/11153208_det.jpg
7294,Welcome to Mooseport,2004,welcome_to_mooseport,4.2,144,19,125,13,4.3,38,6,32,15,2.5,2414,24,http://content9.flixster.com/movie/10/88/38/10883899_det.jpg
7295,Apr√®s la vie,2002,after_the_life,7.2,33,31,2,93,7.7,12,12,0,100,3.8,54,75,http://content8.flixster.com/movie/10/91/82/10918298_det.jpg
7297,Salmer fra kj√∏kkenet,2003,kitchen_stories,7.3,75,67,8,89,7.1,25,24,1,96,4,1308,86,http://content9.flixster.com/movie/11/14/69/11146991_det.jpg
7298,La mentale,2002,the-code,0,0,0,0,0,0,0,0,0,0,0,0,0,http://content7.flixster.com/movie/10/88/66/10886657_det.jpg
7299,Monsieur Ibrahim et les fleurs du Coran,2003,monsieur_ibrahim,7,80,68,12,85,7.4,25,24,1,96,3.9,1791,85,http://content9.flixster.com/movie/27/12/271223_det.jpg
7300,Vanishing Point,1971,1022504-vanishing_point,6.3,16,12,4,75,0,4,2,2,50,3.9,4207,81,http://content6.flixster.com/movie/39/92/06/3992060_det.jpg
7301,Journal d'un cur√© de campagne,1951,diary_of_a_country_priest,8.3,17,15,2,88,0,2,1,1,50,4.1,1108,88,http://content9.flixster.com/movie/30/01/300103_det.jpg
7302,The Thief of Bagdad,1924,1028714-thief_of_bagdad,8.1,13,13,0,100,0,1,1,0,100,3.6,655,75,http://content9.flixster.com/movie/15/52/58/1552587_det.jpg
7303,The Diary of Anne Frank,1959,diary_of_anne_frank,6.8,15,11,4,73,0,2,1,1,50,3.5,6344,74,http://content7.flixster.com/movie/10/87/14/10871409_det.jpg
7304,Allegro non troppo,1976,allegro-non-troppo,7.3,17,15,2,88,0,1,1,0,100,3.8,1302,81,http://content7.flixster.com/movie/26/03/260317_det.jpg
7305,Black Widow,2008,10010172-black_widow,0,1,0,1,0,0,0,0,0,0,0,0,0,http://content6.flixster.com/movie/10/91/44/10914472_det.jpg
7306,La ley de Herodes,1999,la_ley_de_herodes,6.4,25,17,8,68,6.3,10,7,3,70,4,575,88,http://content9.flixster.com/movie/10/93/75/10937595_det.jpg
7307,Flesh+Blood,1985,1007538-flesh_and_blood,6,8,6,2,75,0,0,0,0,0,0,0,0,http://content7.flixster.com/movie/31/89/92/3189929_det.jpg
7308,King Solomon's Mines,1950,1011638-king_solomons_mines,7.4,11,10,1,90,0,0,0,0,0,0,0,0,http://content6.flixster.com/movie/10/83/82/10838236_det.jpg
7309,The Black Pirate,1926,1002511-black_pirate,8.1,7,7,0,100,0,0,0,0,0,0,0,0,http://content8.flixster.com/movie/10/91/91/10919126_det.jpg
7310,Raw Deal,1986,1017226-raw_deal,3.8,12,3,9,25,0,1,0,1,0,2.7,3041,32,http://content7.flixster.com/movie/10/87/80/10878017_det.jpg
7311,"Goodbye, Mr. Chips",1939,1008627-goodbye_mr_chips,7.8,16,13,3,81,0,0,0,0,0,0,0,0,http://content7.flixster.com/movie/10/21/99/10219993_det.jpg
7312,"Follow Me, Boys!",1966,follow_me_boys,0,0,0,0,0,0,0,0,0,0,0,0,0,http://content7.flixster.com/movie/25/09/250997_det.jpg
7313,Fire Birds,1990,fire_birds,3.1,15,1,14,6,0,4,0,4,0,2.9,1449,41,http://content7.flixster.com/movie/10/92/06/10920617_det.jpg
7314,Robot Stories,2003,robot_stories,6.6,42,30,12,71,6.6,15,11,4,73,3.1,471,51,http://content8.flixster.com/movie/30/42/304210_det.jpg
7315,Against the Ropes,2004,against_the_ropes,4.2,131,16,115,12,4.3,34,6,28,17,2.8,1809,35,http://content8.flixster.com/movie/10/89/25/10892502_det.jpg
7316,Confessions of a Teenage Drama Queen,2004,confessions_of_a_teenage_drama_queen,3.8,88,11,77,12,3.8,25,3,22,12,2.7,33054,48,http://content9.flixster.com/movie/10/88/02/10880251_det.jpg
7317,EuroTrip,2004,the-trip-2005,0,0,0,0,0,0,0,0,0,0,0,0,0,http://content9.flixster.com/movie/10/88/69/10886911_det.jpg
7318,The Passion of the Christ,2004,passion_of_the_christ,5.8,262,130,132,49,4.9,47,17,30,36,3.7,51559,84,http://content6.flixster.com/movie/11/13/50/11135040_det.jpg
7319,Club Dread,2004,club-dread,4.4,98,29,69,29,4.3,26,7,19,26,2.7,7120,45,http://content8.flixster.com/movie/10/89/98/10899802_det.jpg
7320,Dirty Dancing: Havana Nights,2004,havana_nights,4.3,105,24,81,22,3.7,34,4,30,11,3.2,46963,71,http://content7.flixster.com/movie/10/91/46/10914657_det.jpg
7321,Twisted,2004,twisted,2.9,132,2,130,1,3.2,36,0,36,0,2.8,2961,40,http://content6.flixster.com/movie/27/63/276304_det.jpg
7322,Alila,2003,alila,5.3,17,7,10,41,5.2,6,2,4,33,3,221,40,http://content6.flixster.com/movie/30/84/308400_det.jpg
7323,Good Bye Lenin!,2003,good_bye_lenin,7.4,105,94,11,89,6.6,28,23,5,82,4,16904,91,http://content7.flixster.com/movie/26/78/267825_det.jpg
7324,Hidalgo,2004,hidalgo,5.6,157,73,84,46,5.5,36,16,20,44,3.2,13730,70,http://content8.flixster.com/movie/25/47/254706_det.jpg
7325,Starsky & Hutch,2004,starsky_and_hutch,6,188,120,68,63,6,41,28,13,68,3,28412,54,http://content9.flixster.com/movie/55/05/01/5505011_det.jpg
7326,The Reckoning,2003,1130191-reckoning,5.6,85,34,51,40,5.5,28,12,16,42,3.3,1019,60,http://content8.flixster.com/movie/10/66/09/10660990_det.jpg
7327,Persona,1966,persona,8.6,29,27,2,93,0,4,3,1,75,4.4,7552,94,http://content6.flixster.com/movie/58/28/49/5828496_det.jpg
7328,En passion,1969,passion_of_anna,8.2,11,11,0,100,0,2,2,0,100,4,746,85,http://content8.flixster.com/movie/10/91/30/10913030_det.jpg
7329,Walk on the Wild Side,1962,walk_on_the_wild_side,0,4,2,2,50,0,0,0,0,0,0,0,0,http://content6.flixster.com/movie/29/74/297416_det.jpg
7330,Tokyo Joe,1949,tokyo_joe,0,3,2,1,66,0,0,0,0,0,0,0,0,http://content7.flixster.com/movie/10/28/51/10285145_det.png
7331,The Serpent's Egg,1977,serpents_egg,4.5,12,3,9,25,0,4,0,4,0,3.3,729,58,http://content6.flixster.com/movie/28/27/282728_det.jpg
7332,Fire Down Below,1997,1078038-fire_down_below,3.3,26,3,23,11,3.3,7,1,6,14,2.6,3327,48,http://content9.flixster.com/movie/27/36/273603_det.jpg
7333,Le corbeau,1943,le_corbeau,7.7,23,20,3,86,0,3,1,2,33,4,807,90,http://content6.flixster.com/movie/10/88/73/10887304_det.jpg
7334,All Quiet on the Western Front,1930,1000642-all_quiet_on_the_western_front,8.6,32,31,1,96,7.8,5,5,0,100,3.8,3797,85,http://content6.flixster.com/movie/66/23/12/6623120_det.jpg
7335,Pickup on South Street,1953,pickup_on_south_street,7.6,25,22,3,88,0,3,1,2,33,4,1058,89,http://content9.flixster.com/movie/10/87/74/10877487_det.jpg
7336,La caduta degli dei,1969,1005155-damned,8.1,10,9,1,90,0,1,1,0,100,4,255,82,http://content8.flixster.com/movie/10/89/58/10895846_det.jpg
7337,American Gun,2005,american_gun,5.3,30,11,19,36,5,12,4,8,33,3.2,1027,49,http://content7.flixster.com/movie/10/84/16/10841697_det.jpg
7338,Richard III,1995,1068177-richard_iii,8.1,43,41,2,95,7.6,11,10,1,90,3.7,1552,82,http://content7.flixster.com/movie/26/89/268909_det.jpg
7339,Quartet,1981,1016958-quartet,0,2,0,2,0,0,0,0,0,0,0,0,0,http://content8.flixster.com/movie/27/93/279306_det.jpg
7340,Just One of the Guys,1985,just_one_of_the_guys,4.6,10,4,6,40,0,2,0,2,0,3.3,2022,66,http://content9.flixster.com/movie/10/83/87/10838715_det.jpg
7341,The Chase,1966,1003957-chase,6.5,5,4,1,80,0,0,0,0,0,0,0,0,http://content7.flixster.com/movie/28/84/288413_det.jpg
7342,The Last Kiss,2006,last_kiss,5.7,124,57,67,45,6,31,15,16,48,3.2,37077,59,http://content8.flixster.com/movie/10/88/16/10881610_det.jpg
7343,Wisconsin Death Trip,1999,wisconsin_death_trip,6.4,11,9,2,81,0,3,2,1,66,3.5,346,66,http://content8.flixster.com/movie/10/83/94/10839438_det.jpg
7344,The Wrong Arm of the Law,1963,wrong_arm_of_the_law,0,0,0,0,0,0,0,0,0,0,0,0,0,http://content9.flixster.com/movie/28/77/287707_det.jpg
7345,Agent Cody Banks 2: Destination London,2004,agent_cody_banks_2_destination_london,3.4,91,11,80,12,3.9,24,4,20,16,2.5,13037,41,http://content8.flixster.com/movie/10/87/57/10875718_det.jpg
7346,The Girl Next Door,2004,1130343-girl_next_door,5.6,156,87,69,55,5,32,17,15,53,3.3,39311,71,http://content9.flixster.com/movie/11/12/56/11125663_det.jpg
7347,Secret Window,2004,secret_window,5.5,158,73,85,46,5.5,37,18,19,48,3.3,56932,69,http://content8.flixster.com/movie/10/88/16/10881658_det.jpg
7348,Spartan,2004,spartan,6.5,131,84,47,64,6.3,41,22,19,53,3.3,3343,61,http://content9.flixster.com/movie/10/83/91/10839155_det.jpg
7349,Knafayim Shvurot,2002,broken-wings,7.3,67,62,5,92,7.4,22,21,1,95,4,613,87,http://content6.flixster.com/movie/27/74/277492_det.jpg
7351,How to Draw a Bunny,2002,how_to_draw_a_bunny,7,27,22,5,81,6.6,8,6,2,75,3.9,404,81,http://content6.flixster.com/movie/11/14/27/11142764_det.jpg
7352,Wilbur Wants to Kill Himself,2002,wilbur_wants_to_kill_himself,7.1,78,67,11,85,6.8,26,20,6,76,3.5,1296,69,http://content7.flixster.com/movie/28/09/280901_det.jpg
7353,Clifford's Really Big Movie,2004,cliffords_really_big_movie,5.6,31,16,15,51,5.6,12,6,6,50,3,524,41,http://content8.flixster.com/movie/10/94/34/10943454_det.jpg
7354,Mad Dog and Glory,1993,mad_dog_and_glory,6.2,26,20,6,76,6.2,6,4,2,66,3,2359,41,http://content8.flixster.com/movie/11/12/32/11123274_det.jpg
7355,The Wind in the Willows,1996,mr_toads_wild_ride,6.9,8,6,2,75,0,0,0,0,0,0,0,0,http://content8.flixster.com/movie/10/94/89/10948990_det.jpg
7356,Night Crossing,1981,night_crossing,0,3,3,0,100,0,0,0,0,0,0,0,0,http://content8.flixster.com/movie/26/00/260006_det.jpg
7357,Peyton Place,1957,peyton_place,6.1,9,5,4,55,0,0,0,0,0,0,0,0,http://content7.flixster.com/movie/11/14/20/11142073_det.jpg
7358,Searching for Debra Winger,2002,searching_for_debra_winger,0,4,3,1,75,0,1,1,0,100,3.2,487,50,http://content9.flixster.com/movie/27/96/279611_det.jpg
7359,Walk Like a Man,1987,walk_like_a_man,0,1,0,1,0,0,0,0,0,0,0,0,0,http://content6.flixster.com/movie/10/61/43/10614376_det.jpg
7360,Dawn of the Dead,2004,dawn_of_the_dead,6.7,171,130,41,76,6.1,32,20,12,62,3.4,49706,75,http://content8.flixster.com/movie/28/60/286018_det.jpg
7361,Eternal Sunshine of the Spotless Mind,2004,eternal_sunshine_of_the_spotless_mind,8.3,216,200,16,92,7.9,42,38,4,90,4,177263,93,http://content8.flixster.com/movie/55/05/71/5505718_det.jpg
7362,Taking Lives,2004,taking_lives,4.6,155,35,120,22,4.7,37,10,27,27,3.2,13988,63,http://content7.flixster.com/movie/10/88/88/10888813_det.jpg
7364,Intermission,2003,intermission,6.6,96,70,26,72,6.8,28,21,7,75,3.6,2948,76,http://content7.flixster.com/movie/10/37/24/10372401_det.jpg
7365,N√≥i alb√≠n√≥i,2003,noi-the-albino,7,53,46,7,86,6.4,15,12,3,80,3.9,1758,85,http://content8.flixster.com/movie/10/92/73/10927342_det.jpg
7366,Jersey Girl,2004,jersey_girl,5.3,169,69,100,40,4.7,38,12,26,31,2.9,16772,52,http://content8.flixster.com/movie/10/86/10/10861010_det.jpg
7367,The Ladykillers,2004,ladykillers,6.1,185,101,84,54,5.8,39,18,21,46,2.8,12107,40,http://content8.flixster.com/movie/11/14/68/11146886_det.jpg
7368,Never Die Alone,2004,never_die_alone,4.1,89,23,66,25,4.3,28,8,20,28,3.3,2511,65,http://content7.flixster.com/movie/27/68/276825_det.jpg
7369,Scooby Doo 2: Monsters Unleashed,2004,scoobydoo-2-monsters-unleashed,4.2,111,24,87,21,3.6,25,3,22,12,2.7,15310,57,http://content7.flixster.com/movie/55/35/68/5535689_det.jpg
7370,A Foreign Affair,1948,foreign_affair,7.6,9,9,0,100,0,2,2,0,100,3.7,504,75,http://content7.flixster.com/movie/10/73/93/10739337_det.jpg
7371,Dogville,2003,dogville,6.9,152,106,46,69,6.8,40,28,12,70,4,17210,88,http://content8.flixster.com/movie/26/94/269402_det.jpg
7372,Ned Kelly,2003,1131148-ned_kelly,5.7,54,30,24,55,5.2,15,4,11,26,3.2,7741,60,http://content7.flixster.com/movie/10/87/79/10877989_det.jpg
7373,Hellboy,2004,hellboy,6.8,195,157,38,80,6.8,38,33,5,86,3.2,65444,63,http://content9.flixster.com/movie/25/60/256011_det.jpg
7374,Home on the Range,2004,home_on_the_range,5.7,120,65,55,54,5.3,30,11,19,36,2.8,4447,44,http://content7.flixster.com/movie/10/86/92/10869241_det.jpg
7375,The Prince & Me,2004,prince_and_me,4.8,118,33,85,27,4.5,32,7,25,21,3.1,29626,67,http://content7.flixster.com/movie/25/68/256805_det.jpg
7376,Walking Tall,2004,walking_tall,4.4,130,32,98,24,4.6,34,7,27,20,3.2,20192,71,http://content6.flixster.com/movie/11/14/56/11145672_det.jpg
7377,The United States of Leland,2003,united_states_of_leland,4.9,87,29,58,33,4.5,27,7,20,25,3.8,6163,83,http://content7.flixster.com/movie/26/99/269913_det.jpg
7379,The Alamo,2004,general-santa-ana,0,0,0,0,0,0,0,0,0,0,0,0,0,http://content7.flixster.com/movie/10/84/54/10845441_det.jpg
7380,Ella Enchanted,2004,ella_enchanted,5.6,113,56,57,49,5.7,30,14,16,46,3.1,50156,62,http://content9.flixster.com/movie/10/87/94/10879427_det.jpg
7381,The Whole Ten Yards,2004,whole_ten_yards,2.8,116,5,111,4,3.3,31,2,29,6,3,11437,51,http://content8.flixster.com/movie/55/37/07/5537078_det.jpg
7382,Io non ho paura,2003,im_not_scared,7.5,98,88,10,89,7.3,32,28,4,87,3.9,1989,87,http://content8.flixster.com/movie/10/92/26/10922602_det.jpg
7383,Shade,2003,shade,5.8,15,10,5,66,0,3,2,1,66,3.3,1382,60,http://content9.flixster.com/movie/27/32/273295_det.jpg
7384,Depuis qu'Otar est parti...,2003,since_otar_left,7.9,55,54,1,98,8.1,20,20,0,100,4,492,84,http://content7.flixster.com/movie/10/87/31/10873101_det.jpg
7385,Twentynine Palms,2003,twentynine_palms,4.9,36,16,20,44,4.6,13,4,9,30,2.8,474,44,http://content9.flixster.com/movie/10/92/74/10927467_det.jpg
7386,The Ten Commandments,1956,1021015-ten_commandments,7.3,29,26,3,89,0,4,2,2,50,3.6,11440,83,http://content9.flixster.com/movie/25/22/252211_det.jpg
7387,Dawn of the Dead,2004,dawn_of_the_dead,6.7,171,130,41,76,6.1,32,20,12,62,3.4,49706,75,http://content8.flixster.com/movie/28/60/286018_det.jpg
7388,"Fratello sole, sorella luna",1972,brother_sun_sister_moon,5.6,8,5,3,62,0,1,0,1,0,3.8,742,77,http://content6.flixster.com/movie/25/56/255620_det.jpg
7389,One Million Years B.C.,1966,one_million_years_bc,5.5,6,3,3,50,0,0,0,0,0,0,0,0,http://content8.flixster.com/movie/29/45/294526_det.jpg
7390,Prey for Rock & Roll,2003,prey_for_rock_and_roll,5.8,46,26,20,56,6.3,14,10,4,71,3.4,876,66,http://content8.flixster.com/movie/10/89/95/10899534_det.jpg
7391,"Mother, Jugs & Speed",1976,mother_jugs_and_speed,5.4,13,7,6,53,0,2,1,1,50,0,0,0,http://content9.flixster.com/movie/10/86/57/10865743_det.jpg
7392,Bandolero!,1968,bandolero2004,0,0,0,0,0,0,0,0,0,0,0,0,0,http://content7.flixster.com/movie/10/85/14/10851477_det.jpg
7393,The Slugger's Wife,1985,sluggers_wife,3.3,8,0,8,0,0,2,0,2,0,2.8,189,24,http://content8.flixster.com/movie/26/68/266814_det.jpg
7394,Those Magnificent Men in Their Flying Machines or How I Flew from London to Paris in 25 hours 11 minutes,1965,those_magnificent_men_in_their_flying_machines,5.8,6,4,2,66,0,0,0,0,0,0,0,0,http://content6.flixster.com/movie/10/86/96/10869664_det.jpg
7395,Cheaper by the Dozen,2003,cheaper_by_the_dozen,4.6,111,26,85,23,4.9,31,10,21,32,3.1,62198,65,http://content8.flixster.com/movie/10/92/26/10922674_det.jpg
7396,Scener ur ett √§ktenskap,1973,scenes_from_a_marriage,8.5,16,15,1,93,0,3,2,1,66,4.4,2761,93,http://content8.flixster.com/movie/13/62/69/1362698_det.jpg
7397,Baby the Rain Must Fall,1965,baby_the_rain_must_fall,0,3,3,0,100,0,0,0,0,0,0,0,0,http://content8.flixster.com/movie/52/87/83/5287834_det.jpg
7398,Belles on Their Toes,1952,belles_on_their_toes,0,1,1,0,100,0,0,0,0,0,0,0,0,http://content7.flixster.com/movie/10/90/86/10908629_det.jpg
7399,Ned Kelly,2003,1131148-ned_kelly,5.7,54,30,24,55,5.2,15,4,11,26,3.2,7741,60,http://content7.flixster.com/movie/10/87/79/10877989_det.jpg
7401,Mac and Me,1988,mac_and_me,2.4,14,0,14,0,0,2,0,2,0,2.7,2264,43,http://content7.flixster.com/movie/26/08/260893_det.jpg
7402,The Food of the Gods,1976,the-food-of-the-gods,3.6,14,3,11,21,0,1,0,1,0,2.8,401,31,http://content8.flixster.com/movie/10/95/72/10957290_det.jpg
7403,Food of the Gods II,1989,,\N,\N,\N,\N,\N,\N,\N,\N,\N,\N,\N,\N,\N,\N
7404,Miracle at St. Anna,2008,miracle_at_st_anna,5.2,113,38,75,33,4.8,32,8,24,25,3.3,8435,56,http://content7.flixster.com/movie/10/91/95/10919533_det.jpg
7405,Road to Bali,1952,road_to_bali,0,4,2,2,50,0,0,0,0,0,0,0,0,http://content8.flixster.com/movie/10/87/41/10874166_det.jpg
7406,The Flying Deuces,1939,flying_deuces,6,6,5,1,83,0,0,0,0,0,0,0,0,http://content7.flixster.com/movie/10/89/28/10892893_det.jpg
7407,Africa Screams,1949,africa_screams,0,4,2,2,50,0,0,0,0,0,0,0,0,http://content9.flixster.com/movie/10/87/38/10873863_det.jpg
7408,Jack and the Beanstalk: The Real Story,2001,1112265-jack_and_the_beanstalk,0,3,1,2,33,0,0,0,0,0,0,0,0,http://content8.flixster.com/movie/10/94/55/10945578_det.jpg
7409,Shu dan long wei,1995,1080128-high_risk,0,3,2,1,66,0,1,1,0,100,0,0,0,http://content6.flixster.com/movie/28/24/282496_det.jpg
7410,The Osterman Weekend,1983,osterman_weekend,5.5,14,6,8,42,0,3,0,3,0,3,724,40,http://content6.flixster.com/movie/27/86/278616_det.jpg
7411,Harold & Kumar Go to White Castle,2004,harold_and_kumar_go_to_white_castle,6.5,144,106,38,73,6.7,30,22,8,73,3.5,61100,79,http://content7.flixster.com/movie/11/14/72/11147225_det.jpg
7413,Hangman's Curse,2003,hangmans_curse,2.9,6,0,6,0,0,2,0,2,0,3.7,1853,77,http://content6.flixster.com/movie/26/05/260524_det.jpg
7414,Going in Style,1979,going_in_style,0,4,4,0,100,0,0,0,0,0,0,0,0,http://content7.flixster.com/movie/26/52/265293_det.jpg
7415,Late Show with David Letterman,1993,,\N,\N,\N,\N,\N,\N,\N,\N,\N,\N,\N,\N,\N,\N
7416,The Sunshine Boys,1975,1020488-sunshine_boys,7.1,15,14,1,93,0,0,0,0,0,0,0,0,http://content9.flixster.com/movie/10/26/06/10260671_det.jpg
7417,Jersey Girl,2004,jersey_girl,5.3,169,69,100,40,4.7,38,12,26,31,2.9,16772,52,http://content8.flixster.com/movie/10/86/10/10861010_det.jpg
7418,American Nightmare,2002,american-nightmare2002,0,0,0,0,0,0,0,0,0,0,0,0,0,http://content8.flixster.com/movie/10/89/70/10897070_det.jpg
7419,After Hours,1985,1032180-after_hours,7.8,37,34,3,91,6.7,5,4,1,80,3.8,5298,85,http://content8.flixster.com/movie/11/12/70/11127022_det.jpg
7420,Viva Las Vegas,1964,viva_las_vegas,6.6,22,18,4,81,0,3,3,0,100,3.4,1800,71,http://content8.flixster.com/movie/11/13/70/11137034_det.jpg
7437,Connie and Carla,2004,connie_and_carla,5.1,119,52,67,43,5.3,32,17,15,53,3.4,3049,66,http://content7.flixster.com/movie/25/89/258917_det.jpg
7438,Kill Bill: Vol. 2,2004,kill_bill_vol_2,7.7,226,193,33,85,7.7,43,35,8,81,3.8,162324,87,http://content9.flixster.com/movie/26/69/266911_det.jpg
7439,Punisher: War Zone,2008,punisher_war_zone,4.2,96,25,71,26,3.7,21,1,20,4,3,29393,47,http://content6.flixster.com/movie/10/88/11/10881196_det.jpg
7440,Paper Clips,2004,paperclips,6.3,52,37,15,71,6.8,16,13,3,81,3.8,723,75,http://content6.flixster.com/movie/10/94/38/10943860_det.jpg
7441,"Mil nubes de paz cercan el cielo, amor, jam√°s acabar√°s de ser amor",2003,thousand_cloud_of_peace,4.6,26,8,18,30,3.7,10,2,8,20,3.2,105,48,http://content8.flixster.com/movie/10/89/50/10895002_det.jpg
7442,Young Adam,2003,young_adam,6.3,116,72,44,62,6.4,32,20,12,62,3.1,2330,48,http://content9.flixster.com/movie/11/12/33/11123335_det.jpg
7444,13 Going on 30,2004,13_going_on_30,6.2,161,104,57,64,6.6,35,26,9,74,3.3,96034,70,http://content6.flixster.com/movie/10/93/55/10935508_det.jpg
7445,Man on Fire,2004,man_on_fire,5.2,157,61,96,38,5.1,38,14,24,36,3.9,67139,89,http://content7.flixster.com/movie/10/87/18/10871825_det.jpg
7446,Clifford's Really Big Movie,2004,cliffords_really_big_movie,5.6,31,16,15,51,5.6,12,6,6,50,3,524,41,http://content8.flixster.com/movie/10/94/34/10943454_det.jpg
7447,MC5*: A True Testimonial,2002,mc5-a-true-testimonial,7.2,15,14,1,93,7,7,6,1,85,4.5,88,96,http://content9.flixster.com/movie/10/92/41/10924131_det.jpg
7448,Envy,2004,1131155-envy,3.1,114,8,106,7,2.9,33,0,33,0,2.5,7245,33,http://content7.flixster.com/movie/11/13/01/11130109_det.jpg
7449,Godsend,2004,godsend,3.4,135,6,129,4,3.3,35,1,34,2,2.5,5199,29,http://content8.flixster.com/movie/26/21/262110_det.jpg
7450,Laws of Attraction,2004,laws_of_attraction,4.5,143,26,117,18,4.4,39,7,32,17,2.9,5210,49,http://content7.flixster.com/movie/55/35/42/5535421_det.jpg
7451,Mean Girls,2004,mean_girls,6.9,170,141,29,82,6.6,40,31,9,77,3,245101,66,http://content8.flixster.com/movie/16/90/40/1690402_det.jpg
7452,The Wrestler,2008,the_wrestler,8.3,207,202,5,97,8.2,37,36,1,97,3.9,57550,86,http://content6.flixster.com/movie/10/87/76/10877628_det.jpg
7453,New York Minute,2004,new_york_minute,3.5,115,13,102,11,3.7,31,4,27,12,3,18023,57,http://content7.flixster.com/movie/55/35/17/5535177_det.jpg
7454,Van Helsing,2004,unhuman,0,0,0,0,0,0,0,0,0,0,0,0,0,http://content8.flixster.com/movie/10/84/54/10845422_det.jpg
7455,The Mudge Boy,2003,mudge_boy,6.4,26,20,6,76,6.4,13,10,3,76,3.7,728,73,http://content8.flixster.com/movie/43/59/19/4359190_det.jpg
7456,My Bloody Valentine,2009,my_bloody_valentine_3_d,5.7,85,48,37,56,5.2,8,3,5,37,3.1,111307,49,http://content8.flixster.com/movie/10/92/60/10926074_det.jpg
7457,Breakin' All the Rules,2004,breakin_all_the_rules,4.8,86,28,58,32,5,28,11,17,39,3.3,2699,64,http://content6.flixster.com/movie/25/88/258804_det.jpg
7458,Troy,2004,troy,6,216,118,98,54,6.2,43,28,15,65,3.5,148904,74,http://content9.flixster.com/movie/29/80/42/2980427_det.jpg
7459,Carandiru,2003,carandiru,6.6,77,53,24,68,7.4,29,25,4,86,3.9,2413,83,http://content7.flixster.com/movie/27/18/271817_det.jpg
7460,Coffee and Cigarettes,2003,coffee_and_cigarettes,6.2,118,75,43,63,6.2,36,25,11,69,3.5,10991,75,http://content6.flixster.com/movie/99/21/85/9921852_det.jpg
7461,Les √©gar√©s,2003,strayed,6.6,58,43,15,74,6.8,21,16,5,76,3.5,542,61,http://content8.flixster.com/movie/28/69/286906_det.jpg
7474,The Boys in the Band,1970,boys_in_the_band,7.1,15,15,0,100,0,0,0,0,0,0,0,0,http://content8.flixster.com/movie/10/86/48/10864834_det.jpg
7478,Swimming to Cambodia,1987,swimming-to-cambodia,7.8,8,8,0,100,0,1,1,0,100,4.1,390,92,http://content8.flixster.com/movie/28/70/287018_det.jpg
7479,Watch on the Rhine,1943,watch_on_the_rhine,0,2,1,1,50,0,0,0,0,0,0,0,0,http://content9.flixster.com/movie/63/06/01/6306011_det.jpg
7480,Courage Under Fire,1996,courage_under_fire,7.3,52,44,8,84,7.8,15,14,1,93,3.2,6918,61,http://content8.flixster.com/movie/10/91/78/10917802_det.jpg
7481,Enemy Mine,1985,enemy_mine,5.7,22,13,9,59,0,1,0,1,0,3.3,3733,69,http://content7.flixster.com/movie/25/72/257225_det.jpg
7482,Enter the Dragon,1973,dragon-since-1973,0,0,0,0,0,0,0,0,0,0,0,0,0,http://content9.flixster.com/movie/10/84/62/10846223_det.jpg
7483,Terra Estrangeira,1996,foreign_land,0,2,1,1,50,0,0,0,0,0,0,0,0,http://content7.flixster.com/movie/30/01/300117_det.jpg
7484,Gimme Shelter,1970,gimme_shelter,9.1,20,20,0,100,0,2,2,0,100,4,1625,90,http://content6.flixster.com/movie/10/88/57/10885780_det.jpg
7485,Ohay√¥,1959,good_morning,8.1,11,9,2,81,0,1,0,1,0,4,948,87,http://content6.flixster.com/movie/10/85/89/10858944_det.jpg
7486,Chun gwong cha sit,1997,1083093-happy_together,7.1,31,24,7,77,7.1,9,7,2,77,4.1,4907,90,http://content8.flixster.com/movie/10/88/85/10888530_det.jpg
7487,Henry & June,1990,henry_and_june,6,14,9,5,64,0,1,1,0,100,3.5,2170,67,http://content6.flixster.com/movie/28/56/285600_det.jpg
7488,Berkeley in the Sixties,1990,berkeley_in_the_sixties,8.1,5,5,0,100,0,1,1,0,100,3.8,195,74,http://content9.flixster.com/movie/29/75/297515_det.jpg
7489,Das schreckliche M√§dchen,1990,nasty_girl,7.6,5,3,2,60,0,1,0,1,0,3.6,464,71,http://content6.flixster.com/movie/10/13/40/10134052_det.jpg
7490,At First Sight,1999,1084607-at_first_sight,5.2,36,12,24,33,5.4,6,1,5,16,2.9,2600,48,http://content9.flixster.com/movie/10/88/64/10886407_det.jpg
7491,The Naked Prey,1966,naked_prey,6.8,11,9,2,81,0,1,0,1,0,3.8,541,80,http://content9.flixster.com/movie/11/14/76/11147679_det.jpg
7492,A Personal Journey with Martin Scorsese Through American Movies,1995,personal_journey_with_martin_scorsese_through_american_movies,8.5,10,10,0,100,0,0,0,0,0,0,0,0,http://content6.flixster.com/movie/11/14/84/11148488_det.jpg
7493,The Three Faces of Eve,1957,three_faces_of_eve,7.7,12,12,0,100,0,1,1,0,100,3.7,997,77,http://content9.flixster.com/movie/28/67/286715_det.jpg
7521,No Mercy,1986,1015199-no_mercy,3.4,13,2,11,15,4.4,5,2,3,40,2.8,740,32,http://content8.flixster.com/movie/10/92/75/10927586_det.jpg
7523,The Desperate Hours,1955,1005724-desperate_hours,7,5,4,1,80,0,0,0,0,0,0,0,0,http://content8.flixster.com/movie/29/75/297594_det.jpg
7541,100 Girls,2000,100_girls,5.9,5,3,2,60,0,0,0,0,0,0,0,0,http://content7.flixster.com/movie/10/87/92/10879257_det.jpg
7560,Fail-Safe,1964,failsafe,7.6,13,12,1,92,0,0,0,0,0,0,0,0,http://content9.flixster.com/movie/29/23/292315_det.jpg
7561,Paperhouse,1988,,8.3,5,5,0,100,0,1,1,0,100,0,0,0,http://content8.flixster.com/movie/28/97/67/2897678_det.jpg
7562,Dobermann,1997,dobermann,0,1,0,1,0,0,0,0,0,0,0,0,0,http://content9.flixster.com/movie/10/89/70/10897075_det.jpg
7563,The Discovery of Heaven,2001,the-discovery-of-heaven,0,0,0,0,0,0,0,0,0,0,0,0,0,http://content9.flixster.com/movie/10/88/61/10886171_det.jpg
7564,Kaidan,1964,kwaidan,7.5,16,13,3,81,0,2,1,1,50,4.1,1525,89,http://content7.flixster.com/movie/29/31/293193_det.jpg
7565,Cat-Women of the Moon,1953,cat-women-of-the-moon,0,0,0,0,0,0,0,0,0,0,0,0,0,http://content8.flixster.com/movie/88/93/05/8893058_det.jpg
7566,28 Up,1985,28_up,8.8,12,12,0,100,0,3,3,0,100,4.2,565,93,http://content7.flixster.com/movie/49/04/44/4904445_det.jpg
7567,Last Chance Harvey,2008,last_chance_harvey,6.2,146,102,44,69,6.1,27,19,8,70,3.2,14302,52,http://content7.flixster.com/movie/10/88/88/10888825_det.jpg
7569,You Only Live Twice,1967,you_only_live_twice,6.1,33,23,10,69,4.8,6,1,5,16,3.4,11073,70,http://content7.flixster.com/movie/25/92/259209_det.jpg
7570,Octopussy,1983,octopussy,5.3,32,15,17,46,4.7,5,2,3,40,3.1,10228,55,http://content7.flixster.com/movie/11/13/14/11131437_det.jpg
7571,The Blue Gardenia,1953,blue_gardenia,6.6,5,5,0,100,0,0,0,0,0,0,0,0,http://content9.flixster.com/movie/29/70/297019_det.jpg
7572,Wit,2001,wit,6.5,10,8,2,80,0,0,0,0,0,0,0,0,http://content6.flixster.com/movie/97/10/18/9710184_det.jpg
7573,Never Say Never Again,1983,never_say_never_again,5.9,34,22,12,64,6.2,5,3,2,60,3.1,7414,48,http://content6.flixster.com/movie/25/63/256316_det.jpg
7574,Maboroshi no hikari,1995,maborosi,8.1,16,16,0,100,0,4,4,0,100,4,530,83,http://content9.flixster.com/movie/10/91/76/10917695_det.jpg
7577,Trollfl√∂jten,1975,1013035-magic_flute,7.8,14,13,1,92,0,3,3,0,100,3.8,1181,77,http://content9.flixster.com/movie/25/15/251515_det.jpg
7578,Midnight Movie,2008,midnight_movie,0,1,1,0,100,0,0,0,0,0,0,0,0,http://content9.flixster.com/movie/10/88/76/10887667_det.jpg
7579,Pride & Prejudice,2005,1153077-1153077-pride_and_prejudice,7.7,164,140,24,85,7.6,37,32,5,86,3.8,101164,88,http://content8.flixster.com/movie/25/05/250518_det.jpg
7580,The Man in the Gray Flannel Suit,1956,man_in_the_gray_flannel_suit,5.9,6,5,1,83,0,0,0,0,0,0,0,0,http://content8.flixster.com/movie/10/87/85/10878506_det.jpg
7581,The Fountainhead,1949,fountainhead,6.4,11,9,2,81,0,0,0,0,0,0,0,0,http://content8.flixster.com/movie/10/85/56/10855630_det.jpg
7582,Old Acquaintance,1943,old_acquaintance,0,1,0,1,0,0,0,0,0,0,0,0,0,http://content7.flixster.com/movie/11/03/09/11030905_det.jpg
7583,In This Our Life,1942,in_this_our_life,0,3,2,1,66,0,0,0,0,0,0,0,0,http://content7.flixster.com/movie/10/89/78/10897845_det.jpg
7584,The Women,2008,10009516-women,3.9,142,18,124,12,3.8,34,4,30,11,3,20081,41,http://content6.flixster.com/movie/10/85/30/10853064_det.jpg
7585,Summertime,1955,summertime,7.4,14,13,1,92,0,3,3,0,100,3.7,859,78,http://content8.flixster.com/movie/29/34/293410_det.jpg
7586,Soldaat van Oranje,1977,soldier_of_orange,7.9,8,8,0,100,0,0,0,0,0,0,0,0,http://content8.flixster.com/movie/27/78/277826_det.jpg
7587,Le samoura√Ø,1967,le_samourai,8.3,25,25,0,100,8.4,7,7,0,100,0,0,0,http://content9.flixster.com/movie/25/36/253691_det.jpg
7613,White Palace,1990,white_palace,5.6,14,8,6,57,0,2,2,0,100,3.2,887,63,http://content7.flixster.com/movie/28/05/280593_det.jpg
7614,Oklahoma!,1955,oklahoma,7.2,22,20,2,90,0,4,3,1,75,3.4,4365,72,http://content9.flixster.com/movie/10/87/71/10877115_det.jpg
7615,Desert Hearts,1985,desert_hearts,6.8,5,4,1,80,0,1,0,1,0,3.7,699,72,http://content6.flixster.com/movie/10/89/81/10898172_det.jpg
7616,Body Double,1984,body_double,6.6,25,21,4,84,0,1,1,0,100,3.2,1914,61,http://content8.flixster.com/movie/27/29/272902_det.jpg
7617,Rooster Cogburn,1975,rooster-cogburn,4.7,7,3,4,42,0,1,0,1,0,0,0,0,http://content9.flixster.com/movie/49/97/71/4997715_det.jpg
7618,Chaplin,1992,chaplin,5.8,44,27,17,61,3.3,9,0,9,0,3.6,6022,81,http://content7.flixster.com/movie/26/06/260625_det.jpg
7619,The Miracle Worker,1962,1013973-miracle_worker,7.8,17,17,0,100,0,3,3,0,100,3.7,1889,83,http://content9.flixster.com/movie/29/13/291323_det.jpg
7620,Monster in a Box,1992,monster_in_a_box,6.6,14,13,1,92,0,2,2,0,100,4.2,127,98,http://content9.flixster.com/movie/10/84/05/10840519_det.jpg
7621,Vengo,2000,vengo,5.7,37,23,14,62,5.2,13,6,7,46,4,644,84,http://content8.flixster.com/movie/29/94/299406_det.jpg
7622,O Primeiro Dia,1998,1095460-midnight,0,1,1,0,100,0,0,0,0,0,0,0,0,http://content6.flixster.com/movie/30/61/306128_det.jpg
7623,If You Only Knew,2000,if_you_only_knew,0,1,1,0,100,0,0,0,0,0,0,0,0,http://content7.flixster.com/movie/10/17/73/10177369_det.jpg
7624,School Ties,1992,school_ties,5.8,35,23,12,65,4.9,7,3,4,42,3.3,5052,69,http://content7.flixster.com/movie/10/84/11/10841189_det.jpg
7625,Calendar Girls,2003,calendar_girls,6.5,118,87,31,73,6.5,33,23,10,69,3.1,8453,59,http://content6.flixster.com/movie/10/90/15/10901532_det.jpg
7626,Switch,1991,1034067-switch,4.7,16,5,11,31,0,2,0,2,0,2.8,1035,47,http://content8.flixster.com/movie/27/29/272926_det.jpg
7627,Just Write,1997,just_write,5,6,3,3,50,0,0,0,0,0,0,0,0,http://content6.flixster.com/movie/26/55/265520_det.jpg
7636,Raising Cain,1992,raising_cain,4.4,19,10,9,52,0,1,1,0,100,2.9,1825,40,http://content9.flixster.com/movie/28/13/281319_det.jpg
7637,Irma Vep,1996,irma_vep,7.4,35,32,3,91,7.5,11,10,1,90,3.5,738,67,http://content6.flixster.com/movie/30/21/302192_det.jpg
7638,Buck Privates,1941,buck_privates,0,0,0,0,0,0,0,0,0,0,0,0,0,http://content8.flixster.com/movie/10/93/43/10934390_det.jpg
7639,Nice Guys Sleep Alone,1999,nice_guys_sleep_alone,0,2,2,0,100,0,0,0,0,0,0,0,0,http://content9.flixster.com/movie/10/89/25/10892559_det.jpg
7644,Divorce Iranian Style,1998,divorce-iranian-style,0,0,0,0,0,0,0,0,0,0,0,0,0,http://content6.flixster.com/movie/10/94/91/10949160_det.jpg
7645,Iron & Silk,1990,iron_and_silk,6.3,5,4,1,80,0,0,0,0,0,0,0,0,http://content7.flixster.com/movie/10/96/28/10962869_det.jpg
7646,Rose Red,2002,red2002,0,0,0,0,0,0,0,0,0,0,0,0,0,http://content6.flixster.com/movie/10/85/43/10854316_det.jpg
7647,Noises Off...,1992,noises_off,5.7,21,12,9,57,0,0,0,0,0,0,0,0,http://content8.flixster.com/movie/25/48/254898_det.jpg
7648,Wildflower,1991,1039504-wildflower,0,1,0,1,0,0,0,0,0,0,0,0,0,http://content6.flixster.com/movie/11/12/55/11125512_det.jpg
7649,Babylon 5: In the Beginning,1998,,\N,\N,\N,\N,\N,\N,\N,\N,\N,\N,\N,\N,\N,\N
7650,Witchfinder General,1968,conqueror_worm,6.9,12,10,2,83,0,1,1,0,100,3.5,1271,68,http://content8.flixster.com/movie/10/93/54/10935422_det.jpg
7675,The Canterville Ghost,1996,1067316-canterville_ghost,0,0,0,0,0,0,0,0,0,0,0,0,0,http://content9.flixster.com/movie/10/86/26/10862627_det.jpg
7697,The Prince and the Showgirl,1957,prince_and_the_showgirl,6,5,4,1,80,0,0,0,0,0,0,0,0,http://content9.flixster.com/movie/30/29/302999_det.jpg
7698,The China Syndrome,1979,china_syndrome,7.4,27,23,4,85,0,4,3,1,75,3.6,2169,76,http://content8.flixster.com/movie/10/88/89/10888998_det.jpg
7699,¬øQui√©n diablos es Juliette?,1997,who_the_hell_is_juliette,6.4,6,4,2,66,0,1,1,0,100,3.4,65,58,http://content6.flixster.com/movie/10/91/39/10913900_det.jpg
7700,Le salaire de la peur,1953,wages_of_fear,8.8,36,36,0,100,8.8,6,6,0,100,4.4,2478,94,http://content6.flixster.com/movie/10/88/72/10887296_det.jpg
7701,Look Who's Talking Too,1990,look_whos_talking_too,2.8,12,2,10,16,0,1,1,0,100,2.6,9775,43,http://content9.flixster.com/movie/26/17/261719_det.jpg
7702,The Bells of St. Mary's,1945,bells_of_st_marys,7.2,15,14,1,93,0,3,3,0,100,3.7,1566,76,http://content8.flixster.com/movie/29/08/290898_det.jpg
7703,You Light Up My Life,1977,you_light_up_my_life,3.2,5,1,4,20,0,0,0,0,0,0,0,0,http://content8.flixster.com/movie/10/87/39/10873962_det.jpg
7704,Delta Force 2: The Colombian Connection,1990,delta_force_2,2.2,7,0,7,0,0,1,0,1,0,2.9,1781,45,http://content8.flixster.com/movie/27/32/273202_det.jpg
7705,Pat and Mike,1952,pat_and_mike,7.4,20,18,2,90,7.2,6,6,0,100,3.5,815,67,http://content7.flixster.com/movie/29/74/297425_det.jpg
7706,Animal Crackers,1930,animal_crackers,8,20,19,1,95,0,0,0,0,0,0,0,0,http://content6.flixster.com/movie/10/88/07/10880780_det.jpg
7707,"He Said, She Said",1991,he_said_she_said,4.9,14,5,9,35,0,2,0,2,0,2.7,1214,33,http://content6.flixster.com/movie/10/84/58/10845848_det.jpg
7708,Bedazzled,2000,1101051-bedazzled,5.4,109,53,56,48,5.2,32,14,18,43,2.7,15017,45,http://content6.flixster.com/movie/10/92/66/10926648_det.jpg
7713,Cat People,1982,1003758-cat_people,6.1,36,23,13,63,0,3,2,1,66,3,2400,46,http://content8.flixster.com/movie/28/49/284902_det.jpg
7714,Quest for Camelot,1998,quest_for_camelot,5.3,21,7,14,33,5.9,6,2,4,33,3.1,4042,62,http://content6.flixster.com/movie/10/91/52/10915264_det.jpg
7716,The Lonely Guy,1984,lonely_guy,5.2,21,10,11,47,0,4,0,4,0,3.1,985,48,http://content6.flixster.com/movie/74/27/57/7427576_det.jpg
7720,The Four Musketeers,1974,four_musketeers,6.9,18,14,4,77,0,1,0,1,0,3.4,1319,68,http://content9.flixster.com/movie/26/52/265215_det.jpg
7723,Good Guys Wear Black,1978,good_guys_wear_black,0,4,1,3,25,0,0,0,0,0,0,0,0,http://content7.flixster.com/movie/26/35/263525_det.jpg
7724,Steel Dawn,1987,steel_dawn,0,2,1,1,50,0,0,0,0,0,0,0,0,http://content7.flixster.com/movie/10/86/98/10869873_det.jpg
7725,On Deadly Ground,1994,on_deadly_ground,2.3,23,0,23,0,2.4,5,0,5,0,2.5,3925,45,http://content8.flixster.com/movie/27/34/273402_det.jpg
7726,Boy Meets Girl,1984,1032409-boy_meets_girl,0,1,1,0,100,0,0,0,0,0,0,0,0,http://content8.flixster.com/movie/10/88/05/10880582_det.jpg
7727,The Fourth Protocol,1987,fourth_protocol,5.7,14,9,5,64,0,2,2,0,100,3.4,544,58,http://content6.flixster.com/movie/10/90/70/10907056_det.jpg
7728,The Postman Always Rings Twice,1981,1016592-postman_always_rings_twice,6.3,10,7,3,70,0,1,0,1,0,3.3,2610,61,http://content9.flixster.com/movie/27/08/270815_det.jpg
7730,Matinee,1993,1041870-matinee,7.5,25,23,2,92,0,3,3,0,100,2.9,970,53,http://content9.flixster.com/movie/31/34/313411_det.jpg
7738,Forever Fever,1998,thats_the_way_i_like_it,5.7,15,7,8,46,0,4,2,2,50,3.5,291,72,http://content9.flixster.com/movie/26/67/266719_det.jpg
7739,Virtual Sexuality,1999,virtual_sexuality,0,4,1,3,25,0,0,0,0,0,0,0,0,http://content6.flixster.com/movie/10/94/29/10942940_det.jpg
7742,The Baxter,2005,10005403-the_baxter,5.1,73,24,49,32,4.8,24,6,18,25,3.7,1793,76,http://content7.flixster.com/movie/25/00/250021_det.jpg
7743,Explorers,1985,corduroy-and-more-stories-about-friendship,0,0,0,0,0,0,0,0,0,0,0,0,0,http://content6.flixster.com/movie/29/45/294524_det.jpg
7745,M√πi du du xanh - L'odeur de la papaye verte,1993,the-scent-of-green-papaya,8.1,14,14,0,100,0,2,2,0,100,4,1483,82,http://content7.flixster.com/movie/11/12/17/11121797_det.jpg
7748,Pierrot le fou,1965,pierrot-le-fou-pierrot-goes-wild-crazy-pete,7.8,34,28,6,82,0,4,2,2,50,4.2,3601,88,http://content8.flixster.com/movie/10/93/52/10935286_det.jpg
7749,Weekend at Bernie's,1989,weekend_at_bernies,4.9,21,10,11,47,0,1,0,1,0,3,6596,57,http://content9.flixster.com/movie/10/88/30/10883063_det.jpg
7751,Strange Cargo,1940,strange_cargo,7,8,5,3,62,0,0,0,0,0,0,0,0,http://content9.flixster.com/movie/10/83/95/10839563_det.jpg
7752,Seven Girlfriends,1999,seven_girlfriends,5.7,6,3,3,50,0,0,0,0,0,0,0,0,http://content7.flixster.com/movie/28/21/282101_det.jpg
7753,Tuesdays with Morrie,1999,tuesdays_with_morrie,5.3,6,4,2,66,0,0,0,0,0,0,0,0,http://content7.flixster.com/movie/29/07/290713_det.jpg
7756,Aleksandr Nevskiy,1938,aleksandr-nevskiy-alexander-nevsky,8.7,16,15,1,93,0,3,2,1,66,4,1217,82,http://content7.flixster.com/movie/30/26/302613_det.jpg
7757,Jason and the Argonauts,1963,1010939-jason_and_the_argonauts,7.7,23,22,1,95,0,0,0,0,0,0,0,0,http://content6.flixster.com/movie/25/14/251400_det.jpg
7758,On conna√Æt la chanson,1997,same-old-song,6.4,14,9,5,64,0,2,1,1,50,3.8,499,77,http://content8.flixster.com/movie/10/83/97/10839786_det.jpg
7759,Nostalgia Boy,2006,,\N,\N,\N,\N,\N,\N,\N,\N,\N,\N,\N,\N,\N,\N
7761,La peau douce,1964,soft_skin,7.4,11,10,1,90,0,2,1,1,50,3.9,573,85,http://content7.flixster.com/movie/49/03/68/4903685_det.jpg
7762,"Tinker, Tailor, Soldier, Spy",1979,,\N,\N,\N,\N,\N,\N,\N,\N,\N,\N,\N,\N,\N,\N
7763,Winterschl√§fer,1997,wintersleepers,0,0,0,0,0,0,0,0,0,0,0,0,0,http://images.rottentomatoescdn.com/images/defaults/poster_default.gif
7764,The Driller Killer,1979,driller_killer,6,10,7,3,70,0,0,0,0,0,0,0,0,http://content7.flixster.com/movie/10/86/11/10861125_det.jpg
7766,Kumonosu-j√¥,1957,throne_of_blood,8.7,33,32,1,96,0,3,3,0,100,4.3,5573,93,http://content8.flixster.com/movie/28/65/286510_det.jpg
7767,La meglio giovent√π,2003,best_of_youth,8.4,62,59,3,95,8.1,26,24,2,92,4.6,2911,97,http://content8.flixster.com/movie/11/14/78/11147822_det.jpg
7768,Guncrazy,1992,guncrazy,5.8,8,5,3,62,0,1,0,1,0,2.9,869,38,http://content8.flixster.com/movie/28/39/283914_det.jpg
7769,Bangrajan,2000,bang_rajan,6.2,31,22,9,70,5.8,13,8,5,61,3.4,846,66,http://content9.flixster.com/movie/28/88/288807_det.jpg
7770,Treasure Island,1990,1021966-treasure_island,0,0,0,0,0,0,0,0,0,0,0,0,0,http://content9.flixster.com/movie/10/83/99/10839911_det.jpg
7771,Alexis Zorbas,1964,zorba_the_greek,7.2,5,4,1,80,0,0,0,0,0,0,0,0,http://content7.flixster.com/movie/11/14/47/11144721_det.jpg
7772,Undercurrent,1946,1099778-undercurrent,0,3,2,1,66,0,0,0,0,0,0,0,0,http://content6.flixster.com/movie/88/91/09/8891096_det.jpg
7773,Bang Bang You're Dead,2002,bang_bang_youre_dead,0,2,1,1,50,0,0,0,0,0,0,0,0,http://content8.flixster.com/movie/28/68/286822_det.jpg
7774,My Side of the Mountain,1969,my_side_of_the_mountain,0,3,2,1,66,0,1,1,0,100,3.2,556,47,http://content9.flixster.com/movie/10/87/46/10874631_det.jpg
7775,The Thin Blue Line,1988,thin_blue_line,8.7,11,11,0,100,0,1,1,0,100,4,1805,89,http://content7.flixster.com/movie/29/37/293729_det.jpg
7781,Twister,1996,1071167-twister,6,49,28,21,57,6.7,10,7,3,70,3.2,45771,62,http://content8.flixster.com/movie/26/63/266302_det.jpg
7782,Sniper,1993,1042281-sniper,4.7,12,5,7,41,0,2,1,1,50,3,3468,58,http://content7.flixster.com/movie/27/34/273421_det.jpg
7783,No se lo digas a nadie,1998,dont_tell_anyone,0,1,1,0,100,0,0,0,0,0,0,0,0,http://content7.flixster.com/movie/10/86/14/10861437_det.jpg
7784,Ghost in the Machine,1993,ghost_in_the_machine,3,8,1,7,12,0,1,0,1,0,2.6,1353,32,http://content7.flixster.com/movie/31/26/312617_det.jpg
7785,Zamani baray√© masti asbha,2000,time_for_drunken_horses,7.3,30,25,5,83,8.1,7,7,0,100,4.3,467,91,http://content9.flixster.com/movie/90/31/40/9031407_det.jpg
7786,Genghis Blues,1999,genghis_blues,7.1,11,8,3,72,0,3,3,0,100,4,354,88,http://content7.flixster.com/movie/29/28/292813_det.jpg
7787,Rambo,2008,john_rambo,4.8,138,50,88,36,4,26,6,20,23,3.4,107524,70,http://content9.flixster.com/movie/10/84/05/10840523_det.jpg
7789,11'09''01 - September 11,2002,september_11,6.6,58,45,13,77,6.6,21,16,5,76,3.5,303,62,http://content9.flixster.com/movie/10/88/53/10885371_det.jpg
7790,"Bon Voyage, Charlie Brown (and Don't Come Back!!)",1980,bon-voyage-charlie-brown-and-dont-come-back,0,0,0,0,0,0,0,0,0,0,0,0,0,http://content9.flixster.com/movie/54/14/96/5414967_det.jpg
7791,Internal Affairs,1990,internal_affairs,6.7,25,22,3,88,6.9,7,6,1,85,3.2,1646,56,http://content9.flixster.com/movie/27/30/273007_det.jpg
7792,The Parallax View,1974,parallax_view,7.7,26,24,2,92,0,4,2,2,50,3.7,1119,77,http://content6.flixster.com/movie/27/54/275492_det.jpg
7802,The Warriors,1979,1023205-warriors,7.4,30,28,2,93,0,0,0,0,0,0,0,0,http://content6.flixster.com/movie/27/06/270600_det.jpg
7808,Mayerling,1968,1068449-mayerling,0,3,1,2,33,0,1,0,1,0,3,76,38,http://content7.flixster.com/movie/10/91/11/10911125_det.jpg
7809,Rukaj√§rven tie,1999,,\N,\N,\N,\N,\N,\N,\N,\N,\N,\N,\N,\N,\N,\N
7810,Babylon 5: A Call to Arms,1999,in-the-shadow-of-babylon,0,0,0,0,0,0,0,0,0,0,0,0,0,http://content7.flixster.com/movie/10/85/71/10857117_det.jpg
7811,Babylon 5: The River of Souls,1998,babylon-5-the-river-of-souls,0,0,0,0,0,0,0,0,0,0,0,0,0,http://content8.flixster.com/movie/10/89/29/10892922_det.jpg
7812,Babylon 5: Thirdspace,1998,babylon-5-thirdspace,0,0,0,0,0,0,0,0,0,0,0,0,0,http://content9.flixster.com/movie/35/67/89/3567899_det.jpg
7813,FM,1978,fm,0,4,2,2,50,0,0,0,0,0,0,0,0,http://content6.flixster.com/movie/26/43/264300_det.jpg
7814,Waterloo,1970,waterloo,0,2,2,0,100,0,0,0,0,0,0,0,0,http://content7.flixster.com/movie/79/06/24/7906245_det.jpg
7815,Dreamer: Inspired by a True Story,2005,dreamer,6.3,115,73,42,63,6.1,29,17,12,58,3.6,21404,74,http://content6.flixster.com/movie/25/03/250392_det.jpg
7816,North Beach,2000,north_beach,0,2,1,1,50,0,0,0,0,0,0,0,0,http://content9.flixster.com/movie/10/85/22/10852247_det.jpg
7817,Zardoz,1974,zardoz,5.2,18,8,10,44,0,1,0,1,0,3.1,2696,51,http://content6.flixster.com/movie/26/95/269596_det.jpg
7818,School for Scoundrels,2006,school_for_scoundrels,4.6,137,35,102,25,4.5,32,8,24,25,3.2,39981,57,http://content7.flixster.com/movie/27/22/94/2722945_det.jpg
7820,Jungfruk√§llan,1960,virgin_spring,8.1,16,15,1,93,0,2,1,1,50,4.2,2857,92,http://content8.flixster.com/movie/10/88/86/10888646_det.jpg
7821,Ice-Cold in Alex,1958,icecold-in-alex-desert-attack,0,0,0,0,0,0,0,0,0,0,0,0,0,http://content9.flixster.com/movie/23/31/08/2331087_det.jpg
7822,Mogambo,1953,mogambo,6.2,9,7,2,77,0,0,0,0,0,0,0,0,http://content7.flixster.com/movie/14/81/29/1481297_det.jpg
7824,Segunda piel,1999,1119827-second_skin,0,0,0,0,0,0,0,0,0,0,0,0,0,http://content7.flixster.com/movie/10/87/40/10874025_det.jpg
7826,The Secret Life of Walter Mitty,1947,secret_life_of_walter_mitty,7,5,4,1,80,0,0,0,0,0,0,0,0,http://content9.flixster.com/movie/66/42/71/6642711_det.jpg
7827,Cypher,2002,cypher,6.3,17,10,7,58,0,0,0,0,0,0,0,0,http://content9.flixster.com/movie/27/32/273203_det.jpg
7828,The Rack,1956,the-rack,0,0,0,0,0,0,0,0,0,0,0,0,0,http://images.rottentomatoescdn.com/images/defaults/poster_default.gif
7831,Another Thin Man,1939,another_thin_man,7.1,12,12,0,100,0,0,0,0,0,0,0,0,http://content7.flixster.com/movie/10/91/31/10913129_det.jpg
7832,The Thin Man Goes Home,1945,thin_man_goes_home,6.4,5,3,2,60,0,0,0,0,0,0,0,0,http://content9.flixster.com/movie/65/86/38/6586387_det.jpg
7833,Shadow of the Thin Man,1941,shadow_of_the_thin_man,6.8,6,5,1,83,0,0,0,0,0,0,0,0,http://content8.flixster.com/movie/65/86/29/6586290_det.jpg
7834,After the Thin Man,1936,after_the_thin_man,7.5,12,12,0,100,0,0,0,0,0,0,0,0,http://content6.flixster.com/movie/62/23/24/6223240_det.jpg
7835,Song of the Thin Man,1947,song_of_the_thin_man,6,10,8,2,80,0,0,0,0,0,0,0,0,http://content7.flixster.com/movie/65/86/32/6586321_det.jpg
7836,Woodstock,1970,woodstock,8.6,19,19,0,100,0,2,2,0,100,4.1,2814,90,http://content8.flixster.com/movie/26/73/267310_det.jpg
7837,36 fillette,1988,36_fillette,7.1,7,6,1,85,0,1,1,0,100,3,414,48,http://content8.flixster.com/movie/10/89/86/10898606_det.jpg
7838,The Internecine Project,1974,internecine_project,0,0,0,0,0,0,0,0,0,0,0,0,0,http://content9.flixster.com/movie/10/95/79/10957935_det.jpg
7839,Crazy Love,2007,10007792-crazy_love,7,84,65,19,77,7,32,26,6,81,3.6,2624,70,http://content6.flixster.com/movie/10/53/69/10536956_det.jpg
7840,Gunga Din,1939,gunga_din,8,24,22,2,91,0,1,1,0,100,3.7,1406,74,http://content7.flixster.com/movie/10/08/01/10080165_det.jpg
7841,Children of Dune,2003,,\N,\N,\N,\N,\N,\N,\N,\N,\N,\N,\N,\N,\N,\N
7842,Dune,1984,1006364-dune,6.1,26,16,10,61,0,2,0,2,0,3.4,17715,67,http://content7.flixster.com/movie/11/13/64/11136477_det.jpg
7843,Lammbock,2001,lammbock,0,0,0,0,0,0,0,0,0,0,0,0,0,http://content9.flixster.com/movie/10/85/44/10854467_det.jpg
7844,Fong Sai Yuk,1993,1076222-legend,7.2,9,8,1,88,0,0,0,0,0,0,0,0,http://content6.flixster.com/movie/27/47/274796_det.jpg
7845,Tremors II: Aftershocks,1996,tremors_2_aftershocks,5.3,8,5,3,62,0,0,0,0,0,0,0,0,http://content7.flixster.com/movie/10/87/82/10878205_det.jpg
7846,Tremors 3: Back to Perfection,2001,tremors_3_back_to_perfection,5.5,6,4,2,66,0,0,0,0,0,0,0,0,http://content6.flixster.com/movie/26/00/260012_det.jpg
7847,The Peanut Butter Solution,1985,peanut_butter_solution,0,0,0,0,0,0,0,0,0,0,0,0,0,http://content6.flixster.com/movie/11/15/29/11152940_det.jpg
7872,Getting It Right,1989,getting_it_right,6,6,4,2,66,0,1,1,0,100,3.9,146,73,http://content6.flixster.com/movie/10/92/22/10922212_det.gif
7878,Straight to Hell,1987,straight_to_hell,4.2,7,2,5,28,0,1,0,1,0,3.3,813,54,http://content7.flixster.com/movie/10/90/01/10900177_det.jpg
7879,Notorious C.H.O.,2002,,\N,\N,\N,\N,\N,\N,\N,\N,\N,\N,\N,\N,\N,\N
7880,Vendredi soir,2002,friday_night,6.9,53,42,11,79,6.2,16,12,4,75,3.4,267,55,http://content6.flixster.com/movie/10/93/46/10934628_det.jpg
7881,White Zombie,1932,white_zombie,6.9,13,10,3,76,0,0,0,0,0,0,0,0,http://content7.flixster.com/movie/28/87/288701_det.jpg
7882,The Plague of the Zombies,1966,,5.2,6,4,2,66,0,0,0,0,0,0,0,0,http://content7.flixster.com/movie/11/15/11/11151185_det.jpg
7883,I Walked with a Zombie,1943,i_walked_with_a_zombie,7.7,22,20,2,90,0,3,1,2,33,3.7,1271,73,http://content6.flixster.com/movie/51/27/71/5127716_det.jpg
7884,Highway 61,1991,highway_61,6.8,5,5,0,100,0,1,1,0,100,0,0,0,http://content7.flixster.com/movie/33/34/27/3334277_det.jpg
7885,The Vampire Lovers,1970,vampire_lovers,4.9,7,3,4,42,0,2,1,1,50,3.4,584,62,http://content9.flixster.com/movie/10/89/40/10894023_det.jpg
7886,Countess Dracula,1971,countess_dracula,0,2,0,2,0,0,0,0,0,0,0,0,0,http://content8.flixster.com/movie/34/47/99/3447994_det.jpg
7887,But I'm a Cheerleader,1999,but_im_a_cheerleader,4.7,46,15,31,32,4.1,12,3,9,25,3.4,7081,74,http://content8.flixster.com/movie/27/53/275310_det.jpg
7888,How to Succeed in Business Without Really Trying,1967,how_to_succeed_in_business_without_really_trying,7,9,8,1,88,0,0,0,0,0,0,0,0,http://content6.flixster.com/movie/28/64/286404_det.jpg
7889,Pat Garrett & Billy the Kid,1973,pat_garrett_and_billy_the_kid,7.2,17,14,3,82,0,3,1,2,33,3.8,2126,82,http://content6.flixster.com/movie/10/88/17/10881780_det.jpg
7890,The Left Handed Gun,1958,the-left-handed-gun,7.8,7,7,0,100,0,2,2,0,100,3.4,241,52,http://content6.flixster.com/movie/10/14/95/10149568_det.jpg
7891,The Last Man on Earth,1964,1050388-last_man_on_earth,6.3,15,11,4,73,0,1,0,1,0,3.6,4886,69,http://content7.flixster.com/movie/18/68/33/1868337_det.jpg
7892,Gekitotsu! Satsujin ken,1974,street_fighter,0,4,3,1,75,0,0,0,0,0,0,0,0,http://content9.flixster.com/movie/11/12/45/11124507_det.jpg
7893,Satsujin ken 2,1974,return_of_the_street_fighter,0,3,0,3,0,0,0,0,0,0,0,0,0,http://content6.flixster.com/movie/31/31/313196_det.jpg
7894,Gi√π la testa,1971,fistful_of_dynamite,7.5,19,17,2,89,7.5,5,4,1,80,3.8,4524,77,http://content6.flixster.com/movie/10/93/53/10935356_det.jpg
7895,Bring Me the Head of Alfredo Garcia,1974,bring_me_the_head_of_alfredo_garcia,7.3,18,15,3,83,0,2,1,1,50,3.9,2407,84,http://content6.flixster.com/movie/10/84/48/10844856_det.jpg
7896,Ride the High Country,1962,ride_the_high_country,8.2,14,13,1,92,0,1,1,0,100,0,0,0,http://content7.flixster.com/movie/10/86/72/10867229_det.jpg
7897,The Ballad of Cable Hogue,1970,ballad_of_cable_hogue,7,13,12,1,92,0,3,3,0,100,3.6,929,75,http://content8.flixster.com/movie/10/86/73/10867306_det.jpg
7898,Junior Bonner,1972,junior_bonner,7.4,17,15,2,88,0,3,2,1,66,3.4,748,60,http://content8.flixster.com/movie/31/07/310714_det.jpg
7899,Du bi quan wang da po xue di zi,1975,master_of_the_flying_guillotine,6.9,20,18,2,90,0,4,4,0,100,3.9,1371,83,http://content6.flixster.com/movie/27/41/274192_det.jpg
7900,Frankenstein Must Be Destroyed,1969,frankenstein_must_be_destroyed,0,2,0,2,0,0,0,0,0,0,0,0,0,http://content7.flixster.com/movie/95/83/99/9583993_det.jpg
7901,The Haunted Palace,1963,haunted_palace,0,4,3,1,75,0,0,0,0,0,0,0,0,http://content8.flixster.com/movie/34/73/84/3473842_det.jpg
7912,Finder's Fee,2001,finders_fee,6.8,5,3,2,60,0,0,0,0,0,0,0,0,http://content7.flixster.com/movie/27/59/275905_det.jpg
7913,La frusta e il corpo,1963,whip_and_the_body,6.8,7,5,2,71,0,0,0,0,0,0,0,0,http://content9.flixster.com/movie/10/89/53/10895307_det.jpg
7914,Berlin: Die Sinfonie der Grosstadt,1927,berlin-symphony-of-a-great-city,6.4,6,5,1,83,0,1,1,0,100,3.9,403,81,http://content6.flixster.com/movie/29/57/295720_det.jpg
7915,SF: Episode One,1998,samurai-fiction,0,1,1,0,100,0,0,0,0,0,0,0,0,http://content6.flixster.com/movie/11/12/56/11125628_det.jpg
7916,Gidget,1959,gidget,5.6,8,4,4,50,0,0,0,0,0,0,0,0,http://content6.flixster.com/movie/11/15/00/11150028_det.jpg
7917,Wild in the Streets,1968,wild-in-the-streets1968,6,8,5,3,62,0,1,0,1,0,3.6,252,69,http://content6.flixster.com/movie/10/87/14/10871488_det.jpg
7918,The Indian Runner,1991,indian_runner,5.9,13,9,4,69,0,2,2,0,100,3.7,1580,78,http://content7.flixster.com/movie/27/11/271121_det.jpg
7919,Yoidore tenshi,1948,drunken_angel,7.5,13,13,0,100,0,3,3,0,100,4,1199,87,http://content8.flixster.com/movie/61/74/16/6174162_det.jpg
7920,Desperate Living,1977,desperate_living,6,10,7,3,70,0,0,0,0,0,0,0,0,http://content6.flixster.com/movie/19/58/20/1958200_det.jpg
7921,The Devil's Rain,1975,devils_rain,3.9,10,2,8,20,0,1,0,1,0,0,0,0,http://content7.flixster.com/movie/26/20/262013_det.jpg
7922,The Valachi Papers,1972,valachi_papers,0,0,0,0,0,0,0,0,0,0,0,0,0,http://content8.flixster.com/movie/31/24/312426_det.jpg
7923,Rolling Thunder,1977,1017818-rolling_thunder,6.9,5,5,0,100,0,0,0,0,0,0,0,0,http://content7.flixster.com/movie/51/24/54/5124545_det.jpg
7924,Nora inu,1949,1020312-stray_dog,7.4,15,14,1,93,0,0,0,0,0,0,0,0,http://content7.flixster.com/movie/29/82/298201_det.jpg
7925,Kakushi-toride no san-akunin,1958,1009583-hidden_fortress,8.6,22,22,0,100,0,2,2,0,100,4.1,6021,90,http://content6.flixster.com/movie/10/92/70/10927028_det.jpg
7926,Tengoku to jigoku,1963,high_and_low,7.8,14,13,1,92,0,2,2,0,100,4.3,2474,94,http://content8.flixster.com/movie/30/26/302694_det.jpg
7928,Efter repetitionen,1984,after_the_rehearsal,7.7,10,9,1,90,0,3,3,0,100,3.7,244,69,http://content6.flixster.com/movie/97/92/03/9792032_det.jpg
7930,The People Under the Stairs,1991,people_under_the_stairs,5.5,13,8,5,61,0,1,0,1,0,3.1,6410,60,http://content6.flixster.com/movie/27/33/273396_det.jpg
7931,My New Gun,1992,my_new_gun,5.7,6,3,3,50,0,1,0,1,0,3.4,190,40,http://content6.flixster.com/movie/50/89/70/5089704_det.jpg
7932,Dark Days,2000,dark_days,7.8,29,27,2,93,7.4,5,4,1,80,4,1419,89,http://content7.flixster.com/movie/29/26/292621_det.jpg
7933,A Night in Casablanca,1946,night_in_casablanca,5,7,4,3,57,0,0,0,0,0,0,0,0,http://content6.flixster.com/movie/10/84/88/10848812_det.jpg
7934,Zelig,1983,zelig,7.7,17,17,0,100,0,0,0,0,0,0,0,0,http://content9.flixster.com/movie/25/82/258299_det.jpg
7935,Ansikte mot ansikte,1976,1070856-face_to_face,6.8,7,5,2,71,0,4,2,2,50,4,333,86,http://content8.flixster.com/movie/97/92/01/9792010_det.jpg
7936,Skammen,1968,shame,6.8,14,10,4,71,0,3,2,1,66,4,1110,88,http://content9.flixster.com/movie/99/95/88/9995887_det.jpg
7937,Tystnaden,1963,1018974-silence,8,12,11,1,91,0,3,2,1,66,4.1,1976,89,http://content9.flixster.com/movie/10/87/61/10876187_det.jpg
7938,Nattvardsg√§sterna,1963,winter_light,7.7,15,12,3,80,0,3,2,1,66,4.3,1967,92,http://content9.flixster.com/movie/10/92/41/10924191_det.jpg
7939,S√•som i en spegel,1961,through_a_glass_darkly,8.6,14,14,0,100,0,2,2,0,100,4.2,2486,91,http://content6.flixster.com/movie/12/83/70/1283700_det.jpg
7940,Ansiktet,1958,,8.2,6,6,0,100,0,2,2,0,100,3.9,677,84,http://content9.flixster.com/movie/95/10/62/9510627_det.jpg
7941,Sommarnattens leende,1955,smiles_of_a_summer_night,8.5,10,10,0,100,0,1,1,0,100,4,1688,88,http://content6.flixster.com/movie/29/56/295608_det.jpg
7942,Sommaren med Monika,1953,,\N,\N,\N,\N,\N,\N,\N,\N,\N,\N,\N,\N,\N,\N
7943,Natural Born Killers,1994,natural_born_killers,6,29,15,14,51,5.9,7,3,4,42,3.5,39062,80,http://content8.flixster.com/movie/10/88/54/10885402_det.jpg
7944,The Night of the Iguana,1964,night_of_the_iguana,7.2,14,10,4,71,0,3,1,2,33,3.9,1177,84,http://content9.flixster.com/movie/10/86/94/10869443_det.jpg
7945,Freud,1962,freud_the_secret_passion,0,1,1,0,100,0,0,0,0,0,0,0,0,http://content6.flixster.com/movie/10/61/30/10613020_det.jpg
7946,Reflections in a Golden Eye,1967,reflections_in_a_golden_eye,6.6,6,5,1,83,0,0,0,0,0,0,0,0,http://content7.flixster.com/movie/90/70/72/9070725_det.jpg
7947,Under the Volcano,1984,under_the_volcano,6.5,16,12,4,75,0,4,3,1,75,3.6,510,71,http://content9.flixster.com/movie/10/87/53/10875307_det.jpg
7948,Wise Blood,1979,wise_blood,7.4,9,8,1,88,0,0,0,0,0,0,0,0,http://content8.flixster.com/movie/52/70/23/5270234_det.jpg
7949,The Yakuza,1974,yakuza,5.8,10,5,5,50,0,3,0,3,0,3.8,480,79,http://content8.flixster.com/movie/50/40/69/5040694_det.jpg
7951,Nightbreed,1990,nightbreed,4.9,11,4,7,36,0,1,0,1,0,3.3,3698,62,http://content9.flixster.com/movie/26/97/269791_det.jpg
7952,Bottle Shock,2008,bottle_shock,5.6,116,56,60,48,6.1,29,16,13,55,3.3,4827,60,http://content9.flixster.com/movie/10/88/94/10889487_det.jpg
7953,Cani arrabbiati,1974,rabid_dogs,6,7,5,2,71,0,0,0,0,0,0,0,0,http://content6.flixster.com/movie/24/83/58/2483580_det.jpg
7954,Gli orrori del castello di Norimberga,1972,baron_blood,4.1,6,0,6,0,0,2,0,2,0,3.1,382,42,http://content9.flixster.com/movie/10/88/42/10884259_det.jpg
7958,Bloody Mama,1970,bloody_mama,4.5,6,2,4,33,0,0,0,0,0,0,0,0,http://content6.flixster.com/movie/10/93/42/10934252_det.jpg
7959,Road Trip,2000,1097259-road_trip,5.9,89,52,37,58,5.9,21,14,7,66,3.3,57286,68,http://content6.flixster.com/movie/55/32/86/5532868_det.jpg
7976,Ken Park,2002,1173608-ken_park,4.9,14,6,8,42,0,1,0,1,0,3.3,3212,58,http://content8.flixster.com/movie/10/85/14/10851434_det.jpg
7979,Monterey Pop,1968,monterey_pop,7.9,16,16,0,100,0,2,2,0,100,4.1,573,88,http://content8.flixster.com/movie/15/52/47/1552478_det.jpg
7980,A Bridge Too Far,1977,bridge_too_far,6.6,12,8,4,66,0,0,0,0,0,0,0,0,http://content6.flixster.com/movie/25/70/257012_det.jpg
7981,Mou gaan dou,2002,infernal_affairs,7.6,60,57,3,95,8,22,22,0,100,4.2,19748,94,http://content9.flixster.com/movie/55/33/32/5533327_det.jpg
7982,"Janghwa, Hongryeon",2003,1143939-1143939-tale_of_two_sisters,7.1,53,46,7,86,6.7,16,13,3,81,3.9,7458,83,http://content7.flixster.com/movie/10/84/07/10840797_det.jpg
7983,Broadway Danny Rose,1984,broadway_danny_rose,8.1,25,25,0,100,0,4,4,0,100,3.7,2721,78,http://content9.flixster.com/movie/26/05/260503_det.jpg
7984,They Came from Beyond Space,1967,they_came_from_beyond_space,0,1,0,1,0,0,0,0,0,0,0,0,0,http://content6.flixster.com/movie/10/92/40/10924068_det.jpg
7985,The Wonderful Ice Cream Suit,1998,wonderful_ice_cream_suit,0,4,3,1,75,0,0,0,0,0,0,0,0,http://content8.flixster.com/movie/86/03/77/8603778_det.jpg
7986,Robot Jox,1990,robot-jox,0,1,0,1,0,0,0,0,0,0,0,0,0,http://content8.flixster.com/movie/25/70/257022_det.jpg
7987,Dolls,2002,dolls2002,6.7,36,27,9,75,6.9,13,12,1,92,4.2,3709,87,http://content8.flixster.com/movie/10/88/89/10888962_det.jpg
7988,Space Truckers,1996,space_truckers,3.4,11,1,10,9,0,0,0,0,0,0,0,0,http://content9.flixster.com/movie/26/38/263807_det.jpg
7989,Not of This Earth,1957,not-of-this-earth,0,0,0,0,0,0,0,0,0,0,0,0,0,http://content6.flixster.com/movie/11/15/31/11153136_det.jpg
7990,Rock 'n' Roll High School,1979,1017745-rock_n_roll_high_school,6.7,23,18,5,78,0,2,1,1,50,3.5,3278,71,http://content9.flixster.com/movie/83/07/830763_det.png
7991,Death Race,2008,death_race,4.8,145,60,85,41,5.2,23,10,13,43,3.5,50505,69,http://content9.flixster.com/movie/10/88/81/10888107_det.jpg
7992,Cockfighter,1974,1195241-born_to_kill,0,0,0,0,0,0,0,0,0,0,0,0,0,http://content9.flixster.com/movie/10/91/22/10912203_det.jpg
7993,A Bucket of Blood,1959,bucket_of_blood,6.6,10,7,3,70,0,0,0,0,0,0,0,0,http://content8.flixster.com/movie/85/92/859230_det.jpg
7994,Premature Burial,1962,premature_burial,4.6,5,2,3,40,0,0,0,0,0,0,0,0,http://content7.flixster.com/movie/10/09/37/10093761_det.jpg
7995,The Wild Angels,1966,wild_angels,5.5,9,5,4,55,0,0,0,0,0,0,0,0,http://content7.flixster.com/movie/27/77/277705_det.jpg
8003,Bedlam,1946,bedlam,6.5,15,13,2,86,0,2,2,0,100,3.3,649,56,http://content7.flixster.com/movie/95/34/44/9534445_det.jpg
8004,Terrore nello spazio,1965,planet_of_the_vampires,5.9,7,4,3,57,0,0,0,0,0,0,0,0,http://content6.flixster.com/movie/10/91/34/10913492_det.jpg
8007,Pure Country,1992,pure_country,0,4,0,4,0,0,1,0,1,0,3.9,3532,89,http://content8.flixster.com/movie/10/93/85/10938526_det.jpg
8008,Brigadoon,1954,brigadoon,6,10,8,2,80,0,0,0,0,0,0,0,0,http://content9.flixster.com/movie/10/87/14/10871455_det.jpg
8009,Marjorie Morningstar,1958,marjorie_morningstar,0,0,0,0,0,0,0,0,0,0,0,0,0,http://content6.flixster.com/movie/10/88/97/10889764_det.jpg
8010,The Power of One,1992,power_of_one,5.6,11,6,5,54,0,2,0,2,0,4,2912,88,http://content7.flixster.com/movie/25/51/255109_det.jpg
8011,The Weather Underground,2002,weather_underground,7.8,57,52,5,91,7.5,19,16,3,84,3.9,920,85,http://content8.flixster.com/movie/10/89/31/10893190_det.jpg
8012,Kikujir√¥ no natsu,1999,kikujiro-no-natsu,0,0,0,0,0,0,0,0,0,0,0,0,0,http://content9.flixster.com/movie/10/95/22/10952211_det.jpg
8013,I'm with Lucy,2002,im_with_lucy,0,2,0,2,0,0,0,0,0,0,0,0,0,http://content9.flixster.com/movie/27/66/276611_det.jpg
8014,Bom yeoreum gaeul gyeoul geurigo bom,2003,spring-summer-fall-winter-and-spring,8.1,94,89,5,94,8.1,26,24,2,92,4.2,7663,92,http://content6.flixster.com/movie/26/79/267996_det.jpg
8015,The Phantom Tollbooth,1970,phantom_tollbooth,0,3,3,0,100,0,0,0,0,0,0,0,0,http://content8.flixster.com/movie/10/87/25/10872586_det.jpg
8016,A Perfect Getaway,2009,a_perfect_getaway,5.8,124,76,48,61,5.9,29,18,11,62,3.2,102622,50,http://content7.flixster.com/movie/10/91/93/10919317_det.jpg
8017,10 Rillington Place,1971,10_rillington_place,6.5,8,5,3,62,0,1,1,0,100,3.9,564,87,http://content8.flixster.com/movie/10/92/16/10921658_det.gif
8019,Honogurai mizu no soko kara,2002,10002114-dark_water,6.8,13,10,3,76,0,0,0,0,0,0,0,0,http://content7.flixster.com/movie/11/12/84/11128477_det.jpg
8024,The Thing Called Love,1993,thing_called_love,5.3,20,11,9,55,0,4,2,2,50,3.5,2915,71,http://content9.flixster.com/movie/12/88/07/1288075_det.jpg
8025,Vor,1997,vor-the-thief,7,24,21,3,87,7.6,9,9,0,100,4,254,89,http://content9.flixster.com/movie/10/13/00/10130011_det.jpg
8033,How to Steal a Million,1966,how_to_steal_a_million,7,6,6,0,100,0,0,0,0,0,0,0,0,http://content6.flixster.com/movie/28/58/285804_det.jpg
8035,La sindrome di Stendhal,1996,stendhal_syndrome,6.2,11,8,3,72,0,0,0,0,0,0,0,0,http://content9.flixster.com/movie/10/89/26/10892691_det.jpg
8037,Dangan ranna,1996,dangan-ranna-dangan-runner-nonstop,0,0,0,0,0,0,0,0,0,0,0,0,0,http://content9.flixster.com/movie/11/13/44/11134487_det.jpg
8039,Support Your Local Sheriff!,1969,support_your_local_sheriff,6,11,7,4,63,0,1,0,1,0,3.6,1267,77,http://content9.flixster.com/movie/25/19/251995_det.jpg
8040,Brain Donors,1992,brain_donors,4.8,9,4,5,44,0,0,0,0,0,0,0,0,http://content6.flixster.com/movie/56/82/32/5682328_det.jpg
8041,Passed Away,1992,passed_away,4.5,8,1,7,12,0,2,0,2,0,0,0,0,http://content6.flixster.com/movie/23/15/97/2315972_det.jpg
8042,Mean Streets,1973,mean_streets,8.9,46,45,1,97,9.2,6,6,0,100,3.8,15074,83,http://content8.flixster.com/movie/96/89/58/9689586_det.jpg
8043,Jack the Bear,1993,jack_the_bear,4.9,17,5,12,29,0,2,1,1,50,3.2,989,56,http://content9.flixster.com/movie/26/50/265011_det.jpg
8044,I Am a Fugitive from a Chain Gang,1932,i_am_a_fugitive_from_a_chain_gang,8.4,16,16,0,100,0,0,0,0,0,0,0,0,http://content7.flixster.com/movie/10/86/72/10867241_det.jpg
8045,Hamburger Hill,1987,hamburger_hill,7.3,11,11,0,100,0,3,3,0,100,3.4,6794,68,http://content9.flixster.com/movie/26/96/269627_det.jpg
8056,Harper,1966,harper,7.1,16,16,0,100,0,3,3,0,100,3.6,474,69,http://content6.flixster.com/movie/43/87/85/4387856_det.jpg
8057,Sweet Bird of Youth,1962,1020684-sweet_bird_of_youth,6.7,16,12,4,75,0,3,1,2,33,3.7,457,71,http://content6.flixster.com/movie/10/87/75/10877596_det.jpg
8062,Dahmer,2002,dahmer,6.4,38,26,12,68,5.9,9,5,4,55,2.8,1473,41,http://content7.flixster.com/movie/27/73/277321_det.jpg
8063,Paradise,1982,1015925-paradise,0,3,0,3,0,0,0,0,0,0,0,0,0,http://content7.flixster.com/movie/83/85/92/8385921_det.jpg
8069,Comes a Horseman,1978,,6.7,7,6,1,85,0,0,0,0,0,0,0,0,http://content7.flixster.com/movie/26/37/263717_det.jpg
8070,Halbe Treppe,2002,halbe-treppe-grill-point,0,0,0,0,0,0,0,0,0,0,0,0,0,http://content9.flixster.com/movie/10/89/54/10895479_det.jpg
8092,Frankenstein Unbound,1990,frankenstein_unbound,5,15,6,9,40,0,1,1,0,100,2.9,443,37,http://content6.flixster.com/movie/10/83/99/10839980_det.jpg
8093,Swiri,1999,shiri2002,5.5,36,21,15,58,6.1,12,8,4,66,3.6,1502,70,http://content8.flixster.com/movie/27/11/271106_det.jpg
8094,Bad Day at Black Rock,1955,bad_day_at_black_rock,8.2,25,24,1,96,0,3,2,1,66,3.9,1420,86,http://content9.flixster.com/movie/10/56/78/10567843_det.jpg
8117,I Kina spiser de hunde,1999,i-kina-spiser-de-hunde-in-china-they-eat-dogs,0,0,0,0,0,0,0,0,0,0,0,0,0,http://content9.flixster.com/movie/22/11/32/2211327_det.jpg
8118,Delta Force 2: The Colombian Connection,1990,delta_force_2,2.2,7,0,7,0,0,1,0,1,0,2.9,1781,45,http://content8.flixster.com/movie/27/32/273202_det.jpg
8119,Crossroads,2002,1112549-crossroads,3.9,101,14,87,13,3.9,24,3,21,12,2.2,15071,41,http://content7.flixster.com/movie/10/94/50/10945037_det.jpg
8120,29th Street,1991,29th_street,6.4,9,7,2,77,0,2,2,0,100,3.3,877,67,http://content9.flixster.com/movie/26/91/269103_det.jpg
8121,La grande s√©duction,2003,la-grande-seduction-seducing-doctor-lewis,6.3,65,44,21,67,5.9,19,12,7,63,3.9,1308,87,http://content8.flixster.com/movie/28/75/11/2875118_det.jpg
8122,Beyond the City Limits,2001,rip-it-off,0,0,0,0,0,0,0,0,0,0,0,0,0,http://content8.flixster.com/movie/10/84/93/10849362_det.jpg
8123,Sammy and Rosie Get Laid,1987,sammy_and_rosie_get_laid,6.9,8,7,1,87,0,1,1,0,100,3.8,157,74,http://content8.flixster.com/movie/95/57/69/9557698_det.jpg
8124,Leaving Normal,1992,leaving_normal,4.6,7,2,5,28,0,2,0,2,0,0,0,0,http://content8.flixster.com/movie/10/88/24/10882454_det.jpg
8125,Sunrise: A Song of Two Humans,1927,sunrise,8.8,38,37,1,97,7.7,8,7,1,87,4.4,2918,93,http://content6.flixster.com/movie/92/32/923216_det.jpg
8126,Shock Corridor,1963,shock_corridor,7.6,11,10,1,90,0,0,0,0,0,0,0,0,http://content6.flixster.com/movie/10/88/51/10885112_det.jpg
8127,The First $20 Million Is Always the Hardest,2002,first_20_million_is_always_the_hardest,2.4,9,1,8,11,0,2,0,2,0,3.2,483,50,http://content6.flixster.com/movie/26/67/266724_det.jpg
8128,Au revoir les enfants,1987,au_revoir_les_enfants,9.2,23,22,1,95,10,5,4,1,80,4.2,3681,92,http://content8.flixster.com/movie/11/15/27/11152770_det.jpg
8129,Sex: The Annabel Chong Story,1999,sex_the_annabel_chong_story,5.1,17,7,10,41,0,4,2,2,50,3.1,1360,51,http://content6.flixster.com/movie/30/26/302628_det.jpg
8130,The Girl Next Door,2004,1130343-girl_next_door,5.6,156,87,69,55,5,32,17,15,53,3.3,39311,71,http://content9.flixster.com/movie/11/12/56/11125663_det.jpg
8131,The Pursuit of Happyness,2006,pursuit_of_happyness,6.4,166,110,56,66,6.1,38,25,13,65,4.1,211913,88,http://content8.flixster.com/movie/28/97/35/2897358_det.jpg
8132,Gladiator,2000,gladiator,7,159,123,36,77,6.4,36,26,10,72,3.8,248672,85,http://content8.flixster.com/movie/10/80/17/10801794_det.jpg
8133,Arven,2003,1144585-inheritance,6.7,36,27,9,75,6.1,15,9,6,60,3.8,493,79,http://content8.flixster.com/movie/28/88/288802_det.jpg
8134,Wonderful Days,2003,sky_blue,5.6,42,23,19,54,5.4,16,8,8,50,3.6,1432,73,http://content8.flixster.com/movie/29/59/27/2959278_det.jpg
8136,Indestructible Man,1956,indestructible_man,0,0,0,0,0,0,0,0,0,0,0,0,0,http://content6.flixster.com/movie/36/27/06/3627060_det.png
8137,The Wasp Woman,1959,1034011-wasp_woman,4.3,10,4,6,40,0,0,0,0,0,0,0,0,http://content7.flixster.com/movie/10/92/44/10924425_det.jpg
8138,Attack of the Giant Leeches,1959,leeches,0,0,0,0,0,0,0,0,0,0,0,0,0,http://content7.flixster.com/movie/55/32/72/5532729_det.jpg
8139,Deranged,1974,1032796-deranged,0,4,1,3,25,0,0,0,0,0,0,0,0,http://content6.flixster.com/movie/37/78/08/3778080_det.jpg
8140,The Cruel Sea,1953,cruel_sea,0,2,2,0,100,0,0,0,0,0,0,0,0,http://content9.flixster.com/movie/10/89/13/10891391_det.jpg
8142,Dead or Alive: Hanzaisha,1999,elvis-is-alive,0,0,0,0,0,0,0,0,0,0,0,0,0,http://content7.flixster.com/movie/10/89/42/10894213_det.jpg
8143,Lola Mont√®s,1955,lola_montes,7.8,27,23,4,85,7.3,10,8,2,80,3.8,488,78,http://content6.flixster.com/movie/10/93/52/10935248_det.jpg
8147,Charlie and the Chocolate Factory,2005,fly-thought-on-golden-wings,0,0,0,0,0,0,0,0,0,0,0,0,0,http://content8.flixster.com/movie/10/84/54/10845470_det.jpg
8148,Twice Upon a Time,1983,twice_upon_a_time,0,1,1,0,100,0,0,0,0,0,0,0,0,http://content6.flixster.com/movie/10/87/76/10877668_det.jpg
8149,"Atlantis, the Lost Continent",1961,1042327-atlantis_the_lost_continent,0,4,0,4,0,0,0,0,0,0,0,0,0,http://content8.flixster.com/movie/10/85/41/10854182_det.jpg
8153,Lust for Life,1956,1012920-lust_for_life,7.8,9,9,0,100,0,0,0,0,0,0,0,0,http://content8.flixster.com/movie/21/00/75/2100758_det.jpg
8154,La dolce vita,1960,dolce_vita,9.1,53,52,1,98,8.5,15,14,1,93,0,0,0,http://content8.flixster.com/movie/31/31/313110_det.jpg
8157,Jin-R√¥,1998,jinroh-the-wolf-brigade,5.8,22,12,10,54,5.4,7,4,3,57,3.7,3049,77,http://content6.flixster.com/movie/27/71/277100_det.jpg
8158,August Rush,2007,august_rush,4.8,120,44,76,36,4.4,27,7,20,25,4,105941,84,http://content6.flixster.com/movie/96/76/16/9676160_det.jpg
8167,Captain Blood,1935,,\N,\N,\N,\N,\N,\N,\N,\N,\N,\N,\N,\N,\N,\N
8168,De lift,1983,de-lift-the-lift-goin-up,0,0,0,0,0,0,0,0,0,0,0,0,0,http://content8.flixster.com/movie/34/78/55/3478554_det.gif
8169,*batteries not included,1987,batteries_not_included,5.6,13,8,5,61,0,2,2,0,100,3.2,9550,61,http://content6.flixster.com/movie/25/55/255524_det.jpg
8183,Educating Rita,1983,educating_rita,7.2,13,11,2,84,0,1,0,1,0,3.6,1843,77,http://content7.flixster.com/movie/11/13/45/11134573_det.jpg
8187,On Moonlight Bay,1951,on_moonlight_bay,6.2,5,5,0,100,0,0,0,0,0,0,0,0,http://content6.flixster.com/movie/10/91/92/10919200_det.jpg
8188,Sansh√¥ day√ª,1954,sansho_the_bailiff,9.1,10,10,0,100,0,0,0,0,0,0,0,0,http://content6.flixster.com/movie/53/80/71/5380716_det.jpg
8189,Zazie dans le m√©tro,1960,zazie-dans-le-metro-zazie-in-the-subway,0,0,0,0,0,0,0,0,0,0,0,0,0,http://content7.flixster.com/movie/60/26/69/6026697_det.jpg
8190,The Americanization of Emily,1964,americanization_of_emily,7.4,11,11,0,100,0,0,0,0,0,0,0,0,http://content6.flixster.com/movie/29/19/291908_det.jpg
8191,Anne of the Thousand Days,1969,anne_of_the_thousand_days,0,4,3,1,75,0,0,0,0,0,0,0,0,http://content8.flixster.com/movie/99/57/11/9957114_det.jpg
8194,Baby Doll,1956,baby_doll,8,14,14,0,100,0,3,3,0,100,3.9,746,81,http://content9.flixster.com/movie/51/08/00/5108007_det.jpg
8195,L'avventura,1960,lavventura,8.6,26,25,1,96,0,3,3,0,100,4.2,3223,90,http://content7.flixster.com/movie/29/31/293117_det.jpg
8196,Beyond the Valley of the Dolls,1970,beyond_the_valley_of_the_dolls,6.1,22,15,7,68,0,3,1,2,33,0,0,0,http://content9.flixster.com/movie/10/93/41/10934191_det.jpg
8197,Hiroshima mon amour,1959,hiroshima_mon_amour,8.4,18,17,1,94,0,2,2,0,100,4.2,3402,89,http://content9.flixster.com/movie/29/51/295199_det.jpg
8198,Die 1000 Augen des Dr. Mabuse,1960,1000_eyes_of_dr_mabuse,6.8,7,6,1,85,0,0,0,0,0,0,0,0,http://content7.flixster.com/movie/10/89/45/10894597_det.jpg
8199,Ugetsu monogatari,1953,ugetsu,8.9,19,19,0,100,8.4,5,5,0,100,4.3,1896,93,http://content8.flixster.com/movie/11/15/03/11150390_det.jpg
8201,At Play in the Fields of the Lord,1991,at_play_in_the_fields_of_the_lord,5.7,6,3,3,50,0,1,1,0,100,0,0,0,http://content9.flixster.com/movie/18/08/05/1808055_det.jpg
8202,Le carrosse d'or,1952,golden_coach,8.3,11,11,0,100,0,2,2,0,100,3.9,335,83,http://content7.flixster.com/movie/83/83/90/8383905_det.jpg
8203,La guerre est finie,1966,la_guerre_est_finie,8.2,7,7,0,100,0,3,3,0,100,3.8,194,72,http://content8.flixster.com/movie/93/74/86/9374862_det.jpg
8206,Mystery of the Wax Museum,1933,mystery_of_the_wax_museum,7.4,8,8,0,100,0,0,0,0,0,0,0,0,http://content7.flixster.com/movie/10/25/32/10253229_det.jpg
8207,The Day of the Jackal,1973,day_of_the_jackal,7.6,20,18,2,90,0,4,3,1,75,3.9,2316,86,http://content6.flixster.com/movie/25/55/255504_det.jpg
8208,The Razor's Edge,1984,1017238-razors_edge,5.4,15,8,7,53,0,1,0,1,0,3.7,879,77,http://content9.flixster.com/movie/25/71/257127_det.jpg
8220,Incubo sulla citt√† contaminata,1980,nightmare_city,0,4,2,2,50,0,0,0,0,0,0,0,0,http://content6.flixster.com/movie/10/89/70/10897052_det.jpg
8221,War of the Buttons,1994,war_of_the_buttons,0,2,2,0,100,0,0,0,0,0,0,0,0,http://content8.flixster.com/movie/83/05/830570_det.jpg
8222,The Other,1972,1015710-other,6.8,7,6,1,85,0,1,1,0,100,3.7,411,72,http://content7.flixster.com/movie/37/43/88/3743889_det.jpg
8225,Night of the Living Dead,1968,1015052-night_of_the_living_dead,8.5,45,43,2,95,7,5,4,1,80,3.7,26113,85,http://content6.flixster.com/movie/10/91/62/10916208_det.jpg
8227,Drums Along the Mohawk,1939,drums_along_the_mohawk,6.7,9,7,2,77,0,0,0,0,0,0,0,0,http://content6.flixster.com/movie/10/92/43/10924308_det.jpg
8228,The Maltese Falcon,1941,1013139-maltese_falcon,9,40,40,0,100,8.2,6,6,0,100,4,14452,90,http://content9.flixster.com/movie/10/87/69/10876999_det.jpg
8232,I Love You Again,1940,i_love_you_again,0,4,4,0,100,0,0,0,0,0,0,0,0,http://content7.flixster.com/movie/95/55/20/9555201_det.jpg
8235,Safety Last!,1923,safety_last,8.5,12,11,1,91,0,0,0,0,0,0,0,0,http://content6.flixster.com/movie/10/95/40/10954040_det.jpg
8236,While the City Sleeps,1956,while_the_city_sleeps,8.9,7,7,0,100,0,0,0,0,0,0,0,0,http://content9.flixster.com/movie/83/83/61/8383611_det.jpg
8238,Little Murders,1971,little_murders,6.4,7,4,3,57,0,1,1,0,100,3.7,356,77,http://content6.flixster.com/movie/27/85/278524_det.jpg
8239,Viridiana,1961,viridiana,8.9,19,19,0,100,0,2,2,0,100,4.2,2048,90,http://content6.flixster.com/movie/21/88/87/2188872_det.jpg
8240,Totally F***ed Up,1993,totally_fed_up,7.6,6,6,0,100,0,0,0,0,0,0,0,0,http://content6.flixster.com/movie/28/69/286928_det.jpg
8241,Megamind,2010,megamind,0,0,0,0,0,0,0,0,0,0,0,0,0,http://content7.flixster.com/movie/11/15/30/11153065_det.jpg
8252,You're a Big Boy Now,1966,youre_a_big_boy_now,6.4,9,7,2,77,0,3,3,0,100,3.3,183,46,http://content7.flixster.com/movie/11/12/37/11123737_det.jpg
8253,Rupan sansei: Kariosutoro no shiro,1979,lupin_the_3rd_castle_of_cagliostro,7,10,9,1,90,0,1,1,0,100,4,4187,86,http://content6.flixster.com/movie/10/93/50/10935020_det.jpg
8254,Arizona Dream,1993,,6.9,14,12,2,85,6.5,5,4,1,80,4,9613,83,http://content8.flixster.com/movie/95/48/954850_det.jpg
8255,Kaosu,1999,1121013-chaos,6.5,16,11,5,68,5.8,5,3,2,60,3.3,372,56,http://content7.flixster.com/movie/30/95/309513_det.jpg
8256,Queen Christina,1933,queen_christina,8.3,12,12,0,100,0,0,0,0,0,0,0,0,http://content9.flixster.com/movie/10/18/32/10183291_det.jpg
8257,Battleground,1949,1001816-battleground,8.4,5,5,0,100,0,0,0,0,0,0,0,0,http://content9.flixster.com/movie/10/86/72/10867231_det.jpg
8258,Citizen Toxie: The Toxic Avenger IV,2000,toxic_avenger_iv_citizen_toxie,5.9,9,6,3,66,0,2,1,1,50,3.3,1527,63,http://content7.flixster.com/movie/10/93/48/10934833_det.jpg
8259,The Texas Chain Saw Massacre,1974,1021112-texas_chainsaw_massacre,7.7,40,36,4,90,0,3,2,1,66,3.4,22149,78,http://content7.flixster.com/movie/27/47/274725_det.jpg
8260,Gadjo dilo,1997,crazy_stranger,7,21,17,4,80,7.5,6,6,0,100,4.1,1215,88,http://content9.flixster.com/movie/30/39/303999_det.jpg
8261,3 Women,1977,3_women,7.9,20,19,1,95,7.1,5,4,1,80,3.9,1570,85,http://content8.flixster.com/movie/26/16/261622_det.jpg
8262,The Green Pastures,1936,green_pastures,6.6,7,6,1,85,0,0,0,0,0,0,0,0,http://content8.flixster.com/movie/10/35/20/10352094_det.jpg
8263,Take Me Out to the Ball Game,1949,take_me_out_to_the_ballgame,7.5,6,6,0,100,0,0,0,0,0,0,0,0,http://content9.flixster.com/movie/29/78/297823_det.jpg
8264,Grey Gardens,1975,grey-gardens1975,8.4,16,16,0,100,0,4,4,0,100,4.1,2464,87,http://content6.flixster.com/movie/10/87/60/10876080_det.jpg
8265,The Frog Prince,1986,1043368-frog_prince,0,0,0,0,0,0,0,0,0,0,0,0,0,http://content9.flixster.com/movie/10/92/85/10928511_det.jpg
8266,Purple Rain,1984,purple_rain,6.3,29,22,7,75,0,2,1,1,50,3.3,7627,78,http://content6.flixster.com/movie/10/04/08/10040820_det.jpg
8267,Lebenszeichen,1968,1062610-signs_of_life,7.1,8,7,1,87,0,1,0,1,0,3.6,399,67,http://content6.flixster.com/movie/30/30/303008_det.jpg
8268,Point of No Return,1993,1042629-point_of_no_return,5.4,21,10,11,47,0,3,2,1,66,2.9,3771,51,http://content8.flixster.com/movie/26/99/269994_det.jpg
8269,Short Time,1990,short_time,4.6,5,1,4,20,0,1,0,1,0,3.6,119,65,http://content7.flixster.com/movie/10/54/28/10542813_det.jpg
8270,Le mari de la coiffeuse,1990,hairdressers_husband,8.1,10,10,0,100,0,0,0,0,0,0,0,0,http://content9.flixster.com/movie/39/89/95/3989955_det.jpg
8272,Cromwell,1970,cromwell,0,4,1,3,25,0,1,0,1,0,3.4,463,60,http://content8.flixster.com/movie/25/17/251798_det.jpg
8273,"Jam√≥n, jam√≥n",1992,jamon_jamon,7,10,8,2,80,0,2,1,1,50,3.5,1911,65,http://content9.flixster.com/movie/40/88/77/4088775_det.jpg
8275,College,2008,1191620-college,2.5,40,2,38,5,2.8,12,1,11,8,2.8,10667,35,http://content9.flixster.com/movie/10/84/13/10841311_det.jpg
8290,Mitchell,1975,mitchell,0,0,0,0,0,0,0,0,0,0,0,0,0,http://content9.flixster.com/movie/11/13/82/11138203_det.jpg
8291,Ten Little Indians,1965,1045403-ten_little_indians,0,1,0,1,0,0,0,0,0,0,0,0,0,http://content7.flixster.com/movie/10/91/72/10917265_det.jpg
8292,Hakuchi,1951,Hakuchi,7,7,6,1,85,0,0,0,0,0,0,0,0,http://content6.flixster.com/movie/40/82/04/4082048_det.jpg
8293,Used People,1992,used_people,5.2,12,5,7,41,0,2,0,2,0,3.1,89,30,http://content6.flixster.com/movie/10/85/43/10854332_det.jpg
8294,The Trumpet of the Swan,2001,trumpet_of_the_swan,3.4,40,5,35,12,3.2,15,1,14,6,2.9,930,39,http://content7.flixster.com/movie/25/23/252317_det.jpg
8295,The Most Dangerous Game,1932,most_dangerous_game,7.7,13,13,0,100,0,0,0,0,0,0,0,0,http://content9.flixster.com/movie/11/13/66/11136607_det.jpg
8302,The Front Page,1974,1037105-front_page,5.8,24,16,8,66,0,1,1,0,100,3.6,905,73,http://content9.flixster.com/movie/10/91/11/10911135_det.gif
8327,Dolls,2002,dolls2002,6.7,36,27,9,75,6.9,13,12,1,92,4.2,3709,87,http://content8.flixster.com/movie/10/88/89/10888962_det.jpg
8330,Our Man in Havana,1959,1205903-our_man_in_havana,7.7,5,5,0,100,0,0,0,0,0,0,0,0,http://content7.flixster.com/movie/11/12/29/11122989_det.jpg
8331,The Man Who Came to Dinner,1942,1013201-man_who_came_to_dinner,8,5,4,1,80,0,1,1,0,100,3.9,562,81,http://content9.flixster.com/movie/98/94/50/9894503_det.jpg
8332,Bloody Sunday,2002,bloody_sunday,7.9,102,94,8,92,8.2,30,28,2,93,4,2812,89,http://content8.flixster.com/movie/10/90/21/10902182_det.jpg
8334,Midnight Cowboy,1969,midnight_cowboy,8.3,49,44,5,89,6.8,6,5,1,83,3.9,8994,87,http://content6.flixster.com/movie/10/88/51/10885192_det.jpg
8336,The Major and the Minor,1942,major_and_the_minor,7.5,14,14,0,100,0,3,3,0,100,4,562,85,http://content6.flixster.com/movie/52/13/83/5213832_det.jpg
8337,The Caine Mutiny,1954,caine_mutiny,7.8,23,21,2,91,0,3,2,1,66,3.8,1792,85,http://content6.flixster.com/movie/29/16/291604_det.jpg
8338,Black Narcissus,1947,black_narcissus,8.7,23,23,0,100,0,3,3,0,100,4.1,1865,88,http://content9.flixster.com/movie/34/10/47/3410471_det.jpg
8340,Escape from Alcatraz,1979,escape_from_alcatraz,7,17,16,1,94,0,1,1,0,100,3.6,14313,78,http://content8.flixster.com/movie/25/79/257922_det.jpg
8341,Oliver Twist,2005,charles-dickens-the-man-who-asked-for-more,0,0,0,0,0,0,0,0,0,0,0,0,0,http://content8.flixster.com/movie/10/87/39/10873958_det.jpg
8360,Shrek 2,2004,shrek_2,7.6,210,186,24,88,7.3,40,35,5,87,3.5,228151,69,http://content9.flixster.com/movie/25/37/253795_det.jpg
8361,The Day After Tomorrow,2004,day_after_tomorrow,5.3,208,95,113,45,5.2,42,18,24,42,3.2,174938,57,http://content7.flixster.com/movie/25/43/254313_det.jpg
8362,Raising Helen,2004,raising_helen,4.6,126,28,98,22,4.7,35,6,29,17,3.2,23535,65,http://content7.flixster.com/movie/11/12/36/11123629_det.jpg
8363,Soul Plane,2004,soul_plane,3.6,97,18,79,18,3.9,27,4,23,14,2.8,10665,61,http://content8.flixster.com/movie/10/92/10/10921050_det.jpg
8364,How to Get the Man's Foot Outta Your Ass,2003,baadasssss,7.4,106,96,10,90,7.5,32,29,3,90,3.6,960,81,http://content9.flixster.com/movie/27/64/276495_det.jpg
8365,The Mother,2003,1132642-mother,7,88,68,20,77,7.4,32,29,3,90,3.4,862,61,http://content7.flixster.com/movie/27/51/275101_det.jpg
8366,Saved!,2004,saved,6.1,140,85,55,60,5.8,37,20,17,54,3.4,19848,75,http://content7.flixster.com/movie/10/89/26/10892601_det.jpg
8367,Le temps du loup,2003,1132644-time_of_the_wolf,6.2,53,33,20,62,6.5,16,12,4,75,3.5,1297,67,http://content8.flixster.com/movie/29/75/297598_det.jpg
8368,Harry Potter and the Prisoner of Azkaban,2004,chicken-shack-id-rather-go-live,0,0,0,0,0,0,0,0,0,0,0,0,0,http://content6.flixster.com/movie/10/85/01/10850148_det.jpg
8369,Mindhunters,2004,mindhunters,4.3,114,29,85,25,3.6,32,2,30,6,3.2,6070,61,http://content6.flixster.com/movie/96/27/18/9627188_det.jpg
8370,Zat√¥ichi,2003,1217686-zatoichi,7.2,113,98,15,86,7.4,29,27,2,93,3.9,10635,86,http://content7.flixster.com/movie/60/97/609777_det.jpg
8371,The Chronicles of Riddick,2004,chronicles_of_riddick,4.6,158,46,112,29,4,33,4,29,12,3.3,35951,73,http://content7.flixster.com/movie/10/88/45/10884541_det.jpg
8372,Garfield,2004,garfield,3.5,133,19,114,14,3.5,33,4,29,12,2.9,33314,54,http://content7.flixster.com/movie/25/44/254417_det.jpg
8373,The Stepford Wives,2004,stepford_wives,4.7,163,43,120,26,4.9,37,11,26,29,2.6,14476,36,http://content6.flixster.com/movie/25/84/258412_det.jpg
8374,Akarui mirai,2003,bright_future,6.6,20,14,6,70,5.3,7,3,4,42,3.6,823,70,http://content6.flixster.com/movie/10/88/86/10888612_det.jpg
8375,The Hunting of the President,2004,hunting_of_the_president,6.3,57,42,15,73,5.9,23,14,9,60,3.2,449,51,http://content7.flixster.com/movie/29/19/291917_det.jpg
8376,Napoleon Dynamite,2004,napoleon_dynamite,6.3,162,114,48,70,5.8,35,23,12,65,3.3,106996,73,http://content9.flixster.com/movie/10/92/76/10927695_det.jpg
8377,City of Joy,1992,city_of_joy,5,14,8,6,57,0,2,2,0,100,3.4,1490,70,http://content7.flixster.com/movie/26/11/261125_det.jpg
8378,Doctor Who,1996,doctor-who,0,0,0,0,0,0,0,0,0,0,0,0,0,http://content8.flixster.com/movie/65/85/89/6585890_det.jpg
8379,The Dresser,1983,dresser,8.1,13,13,0,100,0,1,1,0,100,3.8,466,80,http://content6.flixster.com/movie/26/23/262312_det.jpg
8380,Father Hood,1993,father_hood,2.3,8,0,8,0,0,2,0,2,0,2.7,1547,35,http://content6.flixster.com/movie/26/55/265528_det.jpg
8381,For Me and My Gal,1942,for_me_and_my_gal,7.6,7,7,0,100,0,0,0,0,0,0,0,0,http://content6.flixster.com/movie/10/90/35/10903596_det.jpg
8382,Hello Again,1987,hello_again,3.6,18,2,16,11,0,4,0,4,0,2.7,630,47,http://content7.flixster.com/movie/25/82/258209_det.jpg
8383,Hope Springs,2003,hope_springs,4.5,12,3,9,25,0,1,1,0,100,2.8,1628,31,http://content7.flixster.com/movie/26/09/260921_det.jpg
8384,Love Finds Andy Hardy,1938,love-finds-andy-hardy,0,0,0,0,0,0,0,0,0,0,0,0,0,http://content6.flixster.com/movie/10/88/42/10884280_det.jpg
8385,Lover Come Back,1961,lover_come_back,6.4,8,7,1,87,0,0,0,0,0,0,0,0,http://content8.flixster.com/movie/10/86/75/10867502_det.jpg
8387,Police Academy: Mission to Moscow,1994,police_academy_7_mission_to_moscow,0,3,0,3,0,0,0,0,0,0,0,0,0,http://content7.flixster.com/movie/10/87/17/10871761_det.jpg
8388,Ring of Bright Water,1969,ring_of_bright_water,7.1,5,5,0,100,0,0,0,0,0,0,0,0,http://content8.flixster.com/movie/10/88/86/10888618_det.jpg
8391,Big Wednesday,1978,big_wednesday,5.9,7,4,3,57,0,0,0,0,0,0,0,0,http://content8.flixster.com/movie/25/73/257394_det.jpg
8392,Fool for Love,1985,fool_for_love,5.5,11,8,3,72,0,3,2,1,66,3,339,37,http://content8.flixster.com/movie/28/12/281226_det.jpg
8393,Give My Regards to Broad Street,1984,give_my_regards_to_broad_street,4,13,3,10,23,0,3,0,3,0,2.8,184,32,http://content9.flixster.com/movie/93/74/20/9374207_det.jpg
8395,The Last of Sheila,1973,last_of_sheila,7.3,11,10,1,90,0,1,1,0,100,3.8,402,77,http://content9.flixster.com/movie/10/88/57/10885707_det.jpg
8397,Miss March,2009,10010760-miss_march,2.5,76,4,72,5,2.4,14,0,14,0,2.7,39534,34,http://content9.flixster.com/movie/11/15/35/11153531_det.jpg
8398,Major Movie Star,2008,major_movie_star,0,2,0,2,0,0,0,0,0,0,0,0,0,http://content6.flixster.com/movie/10/92/42/10924220_det.jpg
8399,We're Not Married!,1952,were_not_married,0,2,1,1,50,0,0,0,0,0,0,0,0,http://content7.flixster.com/movie/10/87/46/10874685_det.jpg
8400,Wish You Were Here,2005,wish-you-were-here-cruel-summer,0,0,0,0,0,0,0,0,0,0,0,0,0,http://content6.flixster.com/movie/10/89/13/10891380_det.jpg
8401,The Adventures of Sherlock Holmes,1939,adventures_of_sherlock_holmes,7.9,7,7,0,100,0,0,0,0,0,0,0,0,http://content7.flixster.com/movie/11/14/28/11142881_det.jpg
8402,Book of Love,2004,book_of_love,0,4,1,3,25,0,0,0,0,0,0,0,0,http://content7.flixster.com/movie/10/92/04/10920449_det.jpg
8403,Helen of Troy,1956,1070230-helen_of_troy,0,2,2,0,100,0,0,0,0,0,0,0,0,http://content9.flixster.com/movie/60/56/94/6056947_det.jpg
8404,The Hound of the Baskervilles,1959,1010004-hound_of_the_baskervilles,7.8,11,11,0,100,0,0,0,0,0,0,0,0,http://content6.flixster.com/movie/11/13/75/11137592_det.jpg
8405,Vargtimmen,1968,hour_of_the_wolf,7.5,16,14,2,87,0,3,2,1,66,3.9,1979,85,http://content8.flixster.com/movie/10/86/22/10862238_det.jpg
8407,The Molly Maguires,1970,molly_maguires,6.6,9,8,1,88,0,2,1,1,50,3.4,501,57,http://content6.flixster.com/movie/25/90/259096_det.jpg
8410,Suddenly,1954,1020415-suddenly,6.4,7,6,1,85,0,1,1,0,100,3.3,506,59,http://content6.flixster.com/movie/10/93/55/10935500_det.jpg
8411,Urban Ghost Story,1998,urban_ghost_story,0,4,4,0,100,0,0,0,0,0,0,0,0,http://content7.flixster.com/movie/10/88/03/10880397_det.jpg
8421,Muertos de risa,1999,dying_of_laughter,0,0,0,0,0,0,0,0,0,0,0,0,0,http://content8.flixster.com/movie/10/86/09/10860938_det.jpg
8422,Kings Row,1942,kings_row,7.6,13,13,0,100,0,0,0,0,0,0,0,0,http://content9.flixster.com/movie/10/85/40/10854035_det.jpg
8423,The Kid Brother,1927,10003356-kid_brother,0,3,3,0,100,0,0,0,0,0,0,0,0,http://content6.flixster.com/movie/10/33/38/10333860_det.jpg
8424,The Gay Divorcee,1934,gay_divorcee,7.8,8,8,0,100,0,0,0,0,0,0,0,0,http://content8.flixster.com/movie/37/40/82/3740826_det.jpg
8425,Meet the Applegates,1990,applegates,4.4,9,1,8,11,0,1,0,1,0,0,0,0,http://content6.flixster.com/movie/10/86/76/10867692_det.jpg
8426,Robotto k√¢nibaru,1987,robotto-kanibaru-robot-carnival,0,0,0,0,0,0,0,0,0,0,0,0,0,http://content9.flixster.com/movie/89/68/72/8968727_det.jpg
8427,Americathon,1979,americathon_1998,0,0,0,0,0,0,0,0,0,0,0,0,0,http://content7.flixster.com/movie/28/97/92/2897925_det.jpg
8446,Sands of Iwo Jima,1949,sands_of_iwo_jima,7.4,10,10,0,100,0,0,0,0,0,0,0,0,http://content8.flixster.com/movie/10/88/01/10880182_det.jpg
8447,This Island Earth,1955,this_island_earth,5,11,7,4,63,0,0,0,0,0,0,0,0,http://content8.flixster.com/movie/10/89/84/10898406_det.jpg
8450,Anthony Adverse,1936,anthony_adverse,0,2,0,2,0,0,0,0,0,0,0,0,0,http://content6.flixster.com/movie/56/77/79/5677792_det.jpg
8451,Blackboard Jungle,1955,blackboard_jungle,7.1,21,16,5,76,0,3,2,1,66,3.5,811,72,http://content9.flixster.com/movie/10/87/75/10877587_det.jpg
8452,Moment by Moment,1978,moment-by-moment,0,0,0,0,0,0,0,0,0,0,0,0,0,http://content6.flixster.com/movie/10/83/97/10839716_det.jpg
8453,It Had to Be You,1947,it-had-to-be-you-1947,0,0,0,0,0,0,0,0,0,0,0,0,0,http://images.rottentomatoescdn.com/images/defaults/poster_default.gif
8454,Luna Papa,1999,luna-papa-moon-father,0,0,0,0,0,0,0,0,0,0,0,0,0,http://content8.flixster.com/movie/37/12/74/3712742_det.jpg
8455,Raising Victor Vargas,2002,raising_victor_vargas,7.9,105,101,4,96,8,31,31,0,100,3.8,1155,81,http://content6.flixster.com/movie/27/85/278504_det.jpg
8456,Indagine su un cittadino al di sopra di ogni sospetto,1970,investigation_of_a_citizen_above_suspicion,7.9,5,5,0,100,0,3,3,0,100,4.4,483,97,http://content6.flixster.com/movie/53/53/00/5353004_det.jpg
8457,True Love,1989,1022079-true_love,6.2,8,6,2,75,0,1,1,0,100,3.2,207,50,http://content7.flixster.com/movie/27/59/275909_det.jpg
8458,Chacun son cin√©ma ou Ce petit coup au coeur quand la lumi√®re s'√©teint et que le film commence,2007,chacun-son-cinema-to-each-his-cinema,6.8,5,5,0,100,0,2,2,0,100,3.6,664,72,http://content9.flixster.com/movie/10/84/75/10847535_det.jpg
8459,The Heiress,1949,heiress,8.6,7,7,0,100,0,0,0,0,0,0,0,0,http://content8.flixster.com/movie/51/29/35/5129350_det.jpg
8460,State Fair,1945,1029261-state_fair,6.4,5,4,1,80,0,0,0,0,0,0,0,0,http://content6.flixster.com/movie/29/64/296412_det.jpg
8461,Dragon Seed,1944,dragon_seed,0,3,2,1,66,0,0,0,0,0,0,0,0,http://content6.flixster.com/movie/10/89/81/10898184_det.jpg
8462,Executive Suite,1954,executive_suite,8,7,7,0,100,0,0,0,0,0,0,0,0,http://content8.flixster.com/movie/73/95/69/7395698_det.jpg
8463,Johnny Belinda,1948,1011176-johnny_belinda,7.1,7,6,1,85,0,0,0,0,0,0,0,0,http://content7.flixster.com/movie/10/83/81/10838145_det.jpg
8464,Super Size Me,2004,food-and-culture,0,0,0,0,0,0,0,0,0,0,0,0,0,http://images.rottentomatoescdn.com/images/defaults/poster_default.gif
8465,Johnny Eager,1941,johnny_eager,0,2,1,1,50,0,1,1,0,100,3.7,182,73,http://content9.flixster.com/movie/73/51/55/7351555_det.jpg
8477,La jet√©e,1962,la_jetee,8.4,21,19,2,90,0,3,2,1,66,4.4,3059,93,http://content9.flixster.com/movie/34/73/90/3473903_det.jpg
8478,"Distant Voices, Still Lives",1988,distant_voices_still_lives,7.9,15,13,2,86,0,1,1,0,100,4.2,292,87,http://content9.flixster.com/movie/66/49/21/6649215_det.jpg
8480,King of Kings,1961,1011626-king_of_kings,6.2,14,11,3,78,0,4,2,2,50,3.7,879,75,http://content8.flixster.com/movie/11/13/74/11137462_det.jpg
8481,'Northwest Passage' (Book I -- Rogers' Rangers),1940,northwest_passage,8.8,6,6,0,100,0,0,0,0,0,0,0,0,http://content8.flixster.com/movie/10/94/65/10946566_det.jpg
8482,The Picture of Dorian Gray,1945,1016302-picture_of_dorian_gray,7.9,9,8,1,88,0,0,0,0,0,0,0,0,http://content6.flixster.com/movie/10/83/82/10838244_det.jpg
8483,The Born Losers,1967,born_losers,5.8,5,3,2,60,0,0,0,0,0,0,0,0,http://content8.flixster.com/movie/26/30/263098_det.jpg
8484,Ningen no j√¥ken,1959,human_condition,7.3,8,7,1,87,0,3,2,1,66,4.4,321,94,http://content7.flixster.com/movie/11/14/69/11146953_det.jpg
8485,Samsara,2001,10002103-samsara,7.3,5,5,0,100,0,3,3,0,100,4.1,3198,85,http://content7.flixster.com/movie/10/89/76/10897697_det.jpg
8486,Bachelor Mother,1939,bachelor_mother,0,4,3,1,75,0,0,0,0,0,0,0,0,http://content9.flixster.com/movie/44/31/88/4431887_det.jpg
8487,Please Don't Eat the Daisies,1960,please_dont_eat_the_daisies,5.5,6,4,2,66,0,0,0,0,0,0,0,0,http://content6.flixster.com/movie/11/13/15/11131592_det.jpg
8488,Siddhartha,1972,siddhartha,6.7,17,10,7,58,6.4,7,4,3,57,3.3,225,57,http://content9.flixster.com/movie/27/09/270923_det.jpg
8491,White Heat,1949,white_heat,8.4,28,28,0,100,0,4,4,0,100,4.2,2557,93,http://content9.flixster.com/movie/10/08/01/10080155_det.jpg
8492,Scrooge,1951,1004126-christmas_carol,7.7,23,19,4,82,0,3,2,1,66,3.3,4980,71,http://content7.flixster.com/movie/10/92/45/10924541_det.gif
8493,Memphis Belle,1990,1031087-memphis_belle,6,15,11,4,73,0,2,2,0,100,3.4,3799,75,http://content6.flixster.com/movie/10/88/63/10886312_det.jpg
8494,The Cincinnati Kid,1965,cincinnati_kid,7.7,16,14,2,87,0,2,1,1,50,3.6,1393,77,http://content7.flixster.com/movie/48/47/42/4847421_det.jpg
8495,Animal Factory,2000,animal_factory,6.7,32,26,6,81,6.7,5,4,1,80,3.2,2952,55,http://content8.flixster.com/movie/28/26/282626_det.jpg
8496,The Panic in Needle Park,1971,1156599-panic_in_needle_park,7,9,7,2,77,0,1,1,0,100,3.6,1885,74,http://content9.flixster.com/movie/10/91/39/10913979_det.jpg
8499,Pretty Baby,1978,pretty_baby,6.9,14,11,3,78,0,0,0,0,0,0,0,0,http://content6.flixster.com/movie/26/85/268512_det.jpg
8501,The Hitcher,2007,hitcher,3.8,93,19,74,20,3.5,16,2,14,12,3.1,49309,59,http://content6.flixster.com/movie/10/86/94/10869428_det.jpg
8502,Show Boat,1936,1018915-show_boat,9.4,8,8,0,100,0,0,0,0,0,0,0,0,http://content6.flixster.com/movie/48/61/12/4861124_det.jpg
8503,Ivanhoe,1952,1010824-ivanhoe,5.6,10,7,3,70,0,0,0,0,0,0,0,0,http://content9.flixster.com/movie/93/87/93/9387935_det.jpg
8504,Box of Moon Light,1996,box_of_moonlight,6.7,16,9,7,56,5.8,5,1,4,20,3.9,803,83,http://content8.flixster.com/movie/10/91/91/10919194_det.jpg
8505,Unagi,1997,eel,7,25,19,6,76,6.7,6,5,1,83,3.8,686,81,http://content9.flixster.com/movie/30/55/305507_det.jpg
8506,Fear X,2003,fear_x,5.8,32,18,14,56,6.3,7,5,2,71,2.7,512,30,http://content8.flixster.com/movie/30/75/307510_det.jpg
8507,Freaks,1932,freaks,8.3,41,39,2,95,0,3,3,0,100,4,6354,87,http://content7.flixster.com/movie/56/75/62/5675629_det.jpg
8511,The Immigrant,1917,immigrant,0,0,0,0,0,0,0,0,0,0,0,0,0,http://content7.flixster.com/movie/10/85/69/10856929_det.jpg
8512,Silent Movie,1976,silent_movie,7.1,19,17,2,89,0,1,1,0,100,3.4,3857,65,http://content6.flixster.com/movie/10/89/83/10898360_det.jpg
8516,A Matter of Life and Death,1946,1077183-stairway_to_heaven,8.7,17,17,0,100,0,1,1,0,100,4.4,2083,94,http://content6.flixster.com/movie/11/14/77/11147764_det.jpg
8518,Anna Christie,1930,1001060-anna_christie,0,1,1,0,100,0,0,0,0,0,0,0,0,http://content9.flixster.com/movie/10/85/87/10858755_det.jpg
8519,The Bat People,1974,bat_people,0,0,0,0,0,0,0,0,0,0,0,0,0,http://content6.flixster.com/movie/10/89/79/10897928_det.jpg
8520,Deep Cover,1992,1039270-deep_cover,6.6,20,17,3,85,5.8,8,6,2,75,3.4,1559,70,http://content9.flixster.com/movie/10/88/93/10889327_det.jpg
8521,Dr. Jekyll and Mr. Hyde,2008,dr_jekyll_and_mr_hyde,0,1,0,1,0,0,0,0,0,0,0,0,0,http://content9.flixster.com/movie/11/12/32/11123215_det.jpg
8522,My Little Chickadee,1940,my_little_chickadee,7.4,10,9,1,90,0,0,0,0,0,0,0,0,http://content8.flixster.com/movie/71/37/03/7137030_det.jpg
8524,The High and the Mighty,1954,high_and_the_mighty,5.6,8,3,5,37,0,0,0,0,0,0,0,0,http://content6.flixster.com/movie/96/22/02/9622024_det.jpg
8525,The Ugly Dachshund,1966,ugly_dachshund,0,3,2,1,66,0,0,0,0,0,0,0,0,http://content6.flixster.com/movie/38/14/50/3814504_det.jpg
8526,Around the World in 80 Days,2004,around_the_world_in_80_days,4.8,127,39,88,30,4.7,33,9,24,27,2.7,14038,45,http://content7.flixster.com/movie/11/14/86/11148613_det.jpg
8527,I'll Sleep When I'm Dead,2003,ill_sleep_when_im_dead,5.5,86,37,49,43,5.9,27,14,13,51,2.9,2107,38,http://content6.flixster.com/movie/10/89/25/10892552_det.jpg
8528,Dodgeball: A True Underdog Story,2004,dodgeball_a_true_underdog_story,6.3,159,111,48,69,6.3,36,23,13,63,3.4,118948,75,http://content9.flixster.com/movie/10/94/04/10940443_det.jpg
8529,The Terminal,2004,1133499-1133499-terminal,6.2,198,119,79,60,5.8,43,22,21,51,3.4,42895,72,http://content8.flixster.com/movie/55/04/86/5504862_det.jpg
8530,Dear Frankie,2004,dear_frankie,6.8,109,88,21,80,6.8,32,26,6,81,4,6479,90,http://content8.flixster.com/movie/10/91/90/10919002_det.jpg
8531,White Chicks,2004,white_chicks,3.7,122,18,104,14,4.6,33,10,23,30,3,193197,62,http://content6.flixster.com/movie/55/05/41/5505412_det.jpg
8532,The Door in the Floor,2004,door_in_the_floor,6.4,140,92,48,65,6.2,38,22,16,57,3.3,2273,63,http://content6.flixster.com/movie/26/80/268000_det.jpg
8533,The Notebook,2004,brian-eno14-video-paintings,0,0,0,0,0,0,0,0,0,0,0,0,0,http://content7.flixster.com/movie/29/99/299901_det.jpg
8534,Deux fr√®res,2004,two_brothers,6.6,112,87,25,77,6.2,32,25,7,78,3.4,4817,74,http://content8.flixster.com/movie/11/15/35/11153554_det.jpg
8535,De-Lovely,2004,delovely,5.7,153,74,79,48,5.2,40,17,23,42,3.3,2857,63,http://content9.flixster.com/movie/10/91/92/10919251_det.jpg
8537,Kaena: La proph√©tie,2003,kaena_the_prophecy,3.9,30,2,28,6,3.8,12,0,12,0,2.9,1510,46,http://content9.flixster.com/movie/10/85/34/10853431_det.jpg
8540,Back to Bataan,1945,back_to_bataan,0,3,2,1,66,0,0,0,0,0,0,0,0,http://content9.flixster.com/movie/29/60/296023_det.jpg
8541,Bloodhounds of Broadway,1989,1002651-bloodhounds_of_broadway,0,0,0,0,0,0,0,0,0,0,0,0,0,http://content7.flixster.com/movie/86/23/09/8623093_det.jpg
8542,A Day at the Races,1937,day_at_the_races,7.8,12,12,0,100,0,0,0,0,0,0,0,0,http://content9.flixster.com/movie/95/84/15/9584151_det.jpg
8543,Flying Leathernecks,1951,flying_leathernecks,6.8,7,6,1,85,0,1,1,0,100,3.4,821,62,http://content9.flixster.com/movie/10/86/81/10868191_det.jpg
8544,"Now You See Him, Now You Don't",1972,now_you_see_him_now_you_dont,0,1,0,1,0,0,0,0,0,0,0,0,0,http://content9.flixster.com/movie/10/87/11/10871135_det.jpg
8545,Briar Patch,2003,briar-patch-plain-dirty,0,0,0,0,0,0,0,0,0,0,0,0,0,http://content6.flixster.com/movie/62/78/01/6278012_det.jpg
8571,Bob & Carol & Ted & Alice,1969,bob_and_carol_and_ted_and_alice,7.4,9,8,1,88,0,1,1,0,100,3.4,516,62,http://content9.flixster.com/movie/78/46/17/7846171_det.jpg
8572,The Littlest Rebel,1935,littlest_rebel,5.9,8,7,1,87,0,0,0,0,0,0,0,0,http://content6.flixster.com/movie/98/44/24/9844240_det.jpg
8573,Reconstruction,2003,1133634-reconstruction,6.4,37,28,9,75,6.8,13,10,3,76,4.1,1344,86,http://content8.flixster.com/movie/26/43/264314_det.jpg
8574,A Claymation Christmas Celebration,1987,a-claymation-christmas-celebration,0,0,0,0,0,0,0,0,0,0,0,0,0,http://content9.flixster.com/movie/25/07/250799_det.jpg
8575,Le battement d'ailes du papillon,2000,happenstance,6,36,23,13,63,6.5,16,12,4,75,3.6,1840,71,http://content9.flixster.com/movie/10/91/17/10911751_det.jpg
8576,Kopps,2003,kopps,0,3,2,1,66,0,0,0,0,0,0,0,0,http://content9.flixster.com/movie/10/89/38/10893879_det.jpg
8577,Comandante,2003,comandante,5.6,13,8,5,61,0,1,0,1,0,3.5,658,63,http://content9.flixster.com/movie/10/88/87/10888703_det.jpg
8578,Undead,2003,undead_2003,4.3,74,22,52,29,3.2,20,1,19,5,3,4889,48,http://content9.flixster.com/movie/10/87/15/10871571_det.jpg
8579,The Scarlet and the Black,1993,,\N,\N,\N,\N,\N,\N,\N,\N,\N,\N,\N,\N,\N,\N
8580,Into the Woods,1991,into-the-woods-1991,0,0,0,0,0,0,0,0,0,0,0,0,0,http://content9.flixster.com/movie/59/52/10/5952107_det.jpg
8581,Pirates of Silicon Valley,1999,pirates_of_silicon_valley,6.8,7,6,1,85,0,0,0,0,0,0,0,0,http://content9.flixster.com/movie/10/90/59/10905935_det.jpg
8582,Manufacturing Consent: Noam Chomsky and the Media,1992,manufacturing_consent_noam_chomsky_and_the_media,8.1,7,7,0,100,0,0,0,0,0,0,0,0,http://content6.flixster.com/movie/29/17/291704_det.jpg
8583,Twelve O'Clock High,1949,1022172-twelve_oclock_high,8.2,14,14,0,100,0,0,0,0,0,0,0,0,http://content9.flixster.com/movie/11/15/02/11150275_det.jpg
8584,Leave Her to Heaven,1945,leave_her_to_heaven,8.4,17,17,0,100,7.5,5,5,0,100,3.8,937,81,http://content9.flixster.com/movie/10/87/86/10878603_det.jpg
8585,Rapa Nui,1994,rapanui,0,0,0,0,0,0,0,0,0,0,0,0,0,http://content9.flixster.com/movie/27/64/276411_det.jpg
8586,Roxie Hart,1942,roxie_hart,7.1,9,8,1,88,0,0,0,0,0,0,0,0,http://content7.flixster.com/movie/30/24/302429_det.jpg
8587,Mayor of the Sunset Strip,2003,1126416-mayor_of_the_sunset_strip,7.4,75,65,10,86,7.4,27,25,2,92,3.5,553,67,http://content9.flixster.com/movie/10/87/78/10877875_det.jpg
8588,Killing Me Softly,2002,killing_me_softly,3.4,21,0,21,0,0,2,0,2,0,3,2072,46,http://content9.flixster.com/movie/28/60/286091_det.jpg
8589,Talvisota,1989,talvisota-winter-war,0,0,0,0,0,0,0,0,0,0,0,0,0,http://content9.flixster.com/movie/38/55/90/3855903_det.jpg
8591,The Philadelphia Experiment,1984,philadelphia_experiment,5.1,10,5,5,50,0,0,0,0,0,0,0,0,http://content8.flixster.com/movie/10/93/79/10937994_det.jpg
8592,The Wheeler Dealers,1963,wheeler_dealers,0,0,0,0,0,0,0,0,0,0,0,0,0,http://content8.flixster.com/movie/10/85/47/10854778_det.jpg
8593,Juice,1992,juice,6.3,13,11,2,84,0,2,2,0,100,0,0,0,http://content9.flixster.com/movie/26/79/267907_det.jpg
8594,The Secret Life of Girls,1999,secret_life_of_girls,0,1,0,1,0,0,0,0,0,0,0,0,0,http://content7.flixster.com/movie/10/88/77/10887721_det.jpg
8595,The Flim-Flam Man,1967,flimflam_man,6.4,7,5,2,71,0,1,1,0,100,3.8,91,66,http://content8.flixster.com/movie/10/91/54/10915462_det.jpg
8596,Revenge of the Pink Panther,1978,revenge_of_the_pink_panther,6.7,16,13,3,81,0,0,0,0,0,0,0,0,http://content6.flixster.com/movie/10/87/22/10872256_det.jpg
8597,Whale Rider,2002,whale_rider,7.7,143,129,14,90,7.5,35,30,5,85,3.8,9564,87,http://content8.flixster.com/movie/25/40/254098_det.jpg
8598,I Am Dina,2002,1206485-i_am_dina,0,2,1,1,50,0,2,1,1,50,3.7,1055,74,http://content7.flixster.com/movie/10/91/01/10910121_det.jpg
8599,The Escapist,2008,10009334-the_escapist,6.1,42,27,15,64,6,10,6,4,60,3.3,2418,63,http://content9.flixster.com/movie/10/86/78/10867827_det.jpg
8600,Angels with Dirty Faces,1938,angels_with_dirty_faces,8,20,20,0,100,0,0,0,0,0,0,0,0,http://content8.flixster.com/movie/10/92/03/10920306_det.jpg
8601,Z√©ro de conduite: Jeunes diables au coll√®ge,1933,zero-de-conduite-1932,8.9,12,11,1,91,0,3,2,1,66,0,0,0,http://content7.flixster.com/movie/11/15/22/11152261_det.jpg
8602,Senki,2007,1206670-shadows,5.8,15,9,6,60,0,4,2,2,50,3.6,188,61,http://content6.flixster.com/movie/10/89/11/10891168_det.jpg
8603,Coming Out,1989,coming-out,0,0,0,0,0,0,0,0,0,0,0,0,0,http://content8.flixster.com/movie/28/95/289518_det.jpg
8604,Taxi,2004,taxi,3.4,104,11,93,10,3.8,27,5,22,18,2.8,15669,60,http://content7.flixster.com/movie/10/91/40/10914017_det.jpg
8605,Taxi 3,2003,taxi_3,0,1,1,0,100,0,0,0,0,0,0,0,0,http://content9.flixster.com/movie/10/91/40/10914019_det.jpg
8606,Pull My Daisy,1959,pull_my_daisy,0,0,0,0,0,0,0,0,0,0,0,0,0,http://content9.flixster.com/movie/11/15/10/11151003_det.jpg
8607,Tokyo Godfathers,2003,tokyo_godfathers,7.1,57,51,6,89,7.1,21,19,2,90,4,3789,89,http://content7.flixster.com/movie/10/87/27/10872793_det.jpg
8608,Le boucher,1970,le-boucher,8.6,7,7,0,100,0,1,1,0,100,3.9,689,81,http://content9.flixster.com/movie/10/89/27/10892743_det.jpg
8609,Our Hospitality,1923,our_hospitality,9.5,17,17,0,100,0,0,0,0,0,0,0,0,http://content8.flixster.com/movie/10/98/24/10982454_det.jpg
8610,Walk All Over Me,2007,1194274-walk_all_over_me,0,4,2,2,50,0,1,0,1,0,3,609,37,http://content6.flixster.com/movie/10/91/88/10918812_det.jpg
8611,The Farmer's Daughter,1947,farmers_daughter,0,4,4,0,100,0,0,0,0,0,0,0,0,http://content9.flixster.com/movie/99/15/25/9915255_det.jpg
8612,Lassie Come Home,1943,lassie_come_home,7.5,7,6,1,85,0,0,0,0,0,0,0,0,http://content7.flixster.com/movie/92/06/79/9206797_det.jpg
8613,The Time of Your Life,1948,1021507-time_of_your_life,0,0,0,0,0,0,0,0,0,0,0,0,0,http://content7.flixster.com/movie/54/15/40/5415405_det.jpg
8614,Overboard,1987,overboard,5.1,21,11,10,52,0,3,1,2,33,3.2,9078,70,http://content6.flixster.com/movie/25/47/254700_det.jpg
8615,The Mask of Fu Manchu,1932,mask_of_fu_manchu,6.6,7,6,1,85,0,0,0,0,0,0,0,0,http://content8.flixster.com/movie/10/90/09/10900946_det.jpg
8616,By the Light of the Silvery Moon,1953,by_the_light_of_the_silvery_moon,0,1,1,0,100,0,0,0,0,0,0,0,0,http://content9.flixster.com/movie/10/13/56/10135683_det.jpg
8617,BUtterfield 8,1960,butterfield_8,5.6,12,7,5,58,0,0,0,0,0,0,0,0,http://content7.flixster.com/movie/29/89/298993_det.jpg
8618,Johnny Guitar,1954,johnny_guitar,8.4,23,22,1,95,0,3,2,1,66,4,1015,85,http://content7.flixster.com/movie/10/92/31/10923173_det.jpg
8619,Sister My Sister,1994,sister_my_sister,5.7,8,4,4,50,0,0,0,0,0,0,0,0,http://content9.flixster.com/movie/28/53/285319_det.jpg
8620,El √°ngel exterminador,1962,le-angel-exterminador-the-exterminating-angel,8.9,17,16,1,94,0,2,1,1,50,4.3,2257,94,http://content7.flixster.com/movie/32/87/59/3287593_det.jpg
8621,Ivansxtc,2000,ivans_xtc,6.8,28,21,7,75,7.2,9,7,2,77,3.7,269,71,http://content7.flixster.com/movie/19/68/75/1968753_det.jpg
8622,Fahrenheit 9/11,2004,fahrenheit_911,7.3,224,187,37,83,7.4,45,37,8,82,3.3,22990,69,http://content6.flixster.com/movie/26/70/267092_det.jpg
8623,Roxanne,1987,roxanne,7.3,33,29,4,87,6,6,4,2,66,3,5654,57,http://content6.flixster.com/movie/25/75/257596_det.jpg
8624,Freedom Downtime,2001,freedom-downtime,0,0,0,0,0,0,0,0,0,0,0,0,0,http://content8.flixster.com/movie/10/92/30/10923066_det.gif
8625,The Same River Twice,2003,1125396-same_river_twice,6.7,31,21,10,67,6.7,14,10,4,71,3.8,44,67,http://content7.flixster.com/movie/10/87/60/10876017_det.jpg
8626,Dr. Terror's House of Horrors,1965,dr_terrors_house_of_horrors,0,4,4,0,100,0,0,0,0,0,0,0,0,http://content6.flixster.com/movie/49/10/88/4910880_det.jpg
8628,Search and Destroy,1995,1062111-search_and_destroy,4,8,2,6,25,0,3,1,2,33,3,597,45,http://content8.flixster.com/movie/28/12/281206_det.jpg
8629,The Book of Life,1998,book_of_life,7.5,9,8,1,88,0,0,0,0,0,0,0,0,http://content9.flixster.com/movie/10/87/93/10879359_det.jpg
8630,Such a Long Journey,1998,such-a-long-journey,7.4,13,12,1,92,7.4,5,5,0,100,3.4,185,66,http://content9.flixster.com/movie/10/85/21/10852103_det.jpg
8631,"Maxed Out: Hard Times, Easy Credit and the Era of Predatory Lenders",2006,maxed-out,7,48,42,6,87,6.6,19,15,4,78,3.1,68987,50,http://content8.flixster.com/movie/91/04/03/9104034_det.jpg
8632,Secret Society,2000,secret_society,5.1,9,3,6,33,0,4,1,3,25,2.8,63,50,http://content8.flixster.com/movie/10/92/05/10920526_det.jpg
8633,The Last Starfighter,1984,last_starfighter,6.2,26,19,7,73,0,1,0,1,0,3.3,6360,65,http://content6.flixster.com/movie/10/86/14/10861432_det.jpg
8634,Tank Girl,1995,tank_girl,4.9,33,14,19,42,5.3,9,4,5,44,2.8,7013,61,http://content8.flixster.com/movie/10/91/40/10914042_det.jpg
8635,Ultimo mondo cannibale,1977,jungle_holocaust,0,2,1,1,50,0,0,0,0,0,0,0,0,http://content7.flixster.com/movie/10/91/94/10919461_det.jpg
8636,Spider-Man,2002,citizen-pinoy-the-basic-questions,0,0,0,0,0,0,0,0,0,0,0,0,0,http://content6.flixster.com/movie/10/89/27/10892728_det.jpg
8637,America's Heart and Soul,2004,soul,0,0,0,0,0,0,0,0,0,0,0,0,0,http://content9.flixster.com/movie/10/92/10/10921047_det.jpg
8638,Before Sunset,2004,before_sunset,8.3,158,150,8,94,8.4,39,38,1,97,4,20750,90,http://content8.flixster.com/movie/59/94/32/5994322_det.jpg
8639,The Clearing,2004,clearing,5.6,128,56,72,43,5.5,34,16,18,47,2.9,1494,35,http://content8.flixster.com/movie/27/41/274102_det.jpg
8640,King Arthur,2004,1133964-king_arthur,4.9,183,57,126,31,5.2,38,12,26,31,3.2,57867,63,http://content6.flixster.com/movie/10/92/97/10929712_det.jpg
8642,Sleepover,2004,sleepover,3.7,95,14,81,14,3.9,29,5,24,17,3.3,29842,62,http://content6.flixster.com/movie/10/94/27/10942700_det.jpg
8643,Another Cinderella Story,2008,another_cinderella_story,0,2,2,0,100,0,0,0,0,0,0,0,0,http://content8.flixster.com/movie/10/87/01/10870182_det.jpg
8644,"I, Robot",2004,domain-of-murder,0,0,0,0,0,0,0,0,0,0,0,0,0,http://content9.flixster.com/movie/10/84/80/10848035_det.jpg
8645,Maria Full of Grace,2004,maria_full_of_grace,8,137,133,4,97,8.2,34,33,1,97,3.8,9542,84,http://content9.flixster.com/movie/26/70/267091_det.jpg
8647,Follow That Dream,1962,follow_that_dream,0,2,2,0,100,0,0,0,0,0,0,0,0,http://content6.flixster.com/movie/28/74/67/2874676_det.jpg
8648,La ni√±a de tus ojos,1998,girl_of_your_dreams,0,0,0,0,0,0,0,0,0,0,0,0,0,http://content9.flixster.com/movie/31/10/311003_det.jpg
8649,Gray Lady Down,1978,gray_lady_down,6,5,3,2,60,0,0,0,0,0,0,0,0,http://content6.flixster.com/movie/31/07/310724_det.jpg
8650,Long Day's Journey Into Night,1962,1012647-long_days_journey_into_night,8.3,13,12,1,92,0,1,1,0,100,3.9,807,82,http://content8.flixster.com/movie/10/88/50/10885086_det.jpg
8651,Man of La Mancha,1972,man-of-la-mancha,5.5,12,6,6,50,0,1,0,1,0,0,0,0,http://content9.flixster.com/movie/11/12/76/11127631_det.jpg
8652,The Night of the Following Day,1968,night_of_the_following_day,7.2,5,5,0,100,0,1,1,0,100,3.3,195,44,http://content8.flixster.com/movie/60/86/15/6086154_det.jpg
8653,Posse,1993,1043958-posse,5.1,15,5,10,33,0,4,1,3,25,2.8,1087,45,http://content9.flixster.com/movie/10/88/59/10885983_det.jpg
8654,Prince Valiant,1954,1033462-prince_valiant,0,0,0,0,0,0,0,0,0,0,0,0,0,http://content9.flixster.com/movie/25/83/258391_det.jpg
8655,Rustlers' Rhapsody,1985,rustlers_rhapsody,0,4,0,4,0,0,0,0,0,0,0,0,0,http://content8.flixster.com/movie/25/79/257998_det.jpg
8656,Kr√≥tki film o zabijaniu,1988,short_film_about_killing,7.7,12,10,2,83,0,3,2,1,66,4.2,1659,92,http://content7.flixster.com/movie/30/68/306813_det.jpg
8657,The Tin Star,1957,tin_star,0,4,4,0,100,0,0,0,0,0,0,0,0,http://content9.flixster.com/movie/29/84/298411_det.jpg
8658,Zandalee,1991,zandalee,4,6,2,4,33,0,0,0,0,0,0,0,0,http://content7.flixster.com/movie/46/77/56/4677569_det.jpg
8659,Br√®ve travers√©e,2001,brief_crossing,0,2,2,0,100,0,0,0,0,0,0,0,0,http://content7.flixster.com/movie/10/91/79/10917977_det.jpg
8660,Potop,1974,deluge,0,0,0,0,0,0,0,0,0,0,0,0,0,http://content8.flixster.com/movie/88/41/08/8841086_det.jpg
8661,How the West Was Won,1962,how_the_west_was_won,7.1,15,14,1,93,0,0,0,0,0,0,0,0,http://content7.flixster.com/movie/10/93/43/10934329_det.jpg
8662,Joan of Arc,1999,messenger_the_story_of_joan_of_arc,4.5,72,22,50,30,3.4,21,1,20,4,3.1,8110,57,http://content6.flixster.com/movie/10/88/57/10885720_det.jpg
8663,Live Forever,2003,live_forever,5.6,5,4,1,80,0,0,0,0,0,0,0,0,http://content6.flixster.com/movie/10/89/38/10893800_det.jpg
8664,Mr. Klein,1976,monsieur-klein-1976,0,0,0,0,0,0,0,0,0,0,0,0,0,http://content6.flixster.com/movie/10/89/93/10899396_det.jpg
8665,The Bourne Supremacy,2004,bourne_supremacy,7.2,185,150,35,81,7,39,29,10,74,3.9,111547,89,http://content8.flixster.com/movie/10/81/65/10816574_det.jpg
8666,Catwoman,2004,catwoman,3.1,177,17,160,9,3.3,39,4,35,10,2.2,23007,34,http://content8.flixster.com/movie/55/35/14/5535142_det.jpg
8667,A Home at the End of the World,2004,home_at_the_end_of_the_world,5.7,111,53,58,47,6.1,32,18,14,56,3.5,3425,66,http://content6.flixster.com/movie/10/88/02/10880228_det.jpg
8668,Some Girls,1988,some_girls,0,1,0,1,0,0,0,0,0,0,0,0,0,http://content6.flixster.com/movie/11/12/75/11127520_det.jpg
8669,Stay Hungry,1976,stay_hungry,6.5,6,5,1,83,0,1,1,0,100,2.9,807,34,http://content9.flixster.com/movie/51/03/510379_det.jpg
8670,Das Testament des Dr. Mabuse,1933,testament_of_dr_mabuse,8.2,10,9,1,90,0,0,0,0,0,0,0,0,http://content9.flixster.com/movie/29/88/298891_det.jpg
8671,Zus & zo,2001,zus-zo-hotel-paraiso,4.9,19,8,11,42,4,9,1,8,11,3,136,41,http://content6.flixster.com/movie/10/87/04/10870492_det.jpg
8672,Battle Hymn,1957,battle_hymn,0,4,1,3,25,0,1,0,1,0,2.9,249,30,http://content7.flixster.com/movie/30/25/302525_det.jpg
8673,Crash Dive,1943,1048119-crash_dive,0,3,1,2,33,0,0,0,0,0,0,0,0,http://content9.flixster.com/movie/10/91/92/10919271_det.jpg
8674,Disco Pigs,2001,disco-pigs,4.8,5,1,4,20,0,0,0,0,0,0,0,0,http://content9.flixster.com/movie/29/57/295711_det.jpg
8675,The Enemy Below,1957,enemy_below,0,4,3,1,75,0,0,0,0,0,0,0,0,http://content6.flixster.com/movie/92/55/08/9255080_det.jpg
8676,Fist of the North Star,1995,fist-of-the-north-star1995,0,3,2,1,66,0,0,0,0,0,0,0,0,http://content8.flixster.com/movie/28/41/284102_det.jpg
8677,Flash Gordon Conquers the Universe,1940,flash-gordon-conquers-the-universe,6.5,7,6,1,85,0,0,0,0,0,0,0,0,http://content7.flixster.com/movie/10/89/50/10895093_det.jpg
8678,Guns of the Magnificent Seven,1969,guns_of_the_magnificent_seven,0,2,2,0,100,0,0,0,0,0,0,0,0,http://content7.flixster.com/movie/10/92/05/10920549_det.jpg
8679,The Deer Hunter,1978,deer_hunter,8.3,44,40,4,90,7.1,5,4,1,80,4.1,27513,91,http://content6.flixster.com/movie/26/75/267592_det.jpg
8680,Tras el cristal,1987,in-a-glass-cage,5,6,3,3,50,0,4,2,2,50,3.7,441,77,http://content6.flixster.com/movie/28/75/287508_det.jpg
8681,Lancelot du Lac,1974,lancelot_of_the_lake,8.2,12,11,1,91,0,2,1,1,50,3.7,482,71,http://content9.flixster.com/movie/29/64/296403_det.jpg
8682,The Last Valley,1971,last_valley,0,2,2,0,100,0,0,0,0,0,0,0,0,http://content6.flixster.com/movie/26/57/265720_det.jpg
8683,The Magnificent Seven Ride!,1972,magnificent_seven_ride,0,0,0,0,0,0,0,0,0,0,0,0,0,http://content6.flixster.com/movie/10/83/95/10839596_det.jpg
8684,Un condamn√© √† mort s'est √©chapp√© ou Le vent souffle o√π il veut,1956,man_escaped,8.5,17,17,0,100,0,1,1,0,100,4.3,1392,92,http://content6.flixster.com/movie/29/65/296504_det.jpg
8685,Marcelino pan y vino,1955,miracle_of_marcelino,0,0,0,0,0,0,0,0,0,0,0,0,0,http://content8.flixster.com/movie/10/97/12/10971266_det.jpg
8686,Morituri,1965,morituri,0,3,2,1,66,0,0,0,0,0,0,0,0,http://content6.flixster.com/movie/30/30/303016_det.jpg
8687,Orgy of the Dead,1965,orgy_of_the_dead,1.2,5,0,5,0,0,0,0,0,0,0,0,0,http://content6.flixster.com/movie/28/84/288408_det.jpg
8688,Shalako,1968,shalako,0,4,1,3,25,0,1,0,1,0,2.9,691,34,http://content9.flixster.com/movie/26/61/266195_det.jpg
8689,Shock to the System,2006,shock_to_the_system,5,8,4,4,50,4.5,5,2,3,40,2.8,7652,33,http://content6.flixster.com/movie/10/89/81/10898140_det.jpg
8690,Slaughterhouse-Five,1972,slaughterhouse_five,7.4,13,10,3,76,0,0,0,0,0,0,0,0,http://content6.flixster.com/movie/11/12/35/11123560_det.jpg
8692,Wake Island,1942,wake_island,7.4,5,5,0,100,0,0,0,0,0,0,0,0,http://content9.flixster.com/movie/10/87/32/10873223_det.jpg
8693,What Price Glory,1952,1023438-what_price_glory,0,4,2,2,50,0,0,0,0,0,0,0,0,http://content9.flixster.com/movie/30/15/301511_det.jpg
8694,You Were Never Lovelier,1942,you_were_never_lovelier,7.4,5,5,0,100,0,0,0,0,0,0,0,0,http://content8.flixster.com/movie/29/49/294906_det.jpg
8695,The Bachelor and the Bobby-Soxer,1947,bachelor_and_the_bobbysoxer,6.2,8,6,2,75,0,1,0,1,0,3.7,1615,77,http://content6.flixster.com/movie/10/94/64/10946464_det.jpg
8696,Breezy,1973,breezy,0,2,1,1,50,0,0,0,0,0,0,0,0,http://content9.flixster.com/movie/10/83/84/10838431_det.jpg
8697,En la ciudad sin l√≠mites,2002,la-ciudad-sin-limites,0,0,0,0,0,0,0,0,0,0,0,0,0,http://content8.flixster.com/movie/30/50/305018_det.jpg
8698,The Comfort of Strangers,1990,comfort_of_strangers,5.7,13,8,5,61,0,2,0,2,0,3.4,597,58,http://content9.flixster.com/movie/48/61/80/4861807_det.jpg
8699,Dancing in September,2000,dancing_in_september,0,3,3,0,100,0,0,0,0,0,0,0,0,http://content6.flixster.com/movie/10/88/53/10885372_det.jpg
8700,Destination Tokyo,1943,destination_tokyo,0,4,3,1,75,0,0,0,0,0,0,0,0,http://content9.flixster.com/movie/10/08/01/10080159_det.jpg
8701,Dr. Jekyll and Ms. Hyde,1995,dr_jekyll_and_ms_hyde,2.5,7,1,6,14,0,1,0,1,0,2.4,1292,25,http://content8.flixster.com/movie/98/67/66/9867662_det.jpg
8702,Dream Lover,1993,1052200-dream_lover,5.6,13,7,6,53,0,2,1,1,50,3,280,40,http://content9.flixster.com/movie/10/85/03/10850343_det.jpg
8703,Fausto 5.0,2001,fausto-50,0,0,0,0,0,0,0,0,0,0,0,0,0,http://content9.flixster.com/movie/53/52/04/5352047_det.jpg
8704,For Queen & Country,1988,for-queen-and-country,0,0,0,0,0,0,0,0,0,0,0,0,0,http://content7.flixster.com/movie/99/14/33/9914333_det.jpg
8705,Funny About Love,1990,funny_about_love,3.3,7,0,7,0,0,1,0,1,0,2.8,446,30,http://content6.flixster.com/movie/10/88/03/10880348_det.jpg
8706,The Greatest Game Ever Played,2005,greatest_game_ever_played,6.2,109,68,41,62,5.7,27,15,12,55,3.6,15763,76,http://content6.flixster.com/movie/25/02/250212_det.jpg
8708,Hometown Legend,2002,hometown_legend,0,2,0,2,0,0,0,0,0,0,0,0,0,http://content9.flixster.com/movie/10/38/92/10389251_det.jpg
8709,How I Got Into College,1989,how_i_got_into_college,4.6,8,3,5,37,0,0,0,0,0,0,0,0,http://content9.flixster.com/movie/10/88/71/10887131_det.jpg
8710,Map of the Human Heart,1993,map_of_the_human_heart,6.8,20,16,4,80,0,4,3,1,75,3.7,666,74,http://content8.flixster.com/movie/10/90/03/10900366_det.jpg
8711,Mr. Blandings Builds His Dream House,1948,mr-blandings-builds-his-dream-house,7.1,14,11,3,78,0,0,0,0,0,0,0,0,http://content9.flixster.com/movie/10/95/86/10958699_det.jpg
8712,My Favorite Wife,1940,my_favorite_wife,6.7,12,10,2,83,0,3,2,1,66,3.9,1364,85,http://content9.flixster.com/movie/10/85/42/10854211_det.jpg
8713,The New Adventures of Pippi Longstocking,1988,new_adventures_of_pippi_longstocking,4.4,5,1,4,20,0,0,0,0,0,0,0,0,http://content9.flixster.com/movie/10/93/17/10931735_det.jpg
8714,Night and Day,1946,1015000-night_and_day,0,4,2,2,50,0,0,0,0,0,0,0,0,http://content9.flixster.com/movie/97/70/84/9770843_det.jpg
8715,No Name on the Bullet,1959,no_name_on_the_bullet,0,1,1,0,100,0,0,0,0,0,0,0,0,http://content7.flixster.com/movie/29/93/299313_det.jpg
8716,The Plainsman,1936,plainsman,0,0,0,0,0,0,0,0,0,0,0,0,0,http://content9.flixster.com/movie/10/93/11/10931183_det.jpg
8718,The Snake Pit,1948,snake_pit,0,3,3,0,100,0,0,0,0,0,0,0,0,http://content7.flixster.com/movie/10/88/20/10882093_det.jpg
8719,The Spoilers,1942,1019653-spoilers,0,3,3,0,100,0,0,0,0,0,0,0,0,http://content9.flixster.com/movie/29/67/296715_det.jpg
8720,Super Size Me,2004,food-and-culture,0,0,0,0,0,0,0,0,0,0,0,0,0,http://images.rottentomatoescdn.com/images/defaults/poster_default.gif
8721,Tai-Pan,1986,taipan,3.7,5,1,4,20,0,1,0,1,0,2.9,427,37,http://content7.flixster.com/movie/27/33/273393_det.jpg
8722,Two of a Kind,1983,1022225-two_of_a_kind,4,10,2,8,20,0,1,0,1,0,2.9,2389,40,http://content9.flixster.com/movie/10/93/55/10935531_det.jpg
8723,The 13th Warrior,1999,13th_warrior,4.6,86,28,58,32,4.9,18,7,11,38,3.2,24204,66,http://content7.flixster.com/movie/10/87/23/10872325_det.jpg
8724,Il gattopardo,1963,posto,7.4,6,6,0,100,0,1,1,0,100,4.2,484,92,http://content9.flixster.com/movie/30/35/303507_det.jpg
8725,"Goodbye, Columbus",1969,goodbye_columbus,7.1,9,9,0,100,0,0,0,0,0,0,0,0,http://content9.flixster.com/movie/10/93/50/10935031_det.jpg
8726,The President's Analyst,1967,presidents_analyst,7.1,20,16,4,80,8,5,5,0,100,3.6,371,73,http://content6.flixster.com/movie/11/12/70/11127084_det.jpg
8727,The Day of the Locust,1975,day_of_the_locust,6.8,8,5,3,62,0,1,1,0,100,3.6,582,75,http://content9.flixster.com/movie/27/77/277703_det.jpg
8728,The Creeping Flesh,1973,creeping_flesh,5.8,5,4,1,80,0,0,0,0,0,0,0,0,http://content8.flixster.com/movie/20/86/12/2086126_det.jpg
8729,Un amour de Swann,1984,swann_in_love,0,4,3,1,75,0,1,1,0,100,3.2,261,48,http://content9.flixster.com/movie/27/81/278191_det.jpg
8730,To End All Wars,2001,to_end_all_wars,6.1,11,7,4,63,0,2,1,1,50,3.9,1957,85,http://content6.flixster.com/movie/10/87/33/10873344_det.jpg
8731,Moulin Rouge!,2001,1107863-moulin_rouge,7,168,130,38,77,6.1,35,23,12,65,3.7,110817,88,http://content9.flixster.com/movie/11/13/74/11137447_det.jpg
8732,The Belly of an Architect,1987,belly_of_an_architect,6.3,12,10,2,83,0,0,0,0,0,0,0,0,http://content6.flixster.com/movie/10/91/60/10916004_det.jpg
8733,Nid de gu√™pes,2002,1132155-nest,0,0,0,0,0,0,0,0,0,0,0,0,0,http://content7.flixster.com/movie/28/05/280517_det.jpg
8734,Love Happy,1949,love_happy,0,2,2,0,100,0,0,0,0,0,0,0,0,http://content6.flixster.com/movie/29/95/299516_det.jpg
8735,High School Confidential!,1958,high_school_confidential,6.3,9,6,3,66,0,1,1,0,100,3.3,853,54,http://content7.flixster.com/movie/10/90/24/10902453_det.jpg
8736,Out of the Blue,1980,out-of-the-blue-no-looking-back,6.2,5,4,1,80,0,1,1,0,100,3.9,294,80,http://content8.flixster.com/movie/45/67/96/4567962_det.jpg
8737,Crimetime,1996,crimetime,0,1,0,1,0,0,0,0,0,0,0,0,0,http://content8.flixster.com/movie/10/86/25/10862550_det.jpg
8738,Une femme est une femme,1961,a-woman-is-a-woman,7.4,28,24,4,85,7.6,10,9,1,90,4,2893,86,http://content6.flixster.com/movie/10/92/44/10924424_det.jpg
8739,Mamma Roma,1962,mamma_roma,7.8,9,9,0,100,0,0,0,0,0,0,0,0,http://content9.flixster.com/movie/10/93/52/10935271_det.jpg
8740,Donzoko,1957,lower_depths,8.2,5,4,1,80,0,1,1,0,100,3.9,685,82,http://content6.flixster.com/movie/98/44/32/9844320_det.jpg
8741,Ruby Cairo,1993,ruby-cairo,0,0,0,0,0,0,0,0,0,0,0,0,0,http://content6.flixster.com/movie/63/57/94/6357944_det.jpg
8742,Night Patrol,1984,1015060-night_patrol,0,0,0,0,0,0,0,0,0,0,0,0,0,http://content6.flixster.com/movie/10/88/17/10881756_det.jpg
8743,Biggles,1986,biggles-adventures-in-time,0,0,0,0,0,0,0,0,0,0,0,0,0,http://content7.flixster.com/movie/26/43/264321_det.jpg
8744,Fancy Pants,1950,fancy_pants,0,4,3,1,75,0,0,0,0,0,0,0,0,http://content9.flixster.com/movie/25/26/252615_det.jpg
8745,The World of Suzie Wong,1960,world_of_suzie_wong,0,2,2,0,100,0,0,0,0,0,0,0,0,http://content9.flixster.com/movie/29/32/293219_det.jpg
8746,King of the Ants,2003,1132084-king_of_the_ants,7.2,8,8,0,100,0,0,0,0,0,0,0,0,http://content7.flixster.com/movie/25/24/71/2524717_det.jpg
8747,Uncle Sam,1997,uncle_sam,5.1,9,5,4,55,0,0,0,0,0,0,0,0,http://content7.flixster.com/movie/10/87/45/10874589_det.jpg
8748,"Ieri, oggi, domani",1963,yesterday_today_and_tomorrow,7.3,5,4,1,80,0,0,0,0,0,0,0,0,http://content7.flixster.com/movie/30/17/301713_det.jpg
8749,La belle noiseuse,1991,la_belle_noiseuse,8,22,22,0,100,8.2,6,6,0,100,3.9,797,83,http://content9.flixster.com/movie/29/45/294595_det.jpg
8751,Deadly Is the Female,1950,1031278-gun_crazy,8.2,27,26,1,96,0,2,1,1,50,3.8,881,83,http://content7.flixster.com/movie/30/47/304721_det.jpg
8752,The Set-Up,1949,setup,5.9,6,5,1,83,0,0,0,0,0,0,0,0,http://content6.flixster.com/movie/28/52/93/2852932_det.jpg
8753,Unprecedented: The 2000 Presidential Election,2002,recount-democracy,0,0,0,0,0,0,0,0,0,0,0,0,0,http://content6.flixster.com/movie/10/85/16/10851644_det.jpg
8754,The Prime of Miss Jean Brodie,1969,prime_of_miss_jean_brodie,6.9,14,13,1,92,0,2,2,0,100,3.8,987,81,http://content7.flixster.com/movie/10/09/32/10093241_det.jpg
8755,Il mio viaggio in Italia,1999,my_voyage_to_italy,8.3,20,20,0,100,0,4,4,0,100,3.9,769,82,http://content8.flixster.com/movie/25/91/259198_det.jpg
8756,The North Avenue Irregulars,1979,north_avenue_irregulars,5.1,7,5,2,71,0,0,0,0,0,0,0,0,http://content9.flixster.com/movie/10/87/22/10872231_det.jpg
8757,Lovers and Other Strangers,1970,lovers_and_other_strangers,0,4,3,1,75,0,1,1,0,100,3.4,328,50,http://content8.flixster.com/movie/10/86/73/10867326_det.jpg
8758,Kotch,1971,kotch,0,4,2,2,50,0,1,0,1,0,3.4,272,59,http://content7.flixster.com/movie/22/12/05/2212057_det.jpg
8759,Greyfriars Bobby: The True Story of a Dog,1961,greyfriars_bobby,0,0,0,0,0,0,0,0,0,0,0,0,0,http://content8.flixster.com/movie/29/50/295010_det.jpg
8760,Side Out,1990,side_out,0,4,0,4,0,0,0,0,0,0,0,0,0,http://content9.flixster.com/movie/26/24/262491_det.jpg
8761,The Three Lives of Thomasina,1964,three_lives_of_thomasina,0,4,2,2,50,0,0,0,0,0,0,0,0,http://content6.flixster.com/movie/11/14/06/11140688_det.jpg
8762,"No Deposit, No Return",1976,no_deposit_no_return,0,0,0,0,0,0,0,0,0,0,0,0,0,http://content9.flixster.com/movie/10/87/53/10875371_det.jpg
8763,"The One and Only, Genuine, Original Family Band",1968,one_and_only_genuine_original_family_band,0,0,0,0,0,0,0,0,0,0,0,0,0,http://content6.flixster.com/movie/11/12/52/11125228_det.jpg
8765,This Gun for Hire,1942,1021269-this_gun_for_hire,7.3,13,12,1,92,0,1,1,0,100,3.7,648,80,http://content9.flixster.com/movie/29/30/293091_det.jpg
8766,Black Angel,1946,1080192-black_angel,0,4,3,1,75,0,0,0,0,0,0,0,0,http://content7.flixster.com/movie/10/89/18/10891853_det.jpg
8767,The Big Clock,1948,big_clock,7.6,6,6,0,100,0,0,0,0,0,0,0,0,http://content8.flixster.com/movie/29/72/297202_det.jpg
8768,CrissCross,1992,crisscross,0,0,0,0,0,0,0,0,0,0,0,0,0,http://content6.flixster.com/movie/28/23/282300_det.jpg
8769,The Fifth Musketeer,1979,fifth_musketeer,0,1,1,0,100,0,0,0,0,0,0,0,0,http://content9.flixster.com/movie/89/95/67/8995675_det.jpg
8770,Evilspeak,1981,evilspeak,4.1,5,2,3,40,0,0,0,0,0,0,0,0,http://content8.flixster.com/movie/28/02/280218_det.jpg
8771,Terror by Night,1946,sherlock_holmes_in_terror_by_night,6.5,7,5,2,71,0,0,0,0,0,0,0,0,http://content6.flixster.com/movie/10/66/46/10664648_det.jpg
8772,The Spy Who Came in from the Cold,1965,spy_who_came_in_from_the_cold,7.6,12,10,2,83,0,3,2,1,66,0,0,0,http://content9.flixster.com/movie/10/86/90/10869003_det.jpg
8773,Sherlock Holmes and the Secret Weapon,1943,sherlock_holmes_and_the_secret_weapon,0,2,1,1,50,0,0,0,0,0,0,0,0,http://content8.flixster.com/movie/10/87/83/10878318_det.jpg
8774,The Woman in Green,1945,sherlock_holmes_and_the_woman_in_green,7.2,8,8,0,100,0,0,0,0,0,0,0,0,http://content7.flixster.com/movie/31/15/311529_det.jpg
8775,The Counterfeit Traitor,1962,counterfeit_traitor,0,3,2,1,66,0,0,0,0,0,0,0,0,http://content7.flixster.com/movie/10/87/68/10876813_det.jpg
8777,Roadkill,1989,,\N,\N,\N,\N,\N,\N,\N,\N,\N,\N,\N,\N,\N,\N
8778,Dressed to Kill,1946,sherlock_holmes_in_dressed_to_kill,6.2,5,4,1,80,0,0,0,0,0,0,0,0,http://content8.flixster.com/movie/30/82/308222_det.jpg
8779,Bon voyage,2003,1130780-bon_voyage,6.7,95,72,23,75,7.2,29,23,6,79,3.5,1025,69,http://content6.flixster.com/movie/29/04/290420_det.jpg
8780,The Assassination Bureau,1969,assassination_bureau,5.9,5,4,1,80,0,2,2,0,100,3.5,334,69,http://content9.flixster.com/movie/26/41/264119_det.jpg
8781,The Manchurian Candidate,1962,1013227-manchurian_candidate,8.6,48,47,1,97,7.5,6,5,1,83,3.9,6006,89,http://content7.flixster.com/movie/26/56/265601_det.jpg
8782,Thunderbirds,2004,thunderbirds,4.1,99,19,80,19,3.9,29,5,24,17,2.7,4133,45,http://content8.flixster.com/movie/10/87/69/10876970_det.jpg
8783,The Village,2004,village,5.4,199,84,115,42,5.7,39,19,20,48,3,47806,59,http://content6.flixster.com/movie/10/91/54/10915468_det.jpg
8784,Garden State,2004,garden_state,7.4,184,158,26,85,7.1,36,30,6,83,3.8,90523,87,http://content6.flixster.com/movie/55/35/83/5535832_det.jpg
8785,Bakush√ª,1951,early_summer,8.8,9,9,0,100,0,1,1,0,100,4.1,762,91,http://content7.flixster.com/movie/29/98/299897_det.jpg
8786,Le quai des brumes,1938,,7.9,10,9,1,90,0,2,1,1,50,4.1,679,89,http://content8.flixster.com/movie/30/42/304222_det.jpg
8787,Thunderbirds Are GO,1966,thunderbirds_are_go,4.2,5,2,3,40,0,0,0,0,0,0,0,0,http://content7.flixster.com/movie/10/87/69/10876969_det.jpg
8788,Thunderbird 6,1968,thunderbirds_6,0,3,1,2,33,0,0,0,0,0,0,0,0,http://content8.flixster.com/movie/25/31/253194_det.jpg
8789,Castle Keep,1969,castle_keep,5.4,7,3,4,42,0,3,1,2,33,3,755,46,http://content9.flixster.com/movie/27/99/279995_det.jpg
8790,Revengers Tragedy,2002,1134283-revengers_tragedy,6.4,5,3,2,60,0,1,1,0,100,3.9,317,78,http://content9.flixster.com/movie/43/30/03/4330031_det.jpg
8791,Sip si 32 dou,1996,beyond_hypothermia,0,0,0,0,0,0,0,0,0,0,0,0,0,http://content8.flixster.com/movie/89/35/73/8935730_det.jpg
8792,Octane,2003,pulse2004,3.9,6,1,5,16,0,0,0,0,0,0,0,0,http://content7.flixster.com/movie/27/99/279925_det.jpg
8793,PTU,2003,ptu,5.8,14,8,6,57,0,1,1,0,100,3.7,1107,79,http://content6.flixster.com/movie/11/14/13/11141384_det.jpg
8794,Neokonchennaya pyesa dlya mekhanicheskogo pianino,1977,unfinished_piece_for_player_piano,0,1,1,0,100,0,0,0,0,0,0,0,0,http://content8.flixster.com/movie/10/53/03/10530382_det.jpg
8795,Musa,2001,musa-the-warrior,0,1,1,0,100,0,0,0,0,0,0,0,0,http://content6.flixster.com/movie/10/88/78/10887828_det.jpg
8796,A Funny Thing Happened on the Way to the Forum,1966,funny_thing_happened_on_the_way_to_the_forum,7,17,14,3,82,0,0,0,0,0,0,0,0,http://content6.flixster.com/movie/29/12/291292_det.jpg
8797,Death of a Salesman,1985,1005521-death_of_a_salesman,8.2,7,7,0,100,0,0,0,0,0,0,0,0,http://content9.flixster.com/movie/85/78/42/8578423_det.jpg
8798,Collateral,2004,collateral,7.4,223,192,31,86,7.2,44,36,8,81,3.5,43901,79,http://content6.flixster.com/movie/10/93/72/10937228_det.jpg
8799,Little Black Book,2004,,4.4,108,23,85,21,4.1,31,5,26,16,2.8,12215,46,http://content6.flixster.com/movie/10/92/04/10920448_det.jpg
8800,Code 46,2003,code_46,6.1,96,50,46,52,5.5,32,10,22,31,3.3,2456,59,http://content9.flixster.com/movie/10/88/89/10888943_det.jpg
8801,In the Soup,1992,1042122-in_the_soup,6.7,6,5,1,83,0,2,1,1,50,3.5,578,70,http://content7.flixster.com/movie/10/91/81/10918185_det.jpg
8803,Aoi haru,2001,blue_spring,0,0,0,0,0,0,0,0,0,0,0,0,0,http://content6.flixster.com/movie/30/49/304924_det.jpg
8804,Une affaire de femmes,1988,story_of_women,7.4,10,8,2,80,0,1,0,1,0,3.7,435,73,http://content7.flixster.com/movie/30/66/306621_det.jpg
8805,Juyuso seubgyuksageun,1999,attack-the-gas-station,0,1,1,0,100,0,0,0,0,0,0,0,0,http://content8.flixster.com/movie/11/13/01/11130122_det.jpg
8806,The Mask,1994,1053779-mask,6.4,44,33,11,75,6.1,9,5,4,55,3.2,68419,66,http://content6.flixster.com/movie/62/33/43/6233432_det.jpg
8807,Harold & Kumar Go to White Castle,2004,harold_and_kumar_go_to_white_castle,6.5,144,106,38,73,6.7,30,22,8,73,3.5,61100,79,http://content7.flixster.com/movie/11/14/72/11147225_det.jpg
8808,The Princess Diaries 2: Royal Engagement,2004,princess_diaries_2_royal_engagement,4.6,113,29,84,25,4.8,28,10,18,35,3.2,63165,68,http://content6.flixster.com/movie/11/15/28/11152832_det.jpg
8809,Danny Deckchair,2003,danny_deckchair,5.7,75,40,35,53,5.9,24,14,10,58,3.6,1705,74,http://content9.flixster.com/movie/25/88/258891_det.jpg
8810,AVP: Alien vs. Predator,2004,alien_vs_predator,4.1,139,30,109,21,3.4,25,1,24,4,3,48807,51,http://content7.flixster.com/movie/10/93/20/10932045_det.jpg
8811,Y√ªgi√¥ Duel Monsters: Hikari no pyramid,2004,yugioh,3,62,3,59,4,2.8,19,0,19,0,3,2474,53,http://content9.flixster.com/movie/10/92/94/10929463_det.jpg
8812,Novo,2002,novo,4.7,10,5,5,50,0,4,1,3,25,3.3,452,55,http://content9.flixster.com/movie/28/18/281803_det.jpg
8813,We Don't Live Here Anymore,2004,we_dont_live_here_anymore,6.4,122,79,43,64,6.8,34,24,10,70,3.2,2382,55,http://content7.flixster.com/movie/10/85/42/10854225_det.jpg
8814,Without a Paddle,2004,without_a_paddle,3.9,124,18,106,14,4.2,31,6,25,19,3.3,33540,73,http://content8.flixster.com/movie/10/86/39/10863910_det.jpg
8815,Exorcist: The Beginning,2004,exorcist_the_beginning,3.6,123,14,109,11,3.3,23,1,22,4,2.8,14563,42,http://content9.flixster.com/movie/10/90/81/10908123_det.jpg
8818,It Happened at the World's Fair,1963,it_happened_at_the_worlds_fair,3.9,6,1,5,16,0,0,0,0,0,0,0,0,http://content7.flixster.com/movie/10/85/29/10852957_det.jpg
8821,Harum Scarum,1965,harum_scarum,0,0,0,0,0,0,0,0,0,0,0,0,0,http://content8.flixster.com/movie/35/68/09/3568098_det.jpg
8822,The Spaceman and King Arthur,1979,unidentified_flying_oddball,0,3,1,2,33,0,0,0,0,0,0,0,0,http://content7.flixster.com/movie/10/92/96/10929697_det.jpg
8823,The Sting II,1983,sting_2,0,0,0,0,0,0,0,0,0,0,0,0,0,http://content7.flixster.com/movie/26/49/264901_det.jpg
8825,Cheerleader Camp,1988,,0,1,0,1,0,0,0,0,0,0,0,0,0,http://content9.flixster.com/movie/27/36/273607_det.jpg
8826,Ressources humaines,1999,human_resources,7.8,31,30,1,96,7.8,7,7,0,100,3.7,375,77,http://content9.flixster.com/movie/31/05/310523_det.jpg
8827,Bill Cosby: Himself,1983,bill_cosby_himself,7,5,4,1,80,0,0,0,0,0,0,0,0,http://content8.flixster.com/movie/20/53/43/2053434_det.jpg
8828,Dead Ringers,1988,dead_ringers,7.7,35,29,6,82,5.7,6,3,3,50,3.6,4690,80,http://content6.flixster.com/movie/28/49/284996_det.jpg
8829,Benji: Off the Leash!,2004,1134850-benji_off_the_leash,4.7,43,14,29,32,5,16,5,11,31,3.3,551,60,http://content9.flixster.com/movie/26/32/263227_det.jpg
8830,Anacondas: The Hunt for the Blood Orchid,2004,anacondas_the_hunt_for_the_blood_orchid,4.3,116,31,85,26,4.5,28,8,20,28,2.5,14394,43,http://content9.flixster.com/movie/25/88/258899_det.jpg
8831,Suspect Zero,2004,suspect_zero,4.4,129,23,106,17,4.6,32,7,25,21,3,2578,43,http://content8.flixster.com/movie/27/34/273422_det.jpg
8832,Tian di ying xiong,2003,warriors_of_heaven_and_earth,6.1,31,21,10,67,5.6,10,5,5,50,3.3,1053,57,http://content9.flixster.com/movie/10/94/52/10945255_det.jpg
8833,Vanity Fair,2004,vanity_fair,5.8,162,81,81,50,5.8,41,23,18,56,3,9329,52,http://content9.flixster.com/movie/10/24/36/10243655_det.jpg
8834,The Cookout,2004,cookout,2.8,42,2,40,4,2.6,14,1,13,7,2.9,1132,50,http://content6.flixster.com/movie/26/33/263300_det.jpg
8835,Paparazzi,2004,paparazzi,3.4,77,14,63,18,2.8,14,0,14,0,2.8,2849,43,http://content9.flixster.com/movie/25/97/259791_det.jpg
8836,Wicker Park,2004,wicker_park,4.3,120,28,92,23,4.3,30,7,23,23,3.5,12752,79,http://content8.flixster.com/movie/10/84/98/10849878_det.jpg
8837,Trigger Man,2007,trigger_man,6.9,9,8,1,88,0,3,3,0,100,2.8,140,45,http://content6.flixster.com/movie/10/84/08/10840876_det.jpg
8838,Alice Doesn't Live Here Anymore,1974,alice_doesnt_live_here_anymore,7.8,19,18,1,94,0,4,3,1,75,0,0,0,http://content8.flixster.com/movie/10/84/89/10848982_det.jpg
8839,The Mangler,1995,mangler,2.5,9,2,7,22,0,1,0,1,0,2.4,1314,25,http://content6.flixster.com/movie/56/81/29/5681296_det.jpg
8840,I Call First,1967,whos_that_knocking_at_my_door,6.1,13,9,4,69,0,4,1,3,25,3.4,1323,61,http://content7.flixster.com/movie/10/86/70/10867009_det.jpg
8841,Seeing Other People,2004,seeing_other_people,5.5,33,13,20,39,5.3,13,6,7,46,2.9,579,35,http://content9.flixster.com/movie/27/91/279195_det.jpg
8842,Past Midnight,1991,past_midnight,0,0,0,0,0,0,0,0,0,0,0,0,0,http://content8.flixster.com/movie/10/85/48/10854886_det.jpg
8843,A Million to Juan,1994,million_to_juan,0,2,0,2,0,0,0,0,0,0,0,0,0,http://content6.flixster.com/movie/10/87/93/10879308_det.jpg
8844,Amator,1979,camera_buff,7.3,9,8,1,88,0,3,2,1,66,4,656,88,http://content7.flixster.com/movie/10/86/93/10869317_det.jpg
8845,Bez konca,1985,no_end,7.3,10,9,1,90,0,3,2,1,66,3.9,354,79,http://content9.flixster.com/movie/93/37/41/9337419_det.jpg
8846,Highwaymen,2004,1127803-highwaymen,3.2,15,2,13,13,0,1,0,1,0,3,1050,42,http://content8.flixster.com/movie/10/11/61/10116114_det.jpg
8847,Graffiti Bridge,1990,graffiti_bridge,4.9,8,3,5,37,0,1,0,1,0,3,996,47,http://content6.flixster.com/movie/70/32/22/7032224_det.jpg
8848,I vitelloni,1953,i_vitelloni,8.8,22,22,0,100,8.9,11,11,0,100,4.1,1679,90,http://content8.flixster.com/movie/29/90/299010_det.jpg
8849,Under the Cherry Moon,1986,under_the_cherry_moon,3.8,22,6,16,27,5.3,5,2,3,40,3.3,1076,65,http://content7.flixster.com/movie/10/85/00/10850017_det.jpg
8850,Flipper,1996,1070621-flipper,4.8,17,5,12,29,5.4,5,1,4,20,2.6,6086,44,http://content7.flixster.com/movie/25/69/256925_det.jpg
8851,Smile,2005,10005057-smile,4,13,2,11,15,3.9,5,1,4,20,3.5,585,69,http://content9.flixster.com/movie/10/87/99/10879935_det.jpg
8852,Lord Jim,1965,lord-jim,5.7,13,7,6,53,0,3,0,3,0,3.3,613,54,http://content7.flixster.com/movie/30/23/302397_det.jpg
8853,A Small Circle of Friends,1980,small_circle_of_friends,0,1,1,0,100,0,0,0,0,0,0,0,0,http://content9.flixster.com/movie/10/91/26/10912683_det.jpg
8854,Night of the Demons III,1997,night_of_the_demons_3,0,2,0,2,0,0,0,0,0,0,0,0,0,http://content9.flixster.com/movie/10/91/72/10917299_det.jpg
8855,Witchboard,1986,witchboard,4.8,8,3,5,37,0,0,0,0,0,0,0,0,http://content7.flixster.com/movie/10/93/56/10935657_det.jpg
8856,Roller Boogie,1979,roller_boogie,3,6,0,6,0,0,1,0,1,0,3,585,49,http://content8.flixster.com/movie/10/86/86/10868678_det.jpg
8858,The Apple,1980,1001131-apple,4.6,6,1,5,16,0,0,0,0,0,0,0,0,http://content6.flixster.com/movie/26/14/261412_det.jpg
8859,Superbabies: Baby Geniuses 2,2004,super_babies_baby_geniuses_2,2.2,40,0,40,0,2.5,17,0,17,0,2.1,1335,28,http://content9.flixster.com/movie/10/93/36/10933699_det.jpg
8860,Cellular,2004,cellular,5.8,146,80,66,54,5.8,32,17,15,53,3.2,13185,63,http://content6.flixster.com/movie/10/43/33/10433388_det.jpg
8861,Resident Evil: Apocalypse,2004,resident_evil_apocalypse,3.9,121,25,96,20,3.3,26,2,24,7,3.3,56756,70,http://content9.flixster.com/movie/10/93/47/10934791_det.jpg
8862,Criminal,2004,10003276-criminal,6.4,118,82,36,69,6.7,34,25,9,73,3.3,1400,58,http://content7.flixster.com/movie/10/90/40/10904033_det.jpg
8864,Mr 3000,2004,mr_3000,5.9,104,58,46,55,6.1,34,20,14,58,2.6,2928,35,http://content9.flixster.com/movie/10/86/10/10861015_det.jpg
8865,Sky Captain and the World of Tomorrow,2004,sky_captain,6.8,204,147,57,72,6.6,38,26,12,68,2.8,17325,43,http://content8.flixster.com/movie/10/89/23/10892374_det.jpg
8866,Wimbledon,2004,wimbledon,5.9,142,86,56,60,5.6,33,18,15,54,3.1,14484,57,http://content9.flixster.com/movie/10/94/10/10941007_det.jpg
8867,Anatomie de l'enfer,2004,anatomy_of_hell,3.6,34,9,25,26,3.7,15,4,11,26,2.9,861,42,http://content9.flixster.com/movie/28/58/285819_det.jpg
8868,Head in the Clouds,2004,head_in_the_clouds,4.3,87,13,74,14,4.2,31,4,27,12,3.4,2782,62,http://content7.flixster.com/movie/10/95/42/10954205_det.jpg
8869,First Daughter,2004,first_daughter,3.7,83,7,76,8,3.5,24,0,24,0,2.8,13699,50,http://content6.flixster.com/movie/25/54/255492_det.jpg
8870,The Forgotten,2004,forgotten,5,168,51,117,30,4.7,34,10,24,29,2.9,13766,47,http://content6.flixster.com/movie/25/55/255520_det.jpg
8871,The Last Shot,2004,last_shot,5.9,66,40,26,60,5.7,21,13,8,61,2.8,795,30,http://content9.flixster.com/movie/27/39/273923_det.jpg
8872,A Dirty Shame,2004,adictos_2005,0,0,0,0,0,0,0,0,0,0,0,0,0,http://content7.flixster.com/movie/10/84/57/10845749_det.jpg
8873,Diarios de motocicleta,2004,motorcycle_diaries,7.5,153,128,25,83,7.6,37,31,6,83,4.1,22395,91,http://content8.flixster.com/movie/10/94/15/10941510_det.jpg
8874,Shaun of the Dead,2004,shaun_of_the_dead,7.7,175,159,16,90,7.6,33,31,2,93,3.9,110759,91,http://content7.flixster.com/movie/99/21/86/9921865_det.jpg
8875,"Come Back, Little Sheba",1952,come_back_little_sheba,6.4,6,4,2,66,0,0,0,0,0,0,0,0,http://content6.flixster.com/movie/29/96/299624_det.jpg
8876,The Black Orchid,1958,black_orchid,4.6,5,1,4,20,0,1,0,1,0,3.6,104,66,http://content9.flixster.com/movie/86/22/50/8622507_det.jpg
8878,Class of Nuke 'Em High Part II: Subhumanoid Meltdown,1991,class_of_nuke_em_high_2_subhumanoid_meltdown,0,1,0,1,0,0,0,0,0,0,0,0,0,http://content7.flixster.com/movie/10/22/07/10220793_det.jpg
8879,Murder on the Orient Express,1974,murder_on_the_orient_express,7.4,19,19,0,100,0,1,1,0,100,3.5,3826,74,http://content7.flixster.com/movie/10/86/79/10867929_det.jpg
8880,The Mask,1994,1053779-mask,6.4,44,33,11,75,6.1,9,5,4,55,3.2,68419,66,http://content6.flixster.com/movie/62/33/43/6233432_det.jpg
8881,Alexander's Ragtime Band,1938,alexanders_ragtime_band,0,2,1,1,50,0,0,0,0,0,0,0,0,http://content8.flixster.com/movie/10/85/14/10851446_det.gif
8882,The Boston Strangler,1968,1002939-boston_strangler,6.5,12,11,1,91,0,1,1,0,100,3.5,672,73,http://content8.flixster.com/movie/27/78/277814_det.jpg
8883,The Last Flight of Noah's Ark,1980,last_flight_of_noahs_ark,4.4,5,2,3,40,0,1,0,1,0,2.9,399,42,http://content7.flixster.com/movie/31/06/310693_det.jpg
8884,The Man with One Red Shoe,1985,man_with_one_red_shoe,4.6,13,6,7,46,0,1,0,1,0,2.8,2768,38,http://content6.flixster.com/movie/10/18/81/10188132_det.jpg
8885,The Sentinel,2006,sentinel,5,134,44,90,32,5.1,32,11,21,34,3.1,26716,47,http://content8.flixster.com/movie/31/40/314022_det.jpg
8886,Sssssss,1973,sssssss,3.4,7,1,6,14,0,0,0,0,0,0,0,0,http://content7.flixster.com/movie/26/12/261225_det.jpg
8887,Whispers in the Dark,1992,whispers_in_the_dark,4.6,7,2,5,28,0,1,0,1,0,2.9,293,31,http://content7.flixster.com/movie/28/09/280997_det.jpg
8889,The Legacy,1978,1012162-legacy,0,1,1,0,100,0,0,0,0,0,0,0,0,http://content8.flixster.com/movie/10/91/41/10914170_det.jpg
8890,The Alligator People,1959,alligator_people,0,3,1,2,33,0,0,0,0,0,0,0,0,http://content6.flixster.com/movie/30/21/302112_det.jpg
8891,"See No Evil, Hear No Evil",1989,see_no_evil_hear_no_evil,3.4,11,2,9,18,0,1,0,1,0,3.3,6015,72,http://content8.flixster.com/movie/26/93/269306_det.jpg
8892,Basket Case 3: The Progeny,1992,,\N,\N,\N,\N,\N,\N,\N,\N,\N,\N,\N,\N,\N,\N
8893,Basket Case 2,1990,basket_case_2,0,4,4,0,100,0,0,0,0,0,0,0,0,http://content7.flixster.com/movie/10/89/82/10898277_det.jpg
8894,Orca,1977,orca_the_killer_whale,3.8,12,2,10,16,0,0,0,0,0,0,0,0,http://content8.flixster.com/movie/25/98/259818_det.jpg
8895,AKA,2002,1134304-aka,6.2,31,18,13,58,6.6,12,8,4,66,3.1,250,50,http://content8.flixster.com/movie/27/95/279526_det.jpg
8896,I Married a Monster from Outer Space,1958,i-married-a-monster-from-outer-space,6.2,12,10,2,83,0,0,0,0,0,0,0,0,http://content9.flixster.com/movie/28/77/287719_det.jpg
8897,The Trojan Women,1971,trojan_women,0,2,2,0,100,0,1,1,0,100,3.1,225,50,http://content9.flixster.com/movie/29/78/297899_det.jpg
8898,Robinson Crusoe,1997,1110937-robinson_crusoe,0,3,1,2,33,0,0,0,0,0,0,0,0,http://content6.flixster.com/movie/26/30/263000_det.jpg
8899,Hardcore,1979,1009219-hardcore,6.7,19,16,3,84,0,1,1,0,100,3.4,560,64,http://content9.flixster.com/movie/27/75/277503_det.jpg
8900,Watermelon Man,1970,watermelon_man,0,3,3,0,100,0,0,0,0,0,0,0,0,http://content6.flixster.com/movie/27/86/278692_det.jpg
8901,Flashpoint,2008,,\N,\N,\N,\N,\N,\N,\N,\N,\N,\N,\N,\N,\N,\N
8902,Bug,2006,bug,6.2,128,76,52,59,6.6,36,24,12,66,2.5,168834,31,http://content6.flixster.com/movie/69/50/07/6950072_det.jpg
8903,Planet Terror,2007,planet_terror,6.1,23,17,6,73,0,0,0,0,0,0,0,0,http://content6.flixster.com/movie/10/92/41/10924140_det.jpg
8905,1492: Conquest of Paradise,1992,1492_conquest_of_paradise,4.1,16,7,9,43,0,2,1,1,50,3,3372,47,http://content7.flixster.com/movie/52/53/84/5253849_det.jpg
8906,Cannibal Holocaust,1980,cannibal_holocaust,5.2,11,7,4,63,0,0,0,0,0,0,0,0,http://content9.flixster.com/movie/31/36/313627_det.jpg
8907,Shark Tale,2004,shark_tale,5.2,173,61,112,35,5.5,34,13,21,38,3.2,78877,59,http://content8.flixster.com/movie/55/34/93/5534930_det.jpg
8908,Ladder 49,2004,the-art-of-russell-oberlin2004,0,0,0,0,0,0,0,0,0,0,0,0,0,http://content8.flixster.com/movie/10/94/73/10947338_det.jpg
8909,Black Cloud,2004,,5.3,7,2,5,28,0,2,0,2,0,3.9,507,83,http://content9.flixster.com/movie/10/90/51/10905115_det.gif
8910,I Heart Huckabees,2004,i_heart_huckabees,6.3,184,113,71,61,5.7,41,21,20,51,3.3,38441,75,http://content9.flixster.com/movie/26/73/267311_det.jpg
8911,Raise Your Voice,2004,raise_your_voice,3.7,83,13,70,15,3.9,27,6,21,22,3.3,56922,74,http://content6.flixster.com/movie/55/05/85/5505852_det.jpg
8912,Taxi,2004,taxi,3.4,104,11,93,10,3.8,27,5,22,18,2.8,15669,60,http://content7.flixster.com/movie/10/91/40/10914017_det.jpg
8913,Around the Bend,2004,around_the_bend,4.9,94,27,67,28,4.7,30,7,23,23,3.4,1012,65,http://content9.flixster.com/movie/10/88/98/10889891_det.jpg
8914,Primer,2004,primer,6.5,115,83,32,72,6.4,28,20,8,71,3.8,10817,82,http://content8.flixster.com/movie/25/58/255802_det.jpg
8915,Stage Beauty,2004,coming-to-the-stage,0,0,0,0,0,0,0,0,0,0,0,0,0,http://content6.flixster.com/movie/10/87/72/10877272_det.jpg
8916,Shall We Dance,2004,shall_we_dance,5.4,152,69,83,45,5.2,37,16,21,43,3,26935,63,http://content9.flixster.com/movie/10/84/66/10846607_det.jpg
8917,Team America: World Police,2004,team_america_world_police,6.9,191,145,46,75,6.4,38,26,12,68,3.4,43078,78,http://content6.flixster.com/movie/10/92/10/10921012_det.jpg
8918,Eulogy,2004,eulogy,4.6,34,11,23,32,3.9,9,1,8,11,3.6,2744,71,http://content6.flixster.com/movie/27/09/270916_det.jpg
8919,P.S.,2004,ps,5.8,78,43,35,55,5.6,27,14,13,51,3,1406,41,http://content6.flixster.com/movie/10/87/97/10879784_det.jpg
8920,The Country Girl,1954,1004798-country_girl,7.2,6,5,1,83,0,0,0,0,0,0,0,0,http://content9.flixster.com/movie/29/77/297791_det.jpg
8921,The Rose Tattoo,1955,rose_tattoo,7.8,5,4,1,80,0,0,0,0,0,0,0,0,http://content8.flixster.com/movie/29/82/298210_det.jpg
8922,Epidemic,1987,epidemic,5.4,6,2,4,33,0,2,2,0,100,3.3,1016,60,http://content9.flixster.com/movie/30/93/309395_det.jpg
8923,Tess,1979,tess,7,16,13,3,81,0,4,4,0,100,3.6,1705,73,http://content9.flixster.com/movie/26/05/260511_det.jpg
8924,I Wanna Hold Your Hand,1978,i_wanna_hold_your_hand,6.4,17,14,3,82,0,1,0,1,0,3.5,625,72,http://content7.flixster.com/movie/10/89/23/10892301_det.jpg
8925,Spinning Boris,2003,spinning-boris,0,0,0,0,0,0,0,0,0,0,0,0,0,http://content9.flixster.com/movie/10/84/56/10845691_det.jpg
8926,Circle of Iron,1978,circle_of_iron,4.6,7,3,4,42,0,0,0,0,0,0,0,0,http://content9.flixster.com/movie/10/87/62/10876267_det.jpg
8927,The Cannonball Run,1981,cannonball_run,4.2,29,9,20,31,0,3,0,3,0,3.1,6545,59,http://content8.flixster.com/movie/10/08/33/10083378_det.jpg
8928,Dance of the Vampires,1967,fearless_vampire_killers_or_pardon_me_but_your_teeth_are_in_my_neck,6.1,29,19,10,65,0,4,2,2,50,3.8,3901,77,http://content7.flixster.com/movie/59/56/29/5956297_det.jpg
8929,Black Beauty,1994,1126533-black_friday,0,0,0,0,0,0,0,0,0,0,0,0,0,http://content8.flixster.com/movie/10/93/24/10932426_det.jpg
8930,De fem bensp√¶nd,2003,five_obstructions,7.6,57,50,7,87,8,15,14,1,93,4,1809,84,http://content6.flixster.com/movie/28/71/287124_det.jpg
8931,Born Rich,2003,born-rich2003,0,0,0,0,0,0,0,0,0,0,0,0,0,http://content6.flixster.com/movie/10/84/83/10848304_det.jpg
8932,It's Alive,1974,its_alive_unrated,0,1,0,1,0,0,0,0,0,0,0,0,0,http://content9.flixster.com/movie/10/91/50/10915019_det.jpg
8933,Le d√©clin de l'empire am√©ricain,1986,le-declin-de-lempire-americain,7.3,12,11,1,91,0,1,1,0,100,3.7,1522,79,http://content6.flixster.com/movie/10/88/29/10882932_det.jpg
8934,B√©b√©'s Kids,1992,bebes_kids,4.1,7,1,6,14,0,0,0,0,0,0,0,0,http://content9.flixster.com/movie/25/71/257103_det.jpg
8935,All I Want for Christmas,1991,1039460-all_i_want_for_christmas,2.3,6,0,6,0,0,1,0,1,0,3.1,1740,55,http://content8.flixster.com/movie/10/88/39/10883994_det.jpg
8936,La vie et rien d'autre,1989,life_and_nothing_but,0,4,4,0,100,0,0,0,0,0,0,0,0,http://content7.flixster.com/movie/10/17/05/10170569_det.jpg
8937,Friday Night Lights,2004,friday_night_lights,7.1,166,134,32,80,7.5,39,34,5,87,3.6,36154,84,http://content7.flixster.com/movie/25/46/254613_det.jpg
8938,Tarnation,2003,tarnation,7.6,100,92,8,92,8.2,34,33,1,97,3.9,2007,82,http://content6.flixster.com/movie/10/91/97/10919720_det.jpg
8939,The Final Cut,2004,final_cut,5.4,75,29,46,38,4.9,26,8,18,30,3,4745,48,http://content7.flixster.com/movie/10/93/73/10937377_det.jpg
8941,Riding the Bullet,2004,riding-the-bullet,4.2,21,6,15,28,3.1,6,0,6,0,2.9,1830,40,http://content7.flixster.com/movie/11/12/39/11123973_det.jpg
8942,Spin,2003,1137336-1137336-spin,5.1,7,3,4,42,0,1,0,1,0,3.7,271,71,http://content6.flixster.com/movie/26/26/262608_det.jpg
8943,Being Julia,2004,being_julia,6.7,123,94,29,76,6.5,35,24,11,68,3.5,1947,71,http://content8.flixster.com/movie/10/84/02/10840218_det.jpg
8944,The Dust Factory,2004,dust_factory,2.9,11,1,10,9,0,3,0,3,0,3.6,977,65,http://content8.flixster.com/movie/10/50/22/10502202_det.jpg
8945,Th√©r√®se,1986,therese,7.8,6,5,1,83,0,2,1,1,50,3.8,225,78,http://content8.flixster.com/movie/29/26/292610_det.jpg
8946,Surviving Christmas,2004,surviving_christmas,3,109,8,101,7,2.9,29,2,27,6,2.6,4192,37,http://content8.flixster.com/movie/56/19/48/5619486_det.jpg
8947,The Grudge,2004,grudge,5.1,153,61,92,39,4.8,33,8,25,24,2.9,54794,57,http://content9.flixster.com/movie/28/62/286203_det.jpg
8948,Alfie,2004,alfie,5.5,149,73,76,48,5.2,38,16,22,42,2.9,15367,49,http://content9.flixster.com/movie/27/01/270103_det.jpg
8949,Sideways,2004,sideways,8.6,212,205,7,96,8.7,42,41,1,97,3.4,35809,77,http://content8.flixster.com/movie/26/68/266826_det.jpg
8950,The Machinist,2004,machinist,6.6,132,99,33,75,6.7,33,25,8,75,3.7,41645,82,http://content8.flixster.com/movie/26/76/267694_det.jpg
8951,Vera Drake,2004,vera_drake,7.9,155,142,13,91,8,40,36,4,90,3.8,3338,82,http://content6.flixster.com/movie/10/86/12/10861272_det.jpg
8952,Duo luo tian shi,1995,fallen_angels_hong_kong,7.9,19,18,1,94,0,4,4,0,100,4,4014,86,http://content8.flixster.com/movie/30/83/308306_det.jpg
8954,Lightning in a Bottle,2004,1136293-lightning_in_a_bottle,7.4,61,53,8,86,7.4,22,20,2,90,3.6,343,78,http://content7.flixster.com/movie/10/91/89/10918929_det.jpg
8955,Undertow,2004,undertow,5.9,116,64,52,55,6.1,34,19,15,55,3.4,1926,65,http://content7.flixster.com/movie/27/03/270301_det.jpg
8956,Enduring Love,2004,enduring_love,6.2,96,57,39,59,6.2,34,20,14,58,3.3,2543,60,http://content8.flixster.com/movie/27/57/275702_det.jpg
8957,Saw,2004,saw,5.4,161,77,84,47,4.9,32,10,22,31,3.7,144186,86,http://content8.flixster.com/movie/28/57/285702_det.jpg
8958,Ray,2004,ray,7.3,194,157,37,80,7.7,41,35,6,85,3.8,32696,87,http://content8.flixster.com/movie/26/65/266522_det.jpg
8959,Birth,2004,birth,5.2,138,54,84,39,5.3,39,14,25,35,2.8,5483,41,http://content7.flixster.com/movie/62/20/622045_det.jpg
8960,Voices of Iraq,2004,1164418-voices_of_iraq,6.1,15,9,6,60,5.9,12,6,6,50,4,111,86,http://content9.flixster.com/movie/66/62/49/6662491_det.jpg
8961,The Incredibles,2004,down-syndrome-the-first-18-months2004,0,0,0,0,0,0,0,0,0,0,0,0,0,http://content6.flixster.com/movie/10/90/22/10902236_det.jpg
8962,Fade to Black,1980,1006975-fade_to_black,4.9,11,5,6,45,0,1,1,0,100,3.3,379,54,http://content6.flixster.com/movie/39/56/04/3956044_det.jpg
8963,It's All About Love... og Thomas Vinterberg,2003,,\N,\N,\N,\N,\N,\N,\N,\N,\N,\N,\N,\N,\N,\N
8964,Callas Forever,2002,,0,0,0,0,0,0,0,0,0,0,0,0,0,http://content9.flixster.com/movie/11/12/35/11123503_det.jpg
8965,The Polar Express,2004,polar_express,6.4,186,104,82,55,6.2,39,21,18,53,3.2,22358,65,http://content6.flixster.com/movie/55/35/36/5535368_det.jpg
8966,Kinsey,2004,kinsey,7.6,187,168,19,89,7.9,39,36,3,92,3.4,6162,72,http://content6.flixster.com/movie/10/94/53/10945324_det.jpg
8967,Seed of Chucky,2004,seed_of_chucky,4.4,71,23,48,32,3.9,18,2,16,11,2.6,15727,52,http://content8.flixster.com/movie/10/50/25/10502550_det.jpg
8968,After the Sunset,2004,after_the_sunset,4.4,138,25,113,18,4.2,33,4,29,12,3.1,6886,56,http://content9.flixster.com/movie/15/26/66/1526667_det.jpg
8969,Bridget Jones: The Edge of Reason,2004,bridget_jones_the_edge_of_reason,4.7,149,40,109,26,4.7,35,10,25,28,3.1,41759,64,http://content9.flixster.com/movie/11/12/32/11123203_det.jpg
8970,Finding Neverland,2004,finding_neverland,7.4,200,165,35,82,7.3,39,31,8,79,3.7,77596,84,http://content7.flixster.com/movie/67/71/22/6771229_det.jpg
8971,Veer-Zaara,2004,1195356-veer_zaara,0,3,3,0,100,0,2,2,0,100,4.2,4026,87,http://content9.flixster.com/movie/28/78/287895_det.jpg
8972,National Treasure: Book of Secrets,2007,national-treasure-2-book-of-secrets,4.7,118,39,79,33,4.6,25,8,17,32,3.6,1237906,72,http://content7.flixster.com/movie/10/10/43/10104317_det.jpg
8973,La mala educaci√≥n,2004,bad_education,7.5,134,118,16,88,7.8,35,30,5,85,3.9,13423,85,http://content8.flixster.com/movie/10/88/78/10887886_det.jpg
8974,The SpongeBob SquarePants Movie,2004,spongebob_squarepants_movie,6.2,123,84,39,68,6.2,33,23,10,69,3.2,19811,74,http://content6.flixster.com/movie/11/12/84/11128492_det.jpg
8976,San-Antonio,2004,770872734,0,0,0,0,0,0,0,0,0,0,0,0,0,http://content9.flixster.com/movie/11/14/94/11149447_det.jpg
8977,Alexander,2004,alexander,3.9,193,31,162,16,4,41,5,36,12,2.7,29540,43,http://content9.flixster.com/movie/31/93/29/3193291_det.jpg
8978,Christmas with the Kranks,2004,christmas_with_the_kranks,2.8,131,6,125,4,3.4,33,1,32,3,2.9,11697,46,http://content7.flixster.com/movie/10/88/27/10882789_det.jpg
8979,Guerrilla: The Taking of Patty Hearst,2004,guerrilla-the-taking-of-patty-hearst,0,0,0,0,0,0,0,0,0,0,0,0,0,http://content9.flixster.com/movie/10/88/15/10881511_det.jpg
8980,Notre musique,2004,notre_musique,6.6,54,36,18,66,6.9,17,12,5,70,3.7,949,69,http://content9.flixster.com/movie/29/50/295091_det.jpg
8981,Closer,2004,closer,6.6,201,137,64,68,6.6,42,31,11,73,3.5,50768,80,http://content9.flixster.com/movie/55/36/40/5536407_det.jpg
8982,I Am David,2003,i_am_david,5.2,34,13,21,38,5.3,10,3,7,30,4,1967,86,http://content8.flixster.com/movie/25/49/254926_det.jpg
8983,Shi mian mai fu,2004,house_of_flying_daggers,7.8,163,143,20,87,8.1,39,37,2,94,3.6,35657,81,http://content9.flixster.com/movie/10/89/29/10892903_det.jpg
8984,Ocean's Twelve,2004,oceans_twelve,5.9,174,96,78,55,6.1,38,23,15,60,3.4,108512,67,http://content7.flixster.com/movie/55/34/98/5534985_det.jpg
8985,Blade: Trinity,2004,blade_trinity,4.5,162,43,119,26,4.4,33,7,26,21,3.4,62827,70,http://content7.flixster.com/movie/55/05/72/5505729_det.jpg
8986,The Bellboy,1960,bellboy,6.9,9,6,3,66,0,0,0,0,0,0,0,0,http://content6.flixster.com/movie/29/39/293924_det.jpg
8987,Le monde selon Bush,2004,monde-selon-bush-le,0,0,0,0,0,0,0,0,0,0,0,0,0,http://content7.flixster.com/movie/10/83/89/10838953_det.jpg
8988,Cinderfella,1960,cinderfella,0,4,3,1,75,0,0,0,0,0,0,0,0,http://content9.flixster.com/movie/29/30/293015_det.jpg
8989,Damn Yankees!,1958,1005152-damn_yankees,5.9,7,5,2,71,0,0,0,0,0,0,0,0,http://content7.flixster.com/movie/29/13/291305_det.jpg
8990,The Delicate Delinquent,1957,delicate_delinquent,0,3,1,2,33,0,0,0,0,0,0,0,0,http://content7.flixster.com/movie/10/93/87/10938769_det.jpg
8991,The Disorderly Orderly,1964,,\N,\N,\N,\N,\N,\N,\N,\N,\N,\N,\N,\N,\N,\N
8992,The Errand Boy,1961,errand_boy,5.7,8,4,4,50,0,0,0,0,0,0,0,0,http://content6.flixster.com/movie/29/47/294724_det.jpg
8993,The Family Jewels,1965,family_jewels,0,4,3,1,75,0,0,0,0,0,0,0,0,http://content9.flixster.com/movie/10/86/16/10861639_det.jpg
8994,The Ladies Man,2000,1101029-ladies_man,3.2,71,8,63,11,3.3,18,3,15,16,2.6,2790,43,http://content9.flixster.com/movie/27/08/270807_det.jpg
8995,Doing Time for Patsy Cline,1997,1157715-doing_time_for_patsy_cline,6.1,9,7,2,77,0,4,2,2,50,2.7,50,33,http://content8.flixster.com/movie/10/85/12/10851274_det.jpg
8996,Stateside,2004,stateside,4.3,46,11,35,23,4.1,20,4,16,20,3.4,526,62,http://content8.flixster.com/movie/27/48/274802_det.jpg
8997,The Stooge,1952,stooge,0,1,0,1,0,0,0,0,0,0,0,0,0,http://content9.flixster.com/movie/29/39/293995_det.jpg
8998,That's Entertainment!,1974,thats_entertainment,8,13,13,0,100,0,1,1,0,100,3.7,1093,79,http://content8.flixster.com/movie/10/86/76/10867698_det.jpg
8999,"That's Entertainment, Part II",1976,thats-entertainment-2,0,3,2,1,66,0,0,0,0,0,0,0,0,http://content6.flixster.com/movie/10/87/46/10874684_det.jpg
9000,That's Entertainment! III,1994,thats-entertainment-iii,0,0,0,0,0,0,0,0,0,0,0,0,0,http://content7.flixster.com/movie/10/84/89/10848969_det.jpg
9001,The Wackiest Ship in the Army,1960,wackiest_ship_in_the_army,0,2,1,1,50,0,0,0,0,0,0,0,0,http://content7.flixster.com/movie/10/88/28/10882833_det.jpg
9002,Alexander,2004,alexander,3.9,193,31,162,16,4,41,5,36,12,2.7,29540,43,http://content9.flixster.com/movie/31/93/29/3193291_det.jpg
9003,Conquest of Space,1955,1040442-conquest_of_space,0,3,2,1,66,0,0,0,0,0,0,0,0,http://content7.flixster.com/movie/10/85/09/10850925_det.jpg
9004,D.A.R.Y.L.,1985,daryl,3.7,6,2,4,33,0,0,0,0,0,0,0,0,http://content7.flixster.com/movie/53/96/21/5396213_det.jpg
9005,Fire in the Sky,1993,fire_in_the_sky,5.1,14,5,9,35,0,3,0,3,0,3.1,2891,56,http://content8.flixster.com/movie/55/04/90/5504906_det.jpg
9007,I'll Be Seeing You,1944,1135169-ill_be_seeing_you,0,1,1,0,100,0,0,0,0,0,0,0,0,http://content8.flixster.com/movie/10/85/82/10858246_det.jpg
9008,The Invisible Man Returns,1940,invisible_man_returns,5.9,9,8,1,88,0,0,0,0,0,0,0,0,http://content9.flixster.com/movie/95/83/99/9583999_det.jpg
9009,The Last Minute,2001,,\N,\N,\N,\N,\N,\N,\N,\N,\N,\N,\N,\N,\N,\N
9010,Jeux d'enfants,2003,love_me_if_you_dare,5.2,78,34,44,43,5.1,26,10,16,38,4.2,14602,90,http://content9.flixster.com/movie/26/83/268399_det.jpg
9011,Portrait of Jennie,1948,portrait-of-jennie,7.9,11,10,1,90,0,0,0,0,0,0,0,0,http://images.rottentomatoescdn.com/images/defaults/poster_default.gif
9012,Ruby Gentry,1952,ruby_gentry,6.9,6,4,2,66,0,1,1,0,100,3.1,162,43,http://content8.flixster.com/movie/30/73/307314_det.jpg
9013,Secret Honor,1984,secret_honor,7.4,11,8,3,72,0,3,2,1,66,3.6,540,72,http://content9.flixster.com/movie/30/05/300519_det.jpg
9014,Since You Went Away,1944,since_you_went_away,6.5,6,4,2,66,0,0,0,0,0,0,0,0,http://content9.flixster.com/movie/10/87/11/10871119_det.jpg
9015,A Slipping-Down Life,1999,slipping-down-life,4.7,65,17,48,26,4.5,24,7,17,29,3.2,316,49,http://content6.flixster.com/movie/28/05/280524_det.jpg
9017,Oliver Twist,2005,charles-dickens-the-man-who-asked-for-more,0,0,0,0,0,0,0,0,0,0,0,0,0,http://content8.flixster.com/movie/10/87/39/10873958_det.jpg
9018,Control Room,2004,control_room,7.8,108,104,4,96,7.8,29,28,1,96,3.9,1430,86,http://content6.flixster.com/movie/10/88/83/10888380_det.jpg
9019,Celsius 41.11: The Temperature at Which the Brain... Begins to Die,2004,1140725-celsius_4111,3.9,18,2,16,11,4,10,1,9,10,2.6,208,26,http://content6.flixster.com/movie/11/01/81/11018140_det.jpg
25736,Dr. Jekyll and Mr. Hyde,2008,dr_jekyll_and_mr_hyde,0,1,0,1,0,0,0,0,0,0,0,0,0,http://content9.flixster.com/movie/11/12/32/11123215_det.jpg
25737,"Der Golem, wie er in die Welt kam",1920,golem,7.9,8,8,0,100,0,1,1,0,100,0,0,0,http://content7.flixster.com/movie/28/75/287593_det.jpg
25744,H√§xan,1922,haxan,7.4,15,13,2,86,0,1,1,0,100,3.8,1213,80,http://content9.flixster.com/movie/10/88/46/10884659_det.jpg
25746,The Hunchback of Notre Dame,1939,1010215-hunchback_of_notre_dame,8.3,9,9,0,100,0,0,0,0,0,0,0,0,http://content9.flixster.com/movie/29/39/293991_det.jpg
25750,Sherlock Jr.,1924,sherlock-jr,0,0,0,0,0,0,0,0,0,0,0,0,0,http://content9.flixster.com/movie/99/50/32/9950323_det.jpg
25752,The Freshman,1990,10009001-the_freshman,7.3,32,30,2,93,7.2,8,7,1,87,3.1,2525,52,http://content6.flixster.com/movie/11/14/93/11149316_det.jpg
25753,Greed,1924,1008924-greed,9.3,16,16,0,100,0,4,4,0,100,0,0,0,http://content7.flixster.com/movie/31/92/85/3192853_det.jpg
25755,The Phantom of the Opera,2004,phantom_of_the_opera,5,165,54,111,32,4.6,37,10,27,27,3.7,70849,86,http://content9.flixster.com/movie/35/84/18/3584187_det.jpg
25757,The Jazz Singer,1980,1010979-jazz_singer,3.7,20,3,17,15,0,3,1,2,33,3.4,857,71,http://content6.flixster.com/movie/10/92/52/10925292_det.jpg
25759,Oktyabr,1928,oktyabr-october-ten-days-that-shook-the-world,7.1,7,6,1,85,0,1,1,0,100,4,780,83,http://content9.flixster.com/movie/29/49/294995_det.jpg
25762,Unknown,2006,unknown,5.1,44,17,27,38,4.6,17,4,13,23,3.3,6616,57,http://content7.flixster.com/movie/32/66/88/3266889_det.jpg
25763,Die B√ºchse der Pandora,1929,pandoras_box,8.5,23,21,2,91,8.1,8,6,2,75,4.1,1316,88,http://content9.flixster.com/movie/93/51/65/9351659_det.jpg
25764,The Cameraman,1928,the-cameraman-1928,8.8,13,13,0,100,0,0,0,0,0,0,0,0,http://content7.flixster.com/movie/84/97/57/8497577_det.jpg
25766,The In Crowd,2000,1098652-in_crowd,2.7,52,1,51,1,2.4,14,0,14,0,2.6,925,41,http://content9.flixster.com/movie/26/32/263295_det.jpg
25769,"Steamboat Bill, Jr.",1928,steamboat_bill_jr,9.1,15,15,0,100,0,0,0,0,0,0,0,0,http://content9.flixster.com/movie/30/57/305711_det.jpg
25771,Un chien andalou,1929,un-chien-andalou-an-andalusian-dog,9.2,18,18,0,100,0,3,3,0,100,4.1,5685,86,http://content7.flixster.com/movie/29/12/291229_det.jpg
25773,Little Caesar,1931,little_caesar,7.6,17,15,2,88,0,2,2,0,100,3.6,1977,72,http://content6.flixster.com/movie/46/61/466172_det.jpg
25774,L'√¢ge d'or,1930,lage_dor,8.7,23,21,2,91,0,2,2,0,100,4,1547,82,http://content7.flixster.com/movie/10/92/49/10924949_det.jpg
25777,Monkey Business,1931,1014137-monkey_business,7.8,12,11,1,91,0,0,0,0,0,0,0,0,http://content6.flixster.com/movie/10/86/15/10861560_det.jpg
25783,The Return of Doctor X,1939,return_of_doctor_x,0,3,0,3,0,0,0,0,0,0,0,0,0,http://content6.flixster.com/movie/10/92/60/10926020_det.jpg
25788,Scarface,1983,1018324-scarface,7.5,50,44,6,88,8,5,4,1,80,4.1,121090,93,http://content6.flixster.com/movie/49/68/81/4968812_det.jpg
25793,Interview with the Vampire: The Vampire Chronicles,1994,interview_with_the_vampire,5.8,45,26,19,57,4.6,10,4,6,40,3.7,77706,85,http://content6.flixster.com/movie/28/01/280124_det.jpg
25795,Dinner at Eight,1933,1005875-dinner_at_eight,8.6,16,16,0,100,0,0,0,0,0,0,0,0,http://content8.flixster.com/movie/10/89/24/10892438_det.jpg
25797,Gold Diggers of 1933,1933,gold_diggers_of_1933,9,8,8,0,100,0,0,0,0,0,0,0,0,http://content7.flixster.com/movie/10/87/99/10879965_det.jpg
25798,De fortabte sj√¶les √∏,2007,island-of-lost-souls,0,0,0,0,0,0,0,0,0,0,0,0,0,http://content8.flixster.com/movie/10/85/54/10855490_det.jpg
25802,The Son of Kong,1933,son_of_kong,4.6,9,3,6,33,0,0,0,0,0,0,0,0,http://content9.flixster.com/movie/29/50/295015_det.jpg
25805,L'atalante,1934,latalante,8.7,23,23,0,100,8,7,7,0,100,4.3,1388,91,http://content9.flixster.com/movie/29/80/298095_det.jpg
25825,Balls of Fury,2007,balls_of_fury,4.2,127,29,98,22,4.5,24,8,16,33,2.8,85682,36,http://content6.flixster.com/movie/10/92/34/10923416_det.jpg
25826,Libeled Lady,1936,,7.9,9,7,2,77,0,0,0,0,0,0,0,0,http://content7.flixster.com/movie/10/86/59/10865921_det.jpg
25827,Mr. Deeds Goes to Town,1936,mr_deeds_goes_to_town,8.4,13,12,1,92,0,0,0,0,0,0,0,0,http://content8.flixster.com/movie/10/90/86/10908610_det.jpg
25828,The Petrified Forest,1936,petrified_forest,7.6,8,8,0,100,0,0,0,0,0,0,0,0,http://content7.flixster.com/movie/10/87/04/10870437_det.jpg
25832,Wife vs. Secretary,1936,wife_vs_secretary,0,0,0,0,0,0,0,0,0,0,0,0,0,http://content7.flixster.com/movie/45/42/36/4542361_det.jpg
25833,Camille,1936,1003441-camille,7.3,10,9,1,90,0,1,1,0,100,3.9,1060,82,http://content6.flixster.com/movie/10/95/41/10954112_det.jpg
25835,Dead End,2003,10003925-dead_end,6.1,7,6,1,85,0,0,0,0,0,0,0,0,http://content8.flixster.com/movie/10/87/81/10878126_det.jpg
25839,Nothing Sacred,1937,nothing_sacred,9,9,9,0,100,0,0,0,0,0,0,0,0,http://content8.flixster.com/movie/28/98/289818_det.jpg
25840,The Prisoner of Zenda,1952,1016757-prisoner_of_zenda,0,1,0,1,0,0,0,0,0,0,0,0,0,http://content8.flixster.com/movie/31/92/94/3192946_det.jpg
25841,Stage Door Canteen,1943,stage_door_canteen,0,2,1,1,50,0,0,0,0,0,0,0,0,http://content9.flixster.com/movie/11/14/92/11149227_det.jpg
25850,The Holiday,2006,holiday_2006,0,0,0,0,0,0,0,0,0,0,0,0,0,http://content9.flixster.com/movie/10/88/62/10886279_det.jpg
25855,The Roaring Twenties,1939,roaring_twenties,7.3,10,10,0,100,0,0,0,0,0,0,0,0,http://content9.flixster.com/movie/10/95/34/10953459_det.jpg
25856,Wuthering Heights,1939,1024192-wuthering_heights,7.9,16,16,0,100,0,1,1,0,100,3.9,2525,84,http://content7.flixster.com/movie/31/37/313797_det.jpg
25865,Letters from Iwo Jima,2006,letters_from_iwo_jima,8.2,196,178,18,90,8.3,40,37,3,92,3.8,73433,85,http://content8.flixster.com/movie/10/88/05/10880558_det.jpg
25866,The Sea Hawk,1940,1018433-sea_hawk,8.7,12,12,0,100,0,0,0,0,0,0,0,0,http://content6.flixster.com/movie/10/36/26/10362676_det.jpg
25868,Ball of Fire,1941,ball_of_fire,8.3,23,23,0,100,0,4,4,0,100,4.1,864,89,http://content9.flixster.com/movie/10/86/72/10867215_det.jpg
25870,Here Comes Mr. Jordan,1941,here_comes_mr_jordan,7.4,15,15,0,100,0,0,0,0,0,0,0,0,http://content8.flixster.com/movie/41/87/09/4187090_det.jpg
25878,Across the Pacific,1942,across_the_pacific,0,2,2,0,100,0,0,0,0,0,0,0,0,http://content6.flixster.com/movie/10/90/58/10905820_det.jpg
25885,Prelude to War,1943,prelude-to-war,0,0,0,0,0,0,0,0,0,0,0,0,0,http://content9.flixster.com/movie/10/88/59/10885927_det.jpg
25886,Random Harvest,1942,random_harvest,7.6,9,8,1,88,0,0,0,0,0,0,0,0,http://content7.flixster.com/movie/97/67/96/9767965_det.jpg
25888,Action in the North Atlantic,1943,action_in_the_north_atlantic,0,1,1,0,100,0,0,0,0,0,0,0,0,http://content7.flixster.com/movie/90/59/00/9059009_det.jpg
25891,Heaven Can Wait,1943,1009426-heaven_can_wait,7.8,9,8,1,88,0,0,0,0,0,0,0,0,http://content6.flixster.com/movie/28/70/287004_det.jpg
25893,The Memphis Belle: A Story of a Flying Fortress,1944,the-memphis-belle,0,0,0,0,0,0,0,0,0,0,0,0,0,http://content7.flixster.com/movie/10/87/61/10876173_det.jpg
25898,Vredens dag,1943,vredens-dag-day-of-wrath-day-of-anger,8.5,20,20,0,100,7.5,5,5,0,100,4.2,732,92,http://content7.flixster.com/movie/10/86/11/10861105_det.jpg
25899,Cover Girl,1944,1004832-cover_girl,6.9,9,8,1,88,0,0,0,0,0,0,0,0,http://content8.flixster.com/movie/10/88/93/10889330_det.jpg
25900,The Curse of the Cat People,1944,curse_of_the_cat_people,7.3,23,20,3,86,0,3,2,1,66,0,0,0,http://content9.flixster.com/movie/20/86/11/2086111_det.jpg
25901,Henry V,1989,1029042-henry_v,8.2,32,32,0,100,7.8,7,7,0,100,4,3619,87,http://content9.flixster.com/movie/25/39/253911_det.jpg
25903,The Mask of Dimitrios,1944,mask_of_dimitrios,0,2,2,0,100,0,0,0,0,0,0,0,0,http://content8.flixster.com/movie/10/44/05/10440574_det.jpg
25904,Ministry of Fear,1944,ministry_of_fear,7.2,10,10,0,100,0,0,0,0,0,0,0,0,http://content7.flixster.com/movie/10/16/45/10164529_det.jpg
25905,The Miracle of Morgan's Creek,1944,miracle_of_morgans_creek,8.1,20,18,2,90,0,3,3,0,100,3.9,836,83,http://content7.flixster.com/movie/10/86/99/10869981_det.jpg
25906,Mr. Skeffington,1944,mr_skeffington,6.4,6,4,2,66,0,0,0,0,0,0,0,0,http://content7.flixster.com/movie/58/27/11/5827117_det.jpg
25908,Passage to Marseille,1944,passage-to-marseille,0,0,0,0,0,0,0,0,0,0,0,0,0,http://content7.flixster.com/movie/10/83/94/10839441_det.jpg
25914,Ivan Groznyy,1944,ivan-the-terrible-pt-1,8.7,9,9,0,100,0,1,1,0,100,4.1,999,90,http://content7.flixster.com/movie/10/92/43/10924365_det.jpg
25916,They Were Expendable,1945,they_were_expendable,7.9,8,7,1,87,0,0,0,0,0,0,0,0,http://content7.flixster.com/movie/30/13/301321_det.jpg
25923,Great Expectations,1998,1081200-great_expectations,5.4,32,12,20,37,5.4,7,3,4,42,3.4,10607,76,http://content6.flixster.com/movie/26/88/268896_det.jpg
25924,Humoresque,1946,humoresque,5.9,5,3,2,60,0,0,0,0,0,0,0,0,http://content6.flixster.com/movie/29/97/299720_det.jpg
25927,The Strangers,2008,the_strangers,5,146,65,81,44,4.8,26,13,13,50,3.1,55773,48,http://content9.flixster.com/movie/11/12/79/11127923_det.jpg
25929,Nightmare Alley,1947,1144535-nightmare_alley,7.8,10,10,0,100,0,2,2,0,100,3.9,576,83,http://content7.flixster.com/movie/29/10/291013_det.jpg
25930,Odd Man Out,1947,1015383-odd_man_out,8,22,22,0,100,0,3,3,0,100,4,556,84,http://content9.flixster.com/movie/33/18/40/3318407_det.jpg
25931,Road to Rio,1947,road_to_rio,6.8,6,6,0,100,0,0,0,0,0,0,0,0,http://content7.flixster.com/movie/30/81/308113_det.jpg
25934,The Godfather,1972,godfather,9,66,66,0,100,8.4,11,11,0,100,4.4,172072,97,http://content9.flixster.com/movie/11/12/76/11127687_det.jpg
25937,Easter Parade,1948,easter_parade,7.3,17,15,2,88,0,4,4,0,100,3.8,2172,83,http://content7.flixster.com/movie/10/93/41/10934193_det.jpg
25938,Fort Apache,1948,fort_apache,8.3,13,13,0,100,0,0,0,0,0,0,0,0,http://content7.flixster.com/movie/18/83/22/1883221_det.jpg
25940,The Lady from Shanghai,2010,the-lady-from-shanghai-2010,0,0,0,0,0,0,0,0,0,0,0,0,0,http://images.rottentomatoescdn.com/images/defaults/poster_default.gif
25941,Yi ge mo sheng nu ren de lai xin,2004,yi-ge-mo-sheng-nu-ren-de-lai-xin-a-letter-from-an-unknown-woman,0,0,0,0,0,0,0,0,0,0,0,0,0,http://images.rottentomatoescdn.com/images/defaults/poster_default.gif
25942,Louisiana Story,1948,louisiana_story,7.3,14,11,3,78,0,2,2,0,100,3.4,214,59,http://content9.flixster.com/movie/30/35/303599_det.jpg
25943,The Naked City,1948,1040398-naked_city,7.2,12,11,1,91,0,2,2,0,100,3.8,960,78,http://content9.flixster.com/movie/10/88/30/10883071_det.jpg
25945,They Live by Night,1949,,\N,\N,\N,\N,\N,\N,\N,\N,\N,\N,\N,\N,\N,\N
25946,The Three Musketeers,1993,1046772-three_musketeers,4.8,24,7,17,29,0,3,0,3,0,3.2,13783,67,http://content7.flixster.com/movie/50/26/53/5026533_det.jpg
25947,Unfaithfully Yours,1948,1022369-unfaithfully_yours,7.8,14,13,1,92,0,2,2,0,100,3.9,650,86,http://content8.flixster.com/movie/29/43/294314_det.jpg
25951,In the Good Old Summertime,1949,in_the_good_old_summertime,6.5,7,5,2,71,0,2,1,1,50,3.8,870,79,http://content9.flixster.com/movie/68/88/16/6888163_det.jpg
25952,A Letter to Three Wives,1949,letter_to_three_wives,8.5,10,10,0,100,0,1,1,0,100,3.8,921,82,http://content6.flixster.com/movie/10/29/51/10295176_det.jpg
25954,Orph√©e,1950,orpheus,9.5,15,15,0,100,0,1,1,0,100,4.2,1007,91,http://content6.flixster.com/movie/34/34/28/3434280_det.jpg
25960,Les enfants terribles,1950,les_enfants_terribles,6.6,8,6,2,75,0,1,1,0,100,3.8,405,74,http://content9.flixster.com/movie/96/51/86/9651863_det.jpg
25961,The Gunfighter,1950,1009055-gunfighter,7.6,7,7,0,100,0,0,0,0,0,0,0,0,http://content9.flixster.com/movie/37/96/14/3796147_det.jpg
25962,King Solomon's Mines,1950,1011638-king_solomons_mines,7.4,11,10,1,90,0,0,0,0,0,0,0,0,http://content6.flixster.com/movie/10/83/82/10838236_det.jpg
25963,Los olvidados,1950,los-olvidados-1950,8.8,31,29,2,93,0,4,3,1,75,4.4,1531,95,http://content8.flixster.com/movie/37/63/58/3763586_det.jpg
25964,Sh√ªbun,1950,1072404-scandal,0,4,3,1,75,0,1,1,0,100,3.6,527,69,http://content6.flixster.com/movie/18/35/08/1835088_det.jpg
25971,Carrie,1976,1003625-carrie,8,42,38,4,90,6.4,7,4,3,57,3.3,23161,70,http://content9.flixster.com/movie/28/14/281415_det.jpg
25975,Saikaku ichidai onna,1952,life_of_oharu,8.8,8,8,0,100,0,0,0,0,0,0,0,0,http://content8.flixster.com/movie/10/83/94/10839474_det.jpg
25977,Abbott and Costello Meet Dr. Jekyll and Mr. Hyde,1953,abbott_and_costello_meet_dr_jekyll_and_mr_hyde,6,6,5,1,83,0,0,0,0,0,0,0,0,http://content6.flixster.com/movie/11/12/32/11123224_det.jpg
25993,Z Channel: A Magnificent Obsession,2004,z_channel,8,13,13,0,100,0,0,0,0,0,0,0,0,http://content8.flixster.com/movie/10/94/79/10947942_det.jpg
25995,Miyamoto Musashi,1954,samurai_1_musashi_miyamoto,0,2,2,0,100,0,0,0,0,0,0,0,0,http://content7.flixster.com/movie/10/84/07/10840785_det.jpg
25996,A Star Is Born,1937,1019828-star_is_born,7.3,11,11,0,100,0,0,0,0,0,0,0,0,http://content7.flixster.com/movie/10/88/77/10887749_det.jpg
25999,Into the Wild,2007,into_the_wild,7.5,181,149,32,82,7.2,37,27,10,72,4.2,82515,90,http://content8.flixster.com/movie/93/52/46/9352462_det.jpg
26002,Mr. Arkadin,1955,mr-arkadin-confidential-report,7.1,18,15,3,83,0,2,2,0,100,3.9,707,80,http://content8.flixster.com/movie/10/91/93/10919386_det.jpg
26005,Zoku Miyamoto Musashi: Ichij√¥ji no kett√¥,1955,samurai_2_duel_at_ichijoji_temple,0,0,0,0,0,0,0,0,0,0,0,0,0,http://content7.flixster.com/movie/28/55/65/2855657_det.jpg
26007,Tuntematon sotilas,1955,tuntematon-sotilas-the-unknown-soldier,0,0,0,0,0,0,0,0,0,0,0,0,0,http://content8.flixster.com/movie/37/33/43/3733430_det.jpg
26012,Miyamoto Musashi kanketsuhen: kett√¥ Ganry√ªjima,1956,samurai_3_duel_at_ganryu_island,0,0,0,0,0,0,0,0,0,0,0,0,0,http://content6.flixster.com/movie/30/26/302696_det.jpg
26038,Teacher's Pet,2004,1129129-teachers_pet,6.5,72,54,18,75,6.7,25,19,6,76,2.8,370,38,http://content6.flixster.com/movie/41/61/80/4161808_det.jpg
26048,Ningen no j√¥ken,1959,human-condition-ii-the-road-to-eternity,0,0,0,0,0,0,0,0,0,0,0,0,0,http://content8.flixster.com/movie/30/03/300326_det.jpg
26049,Nobi,1959,fires_on_the_plain,7.8,13,13,0,100,0,4,4,0,100,4.2,428,91,http://content9.flixster.com/movie/68/65/06/6865063_det.jpg
26052,Pickpocket,1959,1053613-pickpocket,9.3,19,19,0,100,0,2,2,0,100,4.1,1733,88,http://content9.flixster.com/movie/11/14/29/11142955_det.jpg
26055,Ukigusa,1959,floating_weeds,8.4,20,19,1,95,0,3,3,0,100,4.2,745,91,http://content7.flixster.com/movie/53/79/44/5379449_det.jpg
26059,Onna ga kaidan wo agaru toki,1960,onna-ga-kaidan-wo-agaru-toki-when-a-woman-ascends-the-stairs,8.2,13,13,0,100,0,0,0,0,0,0,0,0,http://content6.flixster.com/movie/39/91/15/3991152_det.jpg
26064,Warui yatsu hodo yoku nemuru,1960,the-warui-yatsu-hodo-yoku-nemuru-the-bad-sleep-well,7.7,16,16,0,100,0,3,3,0,100,4.1,1723,91,http://content9.flixster.com/movie/10/86/13/10861383_det.jpg
26067,The Deadly Companions,1961,deadly_companions,6.4,5,4,1,80,0,1,0,1,0,3.2,166,38,http://content6.flixster.com/movie/97/88/52/9788528_det.jpg
26073,Ningen no j√¥ken,1961,human-condition-iii-a-soldiers-prayer,0,0,0,0,0,0,0,0,0,0,0,0,0,http://content9.flixster.com/movie/30/47/304707_det.jpg
26078,Advise & Consent,1962,advise_and_consent,7.7,10,8,2,80,0,2,1,1,50,3.9,594,88,http://content7.flixster.com/movie/29/42/294205_det.jpg
26079,David and Lisa,1962,david_and_lisa,7.1,10,8,2,80,0,3,2,1,66,0,0,0,http://content7.flixster.com/movie/29/98/299893_det.jpg
26082,Seppuku,1962,harakiri_1963,0,3,3,0,100,0,1,1,0,100,4.5,1585,96,http://content9.flixster.com/movie/11/14/27/11142739_det.jpg
26084,The Music Man,1962,1014453-music_man,7.9,15,14,1,93,0,0,0,0,0,0,0,0,http://content9.flixster.com/movie/10/85/12/10851299_det.jpg
26085,Mutiny on the Bounty,1935,1014481-mutiny_on_the_bounty,8.2,28,26,2,92,7.5,6,5,1,83,3.7,1846,79,http://content9.flixster.com/movie/10/88/45/10884511_det.jpg
26094,L'eclisse,1962,leclisse,7.4,15,13,2,86,0,4,3,1,75,4.2,1924,90,http://content8.flixster.com/movie/29/36/293622_det.jpg
26096,The Cardinal,1963,cardinal,6,10,6,4,60,0,2,1,1,50,3.4,252,53,http://content9.flixster.com/movie/30/10/301007_det.jpg
26101,McLintock!,1963,mclintock,0,3,2,1,66,0,0,0,0,0,0,0,0,http://content7.flixster.com/movie/85/25/82/8525821_det.jpg
26107,"The Prize Winner of Defiance, Ohio",2005,prize_winner_of_defiance_ohio,6.1,79,46,33,58,6.1,28,14,14,50,3.2,7811,55,http://content6.flixster.com/movie/25/02/250216_det.jpg
26110,36 Hours,1965,1068456-36_hours,0,1,1,0,100,0,0,0,0,0,0,0,0,http://content6.flixster.com/movie/10/89/86/10898612_det.jpg
26111,Becket,1964,becket,7.3,24,18,6,75,6.4,9,6,3,66,4.1,1602,88,http://content9.flixster.com/movie/97/82/77/9782771_det.jpg
26112,Behold a Pale Horse,1964,behold_a_pale_horse,7,7,6,1,85,0,2,1,1,50,3.4,71,65,http://content8.flixster.com/movie/10/85/77/10857750_det.jpg
26113,The Best Man,2005,unhitched,0,1,1,0,100,0,0,0,0,0,0,0,0,http://content8.flixster.com/movie/36/71/69/3671694_det.jpg
26116,"Hush...Hush, Sweet Charlotte",1964,hushhush_sweet_charlotte,7.3,19,16,3,84,0,0,0,0,0,0,0,0,http://content7.flixster.com/movie/10/87/07/10870781_det.jpg
26117,Natural Born Killers,1994,natural_born_killers,6,29,15,14,51,5.9,7,3,4,42,3.5,39062,80,http://content8.flixster.com/movie/10/88/54/10885402_det.jpg
26119,The Naked Kiss,1964,the-naked-kiss,7.4,9,8,1,88,0,0,0,0,0,0,0,0,http://content6.flixster.com/movie/30/30/303096_det.jpg
26122,Onibaba,1964,onibaba,6.6,11,9,2,81,0,3,1,2,33,4.1,1496,91,http://content9.flixster.com/movie/28/82/288223_det.jpg
26123,Robin and the 7 Hoods,1964,robin_and_the_seven_hoods,5.9,9,4,5,44,0,0,0,0,0,0,0,0,http://content9.flixster.com/movie/10/87/80/10878079_det.jpg
26124,Robinson Crusoe on Mars,1964,robinson_crusoe_on_mars,6.4,12,11,1,91,0,0,0,0,0,0,0,0,http://content9.flixster.com/movie/43/59/30/4359303_det.jpg
26128,What a Way to Go!,1964,what_a_way_to_go,4.1,5,0,5,0,0,2,0,2,0,3.7,212,67,http://content6.flixster.com/movie/10/85/77/10857748_det.jpg
26131,La battaglia di Algeri,1966,battle_of_algiers,9,70,69,1,98,8.9,17,17,0,100,4.4,4133,95,http://content9.flixster.com/movie/10/94/26/10942603_det.jpg
26133,A Charlie Brown Christmas,1965,charlie_brown_christmas,8.5,12,11,1,91,0,0,0,0,0,0,0,0,http://content9.flixster.com/movie/29/05/290503_det.jpg
26134,Dracula: Prince of Darkness,1966,dracula_prince_of_darkness,6.3,12,10,2,83,0,1,0,1,0,3.3,1485,63,http://content6.flixster.com/movie/46/24/12/4624124_det.jpg
26136,The Hallelujah Trail,1965,hallelujah_trail,0,3,2,1,66,0,0,0,0,0,0,0,0,http://content9.flixster.com/movie/28/64/286411_det.jpg
26138,House on Haunted Hill,1959,1010034-house_on_haunted_hill,7,19,18,1,94,0,2,1,1,50,3.4,4234,70,http://content9.flixster.com/movie/48/67/86/4867863_det.jpg
26139,In Harm's Way,1965,in_harms_way,5.2,10,5,5,50,0,0,0,0,0,0,0,0,http://content6.flixster.com/movie/29/10/291092_det.jpg
26142,Major Dundee,1965,major_dundee,7.3,30,29,1,96,7.3,14,14,0,100,3.3,808,61,http://content6.flixster.com/movie/10/86/77/10867700_det.jpg
26144,Operation Crossbow,1965,operation_crossbow,5.7,5,3,2,60,0,0,0,0,0,0,0,0,http://content8.flixster.com/movie/31/25/312518_det.jpg
26147,A Thousand Clowns,1965,thousand_clowns,6.9,9,7,2,77,0,0,0,0,0,0,0,0,http://content9.flixster.com/movie/95/70/86/9570867_det.jpg
26148,Strangers on a Train,1951,strangers_on_a_train,8.7,40,39,1,97,7.3,5,4,1,80,4,9106,91,http://content9.flixster.com/movie/10/93/77/10937755_det.jpg
26150,Andrey Rublyov,1966,andrei-rublev,8.7,14,13,1,92,0,2,1,1,50,4.5,3531,94,http://content9.flixster.com/movie/29/58/295899_det.jpg
26151,Au hasard Balthazar,1966,balthazar,9.2,29,29,0,100,9,7,7,0,100,4.2,1694,87,http://content8.flixster.com/movie/10/89/42/10894278_det.jpg
26152,Batman,1966,batman_the_movie,6.2,22,18,4,81,0,1,1,0,100,3,13951,51,http://content8.flixster.com/movie/10/85/60/10856086_det.jpg
26155,Khartoum,1966,khartoum,6.6,9,8,1,88,0,0,0,0,0,0,0,0,http://content9.flixster.com/movie/10/85/88/10858855_det.jpg
26158,Ostre sledovan√© vlaky,1966,closely-watched-trains,7.7,14,14,0,100,0,1,1,0,100,4,1286,87,http://content9.flixster.com/movie/10/85/71/10857163_det.jpg
26159,T√¥ky√¥ nagaremono,1966,tokyo_drifter,7.5,7,7,0,100,0,1,1,0,100,0,0,0,http://content7.flixster.com/movie/30/28/302813_det.jpg
26163,Dont Look Back,1967,dont-look-back,8.4,17,17,0,100,0,4,4,0,100,4.2,1544,91,http://content6.flixster.com/movie/10/85/86/10858636_det.jpg
26170,La mari√©e √©tait en noir,1968,bride_wore_black,7.6,9,9,0,100,0,3,3,0,100,3.7,1464,78,http://content7.flixster.com/movie/10/89/03/10890305_det.jpg
26171,Play Time,1967,playtime,8.7,34,34,0,100,8.3,9,9,0,100,4.3,2267,91,http://content8.flixster.com/movie/30/34/303402_det.jpg
26172,Grosse Pointe Blank,1997,grosse_pointe_blank,7.1,57,44,13,77,6.5,15,11,4,73,3.7,17815,85,http://content7.flixster.com/movie/26/73/267397_det.jpg
26174,Shooting Dogs,2005,beyond-the-gates,7.2,60,50,10,83,6.5,18,13,5,72,3.9,11089,81,http://content9.flixster.com/movie/10/87/23/10872351_det.jpg
26176,Titicut Follies,1967,titicut_follies,7.2,5,5,0,100,0,1,1,0,100,4.2,367,91,http://content9.flixster.com/movie/32/88/01/3288011_det.jpg
26178,Two for the Road,1967,two_for_the_road,7.2,12,10,2,83,0,0,0,0,0,0,0,0,http://content6.flixster.com/movie/29/04/290492_det.jpg
26181,The War Wagon,1967,star_wagon,0,0,0,0,0,0,0,0,0,0,0,0,0,http://content6.flixster.com/movie/10/85/27/10852736_det.jpg
26185,Dracula Has Risen from the Grave,1968,dracula_has_risen_from_the_grave,6.6,13,10,3,76,0,0,0,0,0,0,0,0,http://content7.flixster.com/movie/10/90/78/10907853_det.jpg
26187,Head,1968,monkees-in-head,0,0,0,0,0,0,0,0,0,0,0,0,0,http://images.rottentomatoescdn.com/images/defaults/poster_default.gif
26189,"I Love You, Alice B. Toklas!",1968,i-love-you-alice-b-toklas1968,0,0,0,0,0,0,0,0,0,0,0,0,0,http://content7.flixster.com/movie/10/85/76/10857645_det.jpg
26198,"Yours, Mine and Ours",2005,yours_mine_and_ours,3.3,105,6,99,5,3.7,28,1,27,3,3.2,36270,64,http://content6.flixster.com/movie/25/06/250608_det.jpg
26199,Alice's Restaurant,1969,alices_restaurant,6,14,9,5,64,0,4,3,1,75,3.4,935,61,http://content6.flixster.com/movie/26/85/268520_det.jpg
26203,Colossus: The Forbin Project,1970,colossus_the_forbin_project,0,4,4,0,100,0,0,0,0,0,0,0,0,http://content8.flixster.com/movie/25/70/257002_det.jpg
26208,Ma nuit chez Maud,1969,my_night_at_mauds,8,15,14,1,93,0,2,2,0,100,4.1,2027,85,http://content8.flixster.com/movie/10/89/92/10899286_det.jpg
26211,More,1969,more,0,3,1,2,33,0,1,0,1,0,3.7,386,71,http://content7.flixster.com/movie/29/84/298401_det.jpg
26222,Dodesukaden,1970,dodesukaden-clickety-clack,5.8,6,3,3,50,0,0,0,0,0,0,0,0,http://content7.flixster.com/movie/83/85/29/8385297_det.jpg
26225,Le genou de Claire,1970,claires_knee,8.4,19,18,1,94,0,3,3,0,100,3.9,808,82,http://content8.flixster.com/movie/10/88/70/10887066_det.jpg
26226,"Hi, Mom!",1970,hi_mom,7.2,8,5,3,62,0,0,0,0,0,0,0,0,http://content9.flixster.com/movie/10/43/99/10439959_det.jpg
26228,En k√§rlekshistoria,1970,a-swedish-love-story,0,0,0,0,0,0,0,0,0,0,0,0,0,http://content8.flixster.com/movie/10/85/82/10858218_det.jpg
26230,On a Clear Day You Can See Forever,1970,on_a_clear_day_you_can_see_forever,6.3,8,8,0,100,0,0,0,0,0,0,0,0,http://content9.flixster.com/movie/25/10/251027_det.jpg
26231,Performance,1970,performance,7.4,19,17,2,89,0,1,0,1,0,3.9,1292,81,http://content7.flixster.com/movie/28/97/08/2897085_det.jpg
26240,The Beguiled,1971,beguiled,6.9,10,9,1,90,0,0,0,0,0,0,0,0,http://content7.flixster.com/movie/27/13/271309_det.jpg
26241,The Devil's Advocate,1997,devils_advocate,6.2,43,28,15,65,5.8,10,4,6,40,3.4,30966,78,http://content6.flixster.com/movie/83/07/830796_det.jpg
26242,Duel,1971,1006345-duel,7.7,36,31,5,86,0,2,1,1,50,3.6,6809,80,http://content9.flixster.com/movie/25/57/255711_det.jpg
26246,Johnny Got His Gun,1971,johnny_got_his_gun,6.6,20,14,6,70,0,4,1,3,25,4.1,1730,88,http://content9.flixster.com/movie/24/99/19/2499199_det.jpg
26249,Lo chiamavano Trinit√†...,1970,they_call_me_trinity,0,2,0,2,0,0,1,0,1,0,3.7,1690,79,http://content7.flixster.com/movie/10/88/19/10881905_det.jpg
26251,Mon oncle Antoine,1971,mon_oncle_antoine,0,4,4,0,100,0,0,0,0,0,0,0,0,http://content9.flixster.com/movie/11/15/03/11150363_det.jpg
26258,El topo,1970,el_topo,6.8,31,23,8,74,6.8,6,4,2,66,4.1,4272,86,http://content9.flixster.com/movie/10/89/51/10895167_det.jpg
26265,Dr. Phibes Rises Again,1972,dr_phibes_rises_again,5.5,9,4,5,44,0,0,0,0,0,0,0,0,http://content7.flixster.com/movie/10/93/52/10935289_det.jpg
26269,Kozure √¥kami: Ko wo kashi ude kashi tsukamatsuru,1972,,\N,\N,\N,\N,\N,\N,\N,\N,\N,\N,\N,\N,\N,\N
26270,Kozure √îkami: Sanzu no kawa no ubaguruma,1972,lone_wolf_and_cub_baby_cart_at_the_river_styx,0,4,4,0,100,0,0,0,0,0,0,0,0,http://content8.flixster.com/movie/11/15/35/11153566_det.jpg
26271,Lady Sings the Blues,1972,lady_sings_the_blues,6.7,12,9,3,75,0,4,3,1,75,3.9,1795,85,http://content6.flixster.com/movie/10/87/22/10872232_det.jpg
26277,Slither,2006,slither,6.9,129,110,19,85,6.4,29,22,7,75,3.2,31835,58,http://content7.flixster.com/movie/31/35/313501_det.jpg
26280,Traffic,2000,1103281-traffic,8,149,136,13,91,7.8,39,36,3,92,3.5,26217,81,http://content9.flixster.com/movie/27/66/276615_det.jpg
26283,Charley Varrick,1973,charley_varrick,7.4,7,6,1,85,0,0,0,0,0,0,0,0,http://content6.flixster.com/movie/25/73/257320_det.jpg
26285,Dark Star,1974,dark_star,6.5,21,17,4,80,0,4,2,2,50,3.4,3930,65,http://content9.flixster.com/movie/25/14/251415_det.jpg
26289,Emperor of the North Pole,1973,1162563-emperor_of_the_north,0,4,3,1,75,0,2,1,1,50,3.8,503,81,http://content8.flixster.com/movie/24/15/10/2415106_det.jpg
26294,Il mio nome √® Nessuno,1973,my_name_is_nobody,0,1,1,0,100,0,0,0,0,0,0,0,0,http://content7.flixster.com/movie/10/92/00/10920085_det.jpg
26301,Save the Tiger,1973,save_the_tiger,7,10,9,1,90,0,1,1,0,100,3.5,617,63,http://content9.flixster.com/movie/26/74/267491_det.jpg
26302,Scarecrow,1973,1018318-scarecrow,7.7,12,8,4,66,0,3,1,2,33,3.7,1738,79,http://content9.flixster.com/movie/10/89/27/10892771_det.jpg
26303,The Banger Sisters,2002,banger_sisters,5.3,140,66,74,47,5.1,34,14,20,41,2.7,4139,45,http://content6.flixster.com/movie/27/44/274416_det.jpg
26306,Theater of Blood,1973,theatre_of_blood,7.4,23,22,1,95,0,2,2,0,100,3.6,1253,75,http://content8.flixster.com/movie/10/88/74/10887490_det.jpg
26313,California Split,1974,california_split,7.3,11,10,1,90,7.1,5,4,1,80,3.8,753,81,http://content8.flixster.com/movie/27/93/279314_det.jpg
26318,Le fant√¥me de la libert√©,1974,phantom_of_liberty,8.3,16,14,2,87,0,4,4,0,100,4.1,1386,90,http://content6.flixster.com/movie/27/28/272800_det.jpg
26323,The Groove Tube,1974,groove_tube,3.8,8,1,7,12,0,0,0,0,0,0,0,0,http://content8.flixster.com/movie/28/97/74/2897742_det.jpg
26326,The Holy Mountain,1973,holy_mountain,6.9,18,15,3,83,7.5,6,6,0,100,4.3,3854,90,http://content6.flixster.com/movie/10/89/81/10898188_det.jpg
26336,The Adventure of Sherlock Holmes' Smarter Brother,1975,adventure_of_sherlock_holmes_smarter_brother,0,2,1,1,50,0,0,0,0,0,0,0,0,http://content8.flixster.com/movie/11/14/28/11142882_det.jpg
26339,Dolemite,1975,dolemite,4.6,5,2,3,40,0,0,0,0,0,0,0,0,http://content7.flixster.com/movie/99/66/56/9966561_det.jpg
26345,The Great Waldo Pepper,1975,great_waldo_pepper,5.9,7,5,2,71,0,1,1,0,100,3.2,560,50,http://content9.flixster.com/movie/10/86/89/10868971_det.jpg
26349,Night Moves,1975,night_moves,7.4,17,14,3,82,0,4,4,0,100,0,0,0,http://content8.flixster.com/movie/10/83/84/10838482_det.jpg
26350,Professione: reporter,1975,the-passenger-professione-reporter,8.1,64,58,6,90,9,15,15,0,100,4,2771,85,http://content7.flixster.com/movie/10/92/73/10927313_det.jpg
26359,Novecento,1976,1000039-1900,5.9,14,6,8,42,0,3,0,3,0,4.1,2572,86,http://content7.flixster.com/movie/10/91/97/10919761_det.jpg
26360,L'argent de poche,1976,small_change,7.7,11,11,0,100,0,3,3,0,100,4,793,85,http://content6.flixster.com/movie/26/02/260228_det.jpg
26364,From Noon Till Three,1976,from_noon_till_three,0,1,0,1,0,0,0,0,0,0,0,0,0,http://content9.flixster.com/movie/94/44/21/9444211_det.jpg
26366,Harlan County U.S.A.,1976,harlan_county_usa,9.1,7,7,0,100,0,2,2,0,100,4.2,797,88,http://content6.flixster.com/movie/15/52/28/1552288_det.jpg
26371,The Missouri Breaks,1976,,6.5,18,15,3,83,0,3,1,2,33,3.3,1054,61,http://content8.flixster.com/movie/25/42/254210_det.jpg
26375,Silver Streak,1976,1019017-silver_streak,6.4,18,15,3,83,0,1,1,0,100,3.4,1982,68,http://content7.flixster.com/movie/25/52/255209_det.jpg
26379,Jesus of Nazareth,1977,jesus_of_nazareth-1977,0,3,3,0,100,0,0,0,0,0,0,0,0,http://content6.flixster.com/movie/10/95/80/10958020_det.jpg
26386,High Anxiety,1977,high_anxiety,6.4,26,19,7,73,0,1,0,1,0,3.4,4006,67,http://content6.flixster.com/movie/65/08/650844_det.jpg
26388,The Hound of the Baskervilles,1959,1010004-hound_of_the_baskervilles,7.8,11,11,0,100,0,0,0,0,0,0,0,0,http://content6.flixster.com/movie/11/13/75/11137592_det.jpg
26391,Gangs of New York,2002,gangs_of_new_york,7.1,200,149,51,74,6.5,42,28,14,66,3.5,35768,76,http://content6.flixster.com/movie/26/81/268116_det.jpg
26393,Sorcerer,1977,1019441-sorcerer,7.1,15,12,3,80,0,1,1,0,100,3.8,787,79,http://content8.flixster.com/movie/25/82/258218_det.jpg
26394,The Turning Point,1977,1022131-turning_point,5.9,11,6,5,54,0,0,0,0,0,0,0,0,http://content9.flixster.com/movie/10/94/73/10947387_det.jpg
26398,Capricorn One,1977,capricorn_one,6,17,10,7,58,0,1,0,1,0,0,0,0,http://content9.flixster.com/movie/26/01/260127_det.jpg
26404,In Praise of Older Women,1978,,\N,\N,\N,\N,\N,\N,\N,\N,\N,\N,\N,\N,\N,\N
26413,Se ying diu sau,1978,snake_in_the_eagles_shadow,0,2,1,1,50,0,0,0,0,0,0,0,0,http://content6.flixster.com/movie/26/56/265628_det.jpg
26414,Wedding Crashers,2005,wedding_crashers,6.7,180,135,45,75,6.9,38,28,10,73,3.5,215271,70,http://content9.flixster.com/movie/24/98/249823_det.jpg
26422,Hair,1979,hair,7.2,15,14,1,93,0,0,0,0,0,0,0,0,http://content7.flixster.com/movie/10/92/36/10923629_det.jpg
26425,The In-Laws,2003,inlaws,4.9,126,44,82,34,4.9,35,12,23,34,2.9,2546,42,http://content7.flixster.com/movie/26/40/264009_det.jpg
26431,Opening Night,1977,opening_night,7.8,21,20,1,95,0,3,3,0,100,4.1,1012,91,http://content7.flixster.com/movie/26/55/265593_det.jpg
26462,Bad Boys,1995,1062483-bad_boys,4.8,41,16,25,39,3.7,9,1,8,11,3.5,67658,79,http://content8.flixster.com/movie/28/27/282798_det.jpg
26464,Blue Thunder,1983,,6.2,19,15,4,78,0,0,0,0,0,0,0,0,http://content9.flixster.com/movie/27/42/274291_det.jpg
26465,D.C. Cab,1983,dc_cab,0,2,0,2,0,0,0,0,0,0,0,0,0,http://content9.flixster.com/movie/26/90/269011_det.jpg
26472,El Norte,1983,el_norte,7.5,9,8,1,88,0,0,0,0,0,0,0,0,http://content9.flixster.com/movie/93/08/17/9308179_det.png
26476,Merry Christmas Mr. Lawrence,1983,merry_christmas_mr_lawrence,6.2,19,15,4,78,5,5,2,3,40,3.9,1571,83,http://content8.flixster.com/movie/29/42/10/2942102_det.jpg
26479,The Pirates of Penzance,1983,1016365-pirates_of_penzance,7.3,12,10,2,83,0,0,0,0,0,0,0,0,http://content9.flixster.com/movie/22/20/92/2220923_det.jpg
26483,Rock & Rule,1983,rock-rule,0,3,1,2,33,0,0,0,0,0,0,0,0,http://content6.flixster.com/movie/11/14/76/11147632_det.jpg
26485,Rumble Fish,1983,rumble_fish,6,23,16,7,69,5,5,2,3,40,3.6,6328,78,http://content8.flixster.com/movie/10/85/08/10850858_det.jpg
26487,Star 80,1983,star_80,7.3,9,8,1,88,0,1,1,0,100,3.3,628,62,http://content8.flixster.com/movie/10/88/26/10882694_det.jpg
26488,The Star Chamber,1983,star_chamber,6,14,10,4,71,0,1,0,1,0,3,539,40,http://content9.flixster.com/movie/11/13/78/11137807_det.jpg
26491,To Be or Not to Be,1942,1021557-to_be_or_not_to_be,8.7,34,33,1,97,7,5,4,1,80,4.2,1733,92,http://content8.flixster.com/movie/91/04/09/9104098_det.jpg
26492,Twilight Zone: The Movie,1983,twilight_zone_the_movie,5.8,30,20,10,66,0,4,2,2,50,3.2,7313,56,http://content6.flixster.com/movie/10/88/60/10886020_det.jpg
26494,SubUrbia,1996,1075781-suburbia,6.3,21,13,8,61,6.4,6,3,3,50,3.3,1247,66,http://content7.flixster.com/movie/10/87/78/10877809_det.jpg
26495,Yellowbeard,1983,yellowbeard,5,9,2,7,22,0,1,0,1,0,3.3,1410,63,http://content9.flixster.com/movie/10/85/78/10857843_det.jpg
26497,Another Country,1984,another_country,0,3,2,1,66,0,0,0,0,0,0,0,0,http://content7.flixster.com/movie/25/75/257517_det.jpg
26498,Boy Meets Girl,1984,1032409-boy_meets_girl,0,1,1,0,100,0,0,0,0,0,0,0,0,http://content8.flixster.com/movie/10/88/05/10880582_det.jpg
26504,Cloak & Dagger,1984,1004370-cloak_and_dagger,5,5,2,3,40,0,0,0,0,0,0,0,0,http://content8.flixster.com/movie/25/49/254914_det.jpg
26509,Electric Dreams,1984,1006510-electric_dreams,5.4,5,2,3,40,0,1,1,0,100,3.6,758,72,http://content9.flixster.com/movie/21/66/57/2166571_det.jpg
26513,The Ice Pirates,1984,ice_pirates,3.9,9,1,8,11,0,0,0,0,0,0,0,0,http://content6.flixster.com/movie/75/70/93/7570936_det.jpg
26521,Racing with the Moon,1984,racing_with_the_moon,6.1,10,6,4,60,0,3,3,0,100,3.3,795,57,http://content9.flixster.com/movie/26/37/263719_det.jpg
26524,The Times of Harvey Milk,1984,times_of_harvey_milk,8.3,16,16,0,100,0,1,1,0,100,4.2,1883,93,http://content8.flixster.com/movie/29/80/298094_det.jpg
26527,¬øQu√© he hecho yo para merecer esto!!,1984,what_have_i_done_to_deserve_this,7.6,6,6,0,100,0,1,1,0,100,3.8,1849,80,http://content6.flixster.com/movie/10/89/23/10892300_det.jpg
26544,Heaven Help Us,1985,heaven_help_us,5.6,5,2,3,40,0,1,0,1,0,3.5,872,67,http://content6.flixster.com/movie/10/92/26/10922668_det.jpg
26547,Ging chat goo si,1985,police_story,6.9,12,10,2,83,0,1,1,0,100,3.7,4759,84,http://content8.flixster.com/movie/10/87/13/10871310_det.jpg
26550,Mishima: A Life in Four Chapters,1985,mishima_a_life_in_four_chapters,7.4,20,19,1,95,0,2,2,0,100,4.2,932,91,http://content6.flixster.com/movie/10/90/89/10908912_det.jpg
26554,The Quiet Earth,1985,quiet_earth,6.2,8,5,3,62,0,0,0,0,0,0,0,0,http://content6.flixster.com/movie/12/80/73/1280732_det.jpg
26555,Spies Like Us,1985,spies_like_us,4.6,18,8,10,44,0,0,0,0,0,0,0,0,http://content6.flixster.com/movie/25/80/258000_det.jpg
26558,The Stuff,1985,stuff,6.1,8,5,3,62,0,1,0,1,0,3.1,1354,48,http://content6.flixster.com/movie/27/28/272828_det.jpg
26561,Vision Quest,1985,vision_quest,5.4,12,7,5,58,0,1,1,0,100,3.5,1468,71,http://content7.flixster.com/movie/10/93/74/10937413_det.jpg
26562,White Nights,1985,white-nights,5.1,13,6,7,46,0,1,0,1,0,3.4,1109,74,http://content8.flixster.com/movie/11/15/10/11151086_det.jpg
26564,'Round Midnight,1986,round_midnight,8.1,17,17,0,100,8.3,6,6,0,100,4.1,809,88,http://content6.flixster.com/movie/54/66/26/5466268_det.jpg
26566,The Best of Times,1986,1002178-best_of_times,4.7,12,4,8,33,0,1,0,1,0,2.9,1014,41,http://content9.flixster.com/movie/26/15/261599_det.jpg
26567,Club Paradise,1986,paradise-1986,0,0,0,0,0,0,0,0,0,0,0,0,0,http://content6.flixster.com/movie/10/88/84/10888432_det.jpg
26577,Nobody's Fool,1986,1015224-nobodys_fool,0,4,0,4,0,0,1,0,1,0,3,289,43,http://content6.flixster.com/movie/26/56/265692_det.jpg
26578,Offret,1986,1018055-sacrifice,7.2,25,20,5,80,0,4,3,1,75,4.4,1787,92,http://content8.flixster.com/movie/26/28/262826_det.jpg
26585,Ying hung boon sik,1986,better_tomorrow,7.3,14,13,1,92,0,0,0,0,0,0,0,0,http://content8.flixster.com/movie/11/13/22/11132266_det.jpg
26599,La ley del deseo,1987,law_of_desire,7.4,11,11,0,100,0,2,2,0,100,3.8,1875,79,http://content6.flixster.com/movie/19/57/58/1957584_det.jpg
26603,Prince of Darkness,1987,prince_of_darkness,5.1,19,9,10,47,0,1,0,1,0,3.3,3606,59,http://content6.flixster.com/movie/28/31/283108_det.jpg
26606,Sien nui yau wan,1987,chinese_ghost_story,7.8,8,6,2,75,0,0,0,0,0,0,0,0,http://content7.flixster.com/movie/11/12/73/11127361_det.jpg
26614,The Bourne Identity,2002,bourne_identity,7,180,148,32,82,6.9,37,30,7,81,3.9,125823,91,http://content9.flixster.com/movie/10/81/65/10816575_det.jpg
26616,Cobra Verde,1987,cobra_verde,6.9,14,12,2,85,0,3,2,1,66,3.7,950,74,http://content8.flixster.com/movie/51/69/34/5169342_det.jpg
26629,Killer Klowns from Outer Space,1988,killer_klowns_from_outer_space,5.6,13,9,4,69,0,0,0,0,0,0,0,0,http://content6.flixster.com/movie/25/64/256416_det.jpg
26649,Lonesome Dove,1989,,\N,\N,\N,\N,\N,\N,\N,\N,\N,\N,\N,\N,\N,\N
26662,Majo no takky√ªbin,1989,cat-girl-kiki,0,0,0,0,0,0,0,0,0,0,0,0,0,http://content9.flixster.com/movie/10/94/88/10948831_det.jpg
26663,Monsieur Hire,1989,monsieur_hire,8,11,11,0,100,0,2,2,0,100,3.9,441,84,http://content6.flixster.com/movie/10/86/38/10863892_det.jpg
26676,Almost an Angel,1990,almost_an_angel,3.9,7,2,5,28,0,1,0,1,0,0,0,0,http://content6.flixster.com/movie/10/90/70/10907048_det.jpg
26677,Black Rainbow,1989,black_rainbow,0,3,3,0,100,0,0,0,0,0,0,0,0,http://content8.flixster.com/movie/10/96/30/10963078_det.jpg
26680,Cry-Baby,1990,cry-baby,6.7,37,30,7,81,6.2,6,4,2,66,3.3,38084,75,http://content9.flixster.com/movie/55/36/05/5536059_det.jpg
26681,Die xue jie tou,1990,1054247-bullet_in_the_head,8.4,5,5,0,100,0,0,0,0,0,0,0,0,http://content6.flixster.com/movie/10/92/33/10923380_det.jpg
26682,New York Beat Movie,1981,new-york-beat-movie-downtown-81,5.7,21,15,6,71,6.7,8,7,1,87,3.7,653,71,http://content6.flixster.com/movie/11/15/07/11150740_det.jpg
26686,Ghost Dad,1990,ghost_dad,2.2,19,1,18,5,0,4,1,3,25,2.5,2569,38,http://content6.flixster.com/movie/42/45/38/4245384_det.jpg
26688,Hard to Kill,1990,hard_to_kill,3.7,10,3,7,30,0,1,0,1,0,2.7,4865,52,http://content6.flixster.com/movie/27/24/272416_det.jpg
26693,It,1990,stephen-kings-it1990,5.6,10,7,3,70,0,0,0,0,0,0,0,0,http://content8.flixster.com/movie/28/59/285922_det.jpg
26694,Ju Dou,1990,ju_dou,8.3,14,14,0,100,0,3,3,0,100,3.9,1328,86,http://content7.flixster.com/movie/25/97/259713_det.jpg
26695,The Krays,1990,krays,6.4,12,10,2,83,0,2,2,0,100,3.7,1447,82,http://content6.flixster.com/movie/10/87/81/10878168_det.jpg
26696,Lionheart,1990,1032883-lionheart,4,11,3,8,27,0,3,1,2,33,3,2754,54,http://content7.flixster.com/movie/10/92/04/10920481_det.jpg
26698,Narrow Margin,1990,1030146-narrow_margin,6,11,7,4,63,0,2,0,2,0,3,630,42,http://content7.flixster.com/movie/27/50/275013_det.jpg
26700,Nuns on the Run,1990,nuns_on_the_run,4.7,18,8,10,44,0,2,1,1,50,2.9,1378,48,http://content9.flixster.com/movie/10/92/65/10926531_det.jpg
26704,State of Grace,1990,state_of_grace,6.8,15,13,2,86,0,2,2,0,100,3.7,2900,79,http://content9.flixster.com/movie/10/87/16/10871603_det.jpg
26713,A Fei zheng chuan,1990,days_of_being_wild,7.7,29,26,3,89,8.1,13,12,1,92,4,3441,87,http://content7.flixster.com/movie/28/76/287625_det.jpg
26726,Predator,1987,predator,6.8,37,28,9,75,0,4,2,2,50,3.5,52908,83,http://content8.flixster.com/movie/10/93/20/10932042_det.jpg
26729,Hearts of Darkness: A Filmmaker's Apocalypse,1991,hearts_of_darkness_a_filmmakers_apocalypse,8.5,24,24,0,100,8.2,6,6,0,100,4.1,3043,90,http://content6.flixster.com/movie/10/88/20/10882044_det.jpg
26734,A Kiss Before Dying,1956,1101255-kiss_before_dying,0,4,3,1,75,0,0,0,0,0,0,0,0,http://content7.flixster.com/movie/10/83/91/10839121_det.jpg
26743,Omohide poro poro,1991,omohide_poro_poro,0,3,3,0,100,0,0,0,0,0,0,0,0,http://content6.flixster.com/movie/37/75/54/3775548_det.jpg
26744,Once Around,1991,once_around,5.9,18,12,6,66,5.4,5,3,2,60,3.5,705,71,http://content6.flixster.com/movie/10/85/06/10850668_det.jpg
26745,Other People's Money,1991,other_peoples_money,4.6,14,5,9,35,0,2,1,1,50,2.8,936,42,http://content7.flixster.com/movie/10/87/34/10873433_det.jpg
26746,Out for Justice,1991,out_for_justice,3.6,20,4,16,20,0,4,1,3,25,3,3054,57,http://content8.flixster.com/movie/27/30/273022_det.jpg
26750,Quigley Down Under,1990,quigley_down_under,5.5,15,9,6,60,0,2,0,2,0,3.2,3350,67,http://content8.flixster.com/movie/25/69/256918_det.jpg
26758,Tous les matins du monde,1991,tous_les_matins_du_monde,7.2,9,8,1,88,0,2,1,1,50,4.1,1291,87,http://content8.flixster.com/movie/10/91/53/10915330_det.jpg
26770,Diggstown,1992,diggstown,5.5,13,7,6,53,0,0,0,0,0,0,0,0,http://content9.flixster.com/movie/27/13/271307_det.jpg
26776,Kurenai no buta,1992,porco_rosso,8.2,12,12,0,100,0,0,0,0,0,0,0,0,http://content7.flixster.com/movie/10/88/88/10888865_det.jpg
26778,Ladybugs,1992,ladybugs,3.7,13,2,11,15,0,1,0,1,0,2.6,2093,41,http://content9.flixster.com/movie/10/89/83/10898391_det.jpg
26782,The Mambo Kings,1992,mambo_kings,6.6,19,15,4,78,0,2,2,0,100,3.3,1188,61,http://content9.flixster.com/movie/10/91/63/10916363_det.jpg
26788,Qiu Ju da guan si,1992,story_of_qiu_ju,8,14,12,2,85,0,2,1,1,50,3.9,768,83,http://content7.flixster.com/movie/10/89/10/10891025_det.jpg
26791,Shining Through,1992,shining_through,4.4,13,4,9,30,0,2,1,1,50,3.4,1160,71,http://content7.flixster.com/movie/10/89/05/10890545_det.jpg
26792,Sidekick,2005,sidekick,7.3,13,13,0,100,0,0,0,0,0,0,0,0,http://content8.flixster.com/movie/11/05/66/11056642_det.jpg
26796,Un coeur en hiver,1992,un_coeur_en_hiver,7.7,13,11,2,84,0,2,2,0,100,4.1,1098,88,http://content8.flixster.com/movie/10/92/54/10925458_det.jpg
26803,√Ñnglag√•rd,1992,house_of_angels,7.2,5,4,1,80,0,1,1,0,100,3.7,254,72,http://content9.flixster.com/movie/10/12/14/10121423_det.jpg
26810,Bad Boy Bubby,1993,1144115-bad_boy_bubby,6.9,6,5,1,83,0,1,0,1,0,4,2270,87,http://content6.flixster.com/movie/10/90/21/10902176_det.jpg
26811,Bai fa mo nu zhuan,1993,bride_with_white_hair,8.1,7,7,0,100,0,0,0,0,0,0,0,0,http://content9.flixster.com/movie/10/92/36/10923627_det.jpg
26812,Barbarians at the Gate,1993,barbarians_at_the_gate,6,6,4,2,66,0,0,0,0,0,0,0,0,http://content9.flixster.com/movie/86/23/17/8623179_det.jpg
26819,Kakushi-toride no san-akunin,1958,1009583-hidden_fortress,8.6,22,22,0,100,0,2,2,0,100,4.1,6021,90,http://content6.flixster.com/movie/10/92/70/10927028_det.jpg
26828,Mr. Nanny,1993,mr_nanny,2.4,14,1,13,7,0,3,0,3,0,2.3,4808,38,http://content9.flixster.com/movie/21/00/14/2100147_det.jpg
26834,Philadelphia Experiment II,1993,philadelphia_experiment_2,0,0,0,0,0,0,0,0,0,0,0,0,0,http://content9.flixster.com/movie/10/93/80/10938003_det.jpg
26838,The Snapper,1993,snapper,7.4,31,30,1,96,7.8,7,7,0,100,0,0,0,http://content7.flixster.com/movie/28/97/32/2897329_det.jpg
26840,Sonatine,1993,sonatine,7.3,24,21,3,87,6.4,6,4,2,66,0,0,0,http://content7.flixster.com/movie/26/81/93/2681937_det.jpg
26841,Splitting Heirs,1993,splitting_heirs,3.8,12,1,11,8,0,2,0,2,0,2.6,577,34,http://content8.flixster.com/movie/10/86/94/10869482_det.jpg
26842,Tai ji: Zhang San Feng,1993,tai-chi-warriors,0,0,0,0,0,0,0,0,0,0,0,0,0,http://content6.flixster.com/movie/10/92/62/10926272_det.jpg
26861,Freaked,1993,freaked,5.4,15,7,8,46,0,1,1,0,100,3.3,1649,59,http://content8.flixster.com/movie/10/92/41/10924194_det.jpg
26865,Jing wu ying xiong,1994,fist-of-legend,7.9,11,11,0,100,0,0,0,0,0,0,0,0,http://content7.flixster.com/movie/11/12/07/11120765_det.jpg
26870,Major League II,1994,major_league_2,3.3,21,1,20,4,2.7,6,0,6,0,2.8,4428,45,http://content8.flixster.com/movie/25/67/256714_det.jpg
26875,Una pura formalit√†,1994,pure_formality,7,5,4,1,80,0,1,0,1,0,4.2,605,91,http://content6.flixster.com/movie/10/87/58/10875804_det.jpg
26898,Gonin,1995,gonin,6.8,6,5,1,83,0,0,0,0,0,0,0,0,http://content9.flixster.com/movie/10/88/89/10888983_det.jpg
26901,The Last of the Mohicans,1992,1040678-last_of_the_mohicans,8,32,31,1,96,7.9,7,7,0,100,3.6,34073,84,http://content6.flixster.com/movie/27/61/276124_det.jpg
26903,Mimi wo sumaseba,1995,whisper-of-the-heart,7.4,9,8,1,88,0,0,0,0,0,0,0,0,http://content6.flixster.com/movie/31/32/313204_det.jpg
26915,Tromeo and Juliet,1996,tromeo-and-juliet,0,3,2,1,66,0,0,0,0,0,0,0,0,http://content6.flixster.com/movie/27/34/273404_det.jpg
26934,Sik san,1996,god-of-cookery,0,3,3,0,100,0,0,0,0,0,0,0,0,http://content7.flixster.com/movie/11/13/01/11130145_det.jpg
26939,Kauas pilvet karkaavat,1996,kauas-pilvet-karkaavat-drifting-clouds-far-away-the-clouds-escape,7.1,9,9,0,100,7.2,5,5,0,100,4.1,737,90,http://content7.flixster.com/movie/88/75/82/8875829_det.jpg
26950,Sgt. Kabukiman N.Y.P.D.,1990,sgt-kabukiman-nypd,0,0,0,0,0,0,0,0,0,0,0,0,0,http://content7.flixster.com/movie/32/05/90/3205905_det.jpg
26965,Beautiful Boxer,2003,beautiful_boxer,6.7,35,28,7,80,6.7,12,9,3,75,3.9,879,88,http://content6.flixster.com/movie/10/89/35/10893596_det.jpg
26974,Gummo,1997,gummo,4.7,35,12,23,34,4.1,6,1,5,16,3.6,5657,76,http://content8.flixster.com/movie/10/88/05/10880554_det.jpg
26976,Chicago Cab,1997,hellcab,5.3,8,4,4,50,0,1,1,0,100,3.2,473,51,http://content6.flixster.com/movie/31/28/312828_det.jpg
26982,Men with Guns,1997,1082798-men_with_guns,7.6,26,23,3,88,0,4,4,0,100,3.9,476,84,http://content8.flixster.com/movie/10/92/05/10920542_det.jpg
26985,Nirvana,1997,1140962-nirvana,0,2,0,2,0,0,0,0,0,0,0,0,0,http://content9.flixster.com/movie/28/25/282519_det.jpg
26989,Perdita Durango,1997,dance_with_the_devil,5.3,9,3,6,33,0,0,0,0,0,0,0,0,http://content8.flixster.com/movie/28/86/288630_det.jpg
26996,Safe House,1998,1097142-safe_house,0,1,0,1,0,0,0,0,0,0,0,0,0,http://content9.flixster.com/movie/29/96/299627_det.jpg
27005,Interview,2007,10007916_interview,6,121,70,51,57,5.8,31,15,16,48,3.2,14637,53,http://content6.flixster.com/movie/87/30/54/8730548_det.jpg
27020,Gia,1998,,\N,\N,\N,\N,\N,\N,\N,\N,\N,\N,\N,\N,\N,\N
27022,Thursday,1998,thursday,3.9,6,2,4,33,0,0,0,0,0,0,0,0,http://content6.flixster.com/movie/10/86/94/10869432_det.jpg
27109,Shurayukihime,1973,lady-snowblood,0,2,2,0,100,0,0,0,0,0,0,0,0,http://content6.flixster.com/movie/10/93/10/10931008_det.jpg
27114,Takedown,2000,takedown_2000,0,0,0,0,0,0,0,0,0,0,0,0,0,http://content6.flixster.com/movie/69/95/699568_det.jpg
27186,Kirikou et la sorci√®re,1998,kirikou_and_the_sorceress,7.4,24,23,1,95,7.8,8,8,0,100,3.9,1078,85,http://content8.flixster.com/movie/29/39/293926_det.jpg
27193,Taxi 2,2000,taxi_2,0,3,2,1,66,0,0,0,0,0,0,0,0,http://content9.flixster.com/movie/25/72/46/2572467_det.jpg
27255,Bad ma ra khahad bord,1999,wind_will_carry_us,8.4,25,24,1,96,0,4,4,0,100,3.9,888,82,http://content6.flixster.com/movie/10/90/43/10904324_det.jpg
27266,2046,2004,2046,7.4,106,89,17,83,7.3,30,25,5,83,3.9,14211,84,http://content7.flixster.com/movie/24/99/249909_det.jpg
27271,Gohatto,1999,1101319-taboo,6.6,21,14,7,66,0,2,2,0,100,3.5,1242,70,http://content7.flixster.com/movie/30/02/300297_det.jpg
27316,Ruang talok 69,1999,6ixtynin9,6.6,17,16,1,94,0,3,3,0,100,3.4,613,74,http://content6.flixster.com/movie/30/62/306220_det.jpg
27317,√îdishon,1999,audition_1999,7,61,47,14,77,6.6,12,9,3,75,3.8,14430,81,http://content8.flixster.com/movie/10/93/24/10932402_det.jpg
27338,The Hole,2001,1125456-hole,5.8,15,8,7,53,0,1,0,1,0,3.1,5670,58,http://content7.flixster.com/movie/26/97/269725_det.jpg
27340,The Sleeping Dictionary,2003,sleeping_dictionary,0,3,0,3,0,0,0,0,0,0,0,0,0,http://content6.flixster.com/movie/26/95/269524_det.jpg
27362,Kabhi Khushi Kabhie Gham...,2001,kabhi-khushi-kabhie-gham,0,0,0,0,0,0,0,0,0,0,0,0,0,http://content8.flixster.com/movie/10/89/62/10896274_det.jpg
27368,Ast√©rix & Ob√©lix: Mission Cl√©op√¢tre,2002,asterix-obelix-mission-cleopatre,6.3,7,6,1,85,0,1,0,1,0,3.6,4436,78,http://content9.flixster.com/movie/31/39/313991_det.jpg
27370,Late Night Shopping,2001,1136907-late_night_shopping,5.7,5,3,2,60,0,0,0,0,0,0,0,0,http://content8.flixster.com/movie/10/88/94/10889498_det.jpg
27376,Der Tunnel,2001,the-tunnel,6.9,25,21,4,84,6.9,12,10,2,83,4,713,92,http://content7.flixster.com/movie/10/85/69/10856941_det.jpg
27391,The Laramie Project,2002,laramie_project,7,12,11,1,91,0,1,1,0,100,3.7,1662,78,http://content8.flixster.com/movie/11/14/00/11140030_det.jpg
27397,Gongdong gyeongbi guyeok JSA,2000,jsa-joint-security-area-aka-gongdong-gyeongbi-guyeok,6.9,12,9,3,75,0,3,1,2,33,4,2656,90,http://content7.flixster.com/movie/29/99/299917_det.jpg
27402,Dagon,2001,dagon,5.4,9,5,4,55,0,0,0,0,0,0,0,0,http://content7.flixster.com/movie/27/06/270605_det.jpg
27408,Ripley's Game,2002,ripleys_game,7.2,21,20,1,95,0,4,4,0,100,3.4,2169,63,http://content9.flixster.com/movie/27/64/276403_det.jpg
27410,Conspiracy,2008,conspiracy,0,2,0,2,0,0,1,0,1,0,2.5,968,22,http://content6.flixster.com/movie/10/84/07/10840768_det.jpg
27416,Jalla! Jalla!,2000,jalla-jalla-the-best-mans-wedding,5.4,8,4,4,50,0,1,0,1,0,3.7,1390,76,http://content9.flixster.com/movie/28/46/22/2846223_det.jpg
27432,The Beautiful Country,2004,story-of-a-beautiful-country,0,0,0,0,0,0,0,0,0,0,0,0,0,http://images.rottentomatoescdn.com/images/defaults/poster_default.gif
27434,Darkness,2002,darkness,2.7,52,2,50,3,2,11,0,11,0,2.6,4153,37,http://content9.flixster.com/movie/28/71/287119_det.jpg
27436,Mockingbird Don't Sing,2001,mockingbird_dont_sing,0,1,0,1,0,0,0,0,0,0,0,0,0,http://content6.flixster.com/movie/29/93/299300_det.jpg
27450,Blueberry,2004,blueberry,4.2,7,2,5,28,0,0,0,0,0,0,0,0,http://content8.flixster.com/movie/10/86/10/10861006_det.jpg
27456,Shackleton's Antarctic Adventure,2001,shackletons-antarctic-adventure,0,0,0,0,0,0,0,0,0,0,0,0,0,http://content8.flixster.com/movie/10/94/31/10943166_det.jpg
27491,Kairo,2001,1113170-pulse,6.8,48,35,13,72,6.4,14,10,4,71,3.3,3346,61,http://content8.flixster.com/movie/25/05/250502_det.jpg
27509,Carolina,2003,1131316-carolina,0,2,1,1,50,0,0,0,0,0,0,0,0,http://content6.flixster.com/movie/26/01/260112_det.jpg
27513,Hundstage,2001,dog_days,5.4,33,16,17,48,6.5,11,7,4,63,3.6,603,70,http://content8.flixster.com/movie/31/12/311226_det.jpg
27523,Yeopgijeogin geunyeo,2001,my_sassy_girl,0,2,2,0,100,0,0,0,0,0,0,0,0,http://content7.flixster.com/movie/62/18/621893_det.jpg
27528,The Warriors,1979,1023205-warriors,7.4,30,28,2,93,0,0,0,0,0,0,0,0,http://content6.flixster.com/movie/27/06/270600_det.jpg
27537,Nothing Is Private,2007,towelhead,5.3,110,52,58,47,5,33,16,17,48,3.4,2878,61,http://content8.flixster.com/movie/10/92/42/10924222_det.jpg
27555,Fubar,2002,fubar,6.2,11,6,5,54,0,1,1,0,100,0,0,0,http://content9.flixster.com/movie/10/92/94/10929455_det.jpg
27563,Katakuri-ke no k√¥fuku,2001,strange_faces_of_japanese_cinema,0,0,0,0,0,0,0,0,0,0,0,0,0,http://content6.flixster.com/movie/10/92/03/10920328_det.jpg
27564,Sex Is Comedy,2002,sex_is_comedy,6.4,46,32,14,69,6.5,19,12,7,63,3.1,1109,52,http://content8.flixster.com/movie/10/08/28/10082818_det.jpg
27573,Stratosphere Girl,2004,,\N,\N,\N,\N,\N,\N,\N,\N,\N,\N,\N,\N,\N,\N
27584,Dead End,2003,10003925-dead_end,6.1,7,6,1,85,0,0,0,0,0,0,0,0,http://content8.flixster.com/movie/10/87/81/10878126_det.jpg
27587,Pure,2002,,\N,\N,\N,\N,\N,\N,\N,\N,\N,\N,\N,\N,\N,\N
27592,Boksuneun naui geot,2002,sympathy-for-mr-vengeance-boksuneun-naui-geot,6.2,53,29,24,54,5.7,12,6,6,50,4,10632,86,http://content9.flixster.com/movie/25/00/250011_det.jpg
27604,Jisatsu s√¢kuru,2001,1125611-suicide_club,5.7,6,3,3,50,0,0,0,0,0,0,0,0,http://content8.flixster.com/movie/28/65/286526_det.jpg
27608,Immortel (ad vitam),2004,1144306-immortal,5.1,7,3,4,42,0,0,0,0,0,0,0,0,http://content7.flixster.com/movie/95/19/98/9519985_det.jpg
27611,Battlestar Galactica,2003,battlestar-gallactica,0,1,1,0,100,0,0,0,0,0,0,0,0,http://content8.flixster.com/movie/93/38/97/9338970_det.jpg
27618,A Sound of Thunder,2005,sound_of_thunder,2.9,96,6,90,6,2.9,23,1,22,4,2.4,12447,24,http://content9.flixster.com/movie/10/89/83/10898335_det.jpg
27620,Stupeur et tremblements,2003,fear_and_trembling,7.3,35,32,3,91,7.5,15,13,2,86,3.7,726,74,http://content8.flixster.com/movie/10/86/88/10868842_det.jpg
27627,Oasis,2002,1133147-oasis,7.7,28,25,3,89,7.9,12,12,0,100,4,289,85,http://content9.flixster.com/movie/10/89/37/10893791_det.jpg
27636,Herr Lehmann,2003,herr-lehmann-berlin-blues,0,0,0,0,0,0,0,0,0,0,0,0,0,http://content8.flixster.com/movie/35/67/46/3567462_det.jpg
27644,Ricordati di me,2003,remember_me_my_love,5.8,33,18,15,54,5.9,9,5,4,55,3.4,361,58,http://content9.flixster.com/movie/10/94/37/10943731_det.jpg
27648,Bright Young Things,2003,bright_young_things,6.3,107,70,37,65,6.5,32,21,11,65,3.5,1866,64,http://content8.flixster.com/movie/10/88/86/10888614_det.jpg
27660,The Animatrix,2003,animatrix,6.7,17,15,2,88,0,1,1,0,100,3.4,35884,68,http://content7.flixster.com/movie/29/27/292713_det.jpg
27664,The Brown Bunny,2003,brown_bunny,5.1,89,39,50,43,4.8,30,13,17,43,2.9,2486,48,http://content8.flixster.com/movie/10/88/57/10885774_det.jpg
27674,11:14,2003,1114,6.8,11,11,0,100,0,1,1,0,100,3.6,6342,75,http://content8.flixster.com/movie/58/27/59/5827590_det.jpg
27679,Xiao cheng zhi chun,2002,springtime-in-a-small-town,7.4,35,31,4,88,7.6,11,11,0,100,3.5,338,65,http://content7.flixster.com/movie/10/87/08/10870877_det.jpg
27685,Bring It on Again,2004,bring_it_on_again,0,0,0,0,0,0,0,0,0,0,0,0,0,http://content7.flixster.com/movie/10/87/70/10877033_det.jpg
27689,Les rivi√®res pourpres II - Les anges de l'apocalypse,2004,1141488-crimson_rivers_2_angels_of_the_apocalypse,0,2,0,2,0,0,0,0,0,0,0,0,0,http://content9.flixster.com/movie/10/50/20/10502099_det.jpg
27700,Ondskan,2003,1157810-evil,6.6,36,24,12,66,5.8,11,5,6,45,3.9,2971,85,http://content9.flixster.com/movie/31/29/312903_det.jpg
27706,Lemony Snicket's A Series of Unfortunate Events,2004,lemony_snicket,6.6,154,109,45,70,6.6,32,19,13,59,3.2,60437,61,http://content8.flixster.com/movie/40/88/39/4088394_det.jpg
27716,De gr√∏nne slagtere,2003,green_butchers,6.3,27,17,10,62,5.6,12,5,7,41,3.9,1464,84,http://content8.flixster.com/movie/27/98/279826_det.jpg
27721,Un long dimanche de fian√ßailles,2004,very_long_engagement,7.4,142,110,32,77,7.3,35,28,7,80,3.9,22939,84,http://content9.flixster.com/movie/10/93/23/10932371_det.jpg
27722,Ruang rak noi nid mahasan,2003,last_life_in_the_universe,7.4,40,36,4,90,7.8,11,11,0,100,4.1,3086,89,http://content7.flixster.com/movie/10/91/75/10917561_det.jpg
27727,Gegen die Wand,2004,punk-drunk-love-the-images-of-mick-rock,0,0,0,0,0,0,0,0,0,0,0,0,0,http://content8.flixster.com/movie/10/88/57/10885794_det.jpg
27728,Innocence,2004,ghost_in_the_shell_2_innocence,6.3,94,61,33,64,6.4,24,17,7,70,3.8,8464,80,http://content8.flixster.com/movie/10/93/14/10931402_det.jpg
27731,Neko no ongaeshi,2002,cat_returns,7,17,16,1,94,0,2,2,0,100,3.9,9609,81,http://content8.flixster.com/movie/99/06/77/9906774_det.jpg
27734,Country of My Skull,2004,in_my_country,4.8,81,18,63,22,5.1,28,6,22,21,3.3,748,59,http://content9.flixster.com/movie/27/20/272023_det.jpg
27735,Unstoppable,2004,,\N,\N,\N,\N,\N,\N,\N,\N,\N,\N,\N,\N,\N,\N
27736,Te doy mis ojos,2003,te_doy_mis_ojos,7.6,33,30,3,90,7.2,11,9,2,81,3.6,1070,78,http://content9.flixster.com/movie/11/12/75/11127523_det.jpg
27741,Tasogare Seibei,2002,twilight_samurai,8.2,68,67,1,98,7.9,22,22,0,100,4.2,3512,93,http://content9.flixster.com/movie/10/92/29/10922967_det.jpg
27744,La finestra di fronte,2003,facing_windows,6.1,65,41,24,63,6.2,27,19,8,70,4,1928,85,http://content9.flixster.com/movie/27/16/271619_det.jpg
27746,Ginger Snaps: Unleashed,2004,ginger_snaps_2_unleashed,6.9,15,14,1,93,0,3,3,0,100,3.2,5388,65,http://content8.flixster.com/movie/26/86/268602_det.jpg
27765,Trauma,2004,10003310-trauma,4.7,15,5,10,33,0,2,0,2,0,2.6,731,28,http://content9.flixster.com/movie/28/02/280291_det.jpg
27768,Confidences trop intimes,2004,1132500-intimate_strangers,7.3,100,87,13,87,7.2,32,27,5,84,3.4,696,65,http://content6.flixster.com/movie/95/02/25/9502252_det.jpg
27772,Ju-on,2002,,0,0,0,0,0,0,0,0,0,0,0,0,0,http://content7.flixster.com/movie/10/89/10/10891029_det.jpg
27773,Oldeuboi,2003,oldboy,7.3,127,102,25,80,7.1,30,24,6,80,4.3,41925,94,http://content8.flixster.com/movie/46/00/460042_det.jpg
27776,Feux rouges,2004,red_lights,7.2,85,71,14,83,7.4,31,26,5,83,3.4,433,64,http://content6.flixster.com/movie/10/84/30/10843036_det.jpg
27778,Ginger Snaps Back: The Beginning,2004,ginger_snaps_back,0,4,3,1,75,0,0,0,0,0,0,0,0,http://content7.flixster.com/movie/10/87/99/10879953_det.jpg
27783,El abrazo partido,2004,lost_embrace,6.7,47,39,8,82,7.3,17,15,2,88,3.7,516,72,http://content9.flixster.com/movie/10/94/29/10942907_det.jpg
27788,The Jacket,2005,jacket,5.4,157,68,89,43,5.1,32,11,21,34,3.5,22896,72,http://content7.flixster.com/movie/51/82/35/5182353_det.jpg
27790,20 Million Miles to Earth,1957,20_million_miles_to_earth,6.4,8,7,1,87,0,0,0,0,0,0,0,0,http://content8.flixster.com/movie/29/61/296118_det.jpg
27792,The Saddest Music in the World,2003,saddest_music_in_the_world,7.1,99,77,22,77,6.9,27,20,7,74,3.7,1821,77,http://content6.flixster.com/movie/11/15/29/11152912_det.jpg
27797,O Homem Que Copiava,2003,man_who_copied,6.2,32,21,11,65,5.4,12,5,7,41,3.9,896,83,http://content6.flixster.com/movie/27/56/275616_det.jpg
27801,Ong-bak,2003,ongbak,6.9,102,87,15,85,6.5,25,19,6,76,3.8,16639,85,http://content8.flixster.com/movie/26/69/266994_det.jpg
27803,Mar adentro,2004,sea_inside,7.6,128,107,21,83,7.5,36,29,7,80,4.1,10334,92,http://content7.flixster.com/movie/62/05/50/6205505_det.jpg
27808,Spanglish,2004,spanglish,5.9,162,85,77,52,5.8,40,21,19,52,3,21732,62,http://content8.flixster.com/movie/55/36/27/5536274_det.jpg
27812,Festival Express,2003,festival_express,7.6,76,73,3,96,7.7,28,28,0,100,3.8,857,79,http://content9.flixster.com/movie/10/94/81/10948187_det.png
27815,Les choristes,2004,chorus_les_choristes,6.5,105,71,34,67,6.3,29,18,11,62,4.1,8414,92,http://content9.flixster.com/movie/10/61/21/10612171_det.jpg
27816,Saints and Soldiers,2003,saints_and_soldiers,6.4,33,21,12,63,5.9,13,8,5,61,3.9,4284,81,http://content6.flixster.com/movie/10/91/48/10914844_det.jpg
27820,Die Geschichte vom weinenden Kamel,2003,story_of_the_weeping_camel,7.6,102,96,6,94,7.6,29,28,1,96,4,1514,84,http://content8.flixster.com/movie/98/45/27/9845278_det.jpg
27821,The Interpreter,2005,interpreter,6,189,109,80,57,6.2,40,25,15,62,3.1,14657,56,http://content7.flixster.com/movie/24/97/249725_det.jpg
27822,Open Water,2003,open_water,6.6,189,136,53,71,7.1,38,30,8,78,2.4,8148,31,http://content7.flixster.com/movie/27/37/273721_det.jpg
27826,Touch of Pink,2004,touch_of_pink,5,61,22,39,36,5,20,8,12,40,3.4,1401,63,http://content7.flixster.com/movie/10/88/36/10883617_det.jpg
27828,De zaak Alzheimer,2003,memory_of_a_killer,6.8,67,56,11,83,6.9,22,19,3,86,3.7,1053,77,http://content9.flixster.com/movie/25/00/250091_det.jpg
27830,Bobby Jones: Stroke of Genius,2004,bobby_jones_stroke_of_genius,4.6,74,19,55,25,4.3,28,8,20,28,3.4,708,63,http://content9.flixster.com/movie/10/85/36/10853615_det.jpg
27831,Layer Cake,2004,layer_cake,7.1,133,108,25,81,7.4,31,26,5,83,3.7,37167,83,http://content6.flixster.com/movie/55/28/552840_det.jpg
27833,Silver City,2004,,\N,\N,\N,\N,\N,\N,\N,\N,\N,\N,\N,\N,\N,\N
27834,Vozvrashchenie,2003,the-return-2003,0,0,0,0,0,0,0,0,0,0,0,0,0,http://content7.flixster.com/movie/10/89/10/10891069_det.jpg
27837,Flight of the Phoenix,2004,flight_of_the_phoenix,4.8,115,34,81,29,4.4,27,5,22,18,3,7566,48,http://content7.flixster.com/movie/10/87/00/10870025_det.jpg
27838,Mean Creek,2004,mean_creek,7.3,117,105,12,89,7.5,35,32,3,91,3.6,5554,79,http://content6.flixster.com/movie/10/86/99/10869964_det.jpg
27839,The Ring Two,2005,ring_two,4.4,178,36,142,20,4.7,37,10,27,27,2.8,39779,54,http://content9.flixster.com/movie/10/86/94/10869455_det.jpg
27841,The Visual Bible: The Gospel of John,2003,gospel_of_john,5,50,18,32,36,4.9,16,4,12,25,4.3,425,88,http://content9.flixster.com/movie/10/93/61/10936175_det.jpg
27843,Machuca,2004,machuca,7.5,37,33,4,89,7.7,11,10,1,90,4.1,1842,90,http://content7.flixster.com/movie/12/81/48/1281485_det.jpg
27846,The Corporation,2003,corporation,7.4,107,97,10,90,7.6,30,28,2,93,4,5815,89,http://content7.flixster.com/movie/10/93/78/10937865_det.jpg
27850,The Yes Men,2003,yes_men,7,82,70,12,85,6.8,28,22,6,78,3.4,1444,65,http://content6.flixster.com/movie/26/90/269092_det.jpg
27851,Ae Fond Kiss...,2004,1140811-fond_kiss,7.4,24,21,3,87,0,4,4,0,100,3.7,1269,73,http://content6.flixster.com/movie/10/87/10/10871048_det.jpg
27857,S√• som i himmelen,2004,saa_som_i_himmelen,6.7,6,5,1,83,0,2,2,0,100,4.3,3319,90,http://content6.flixster.com/movie/10/88/35/10883504_det.jpg
27864,She Hate Me,2004,she_hate_me,3.9,99,19,80,19,3.8,36,7,29,19,3.3,1915,61,http://content8.flixster.com/movie/26/98/269898_det.jpg
27865,Azumi,2003,azumi2003,5.4,32,15,17,46,4.5,11,3,8,27,3.9,4714,82,http://content8.flixster.com/movie/31/40/314014_det.jpg
27866,In My Father's Den,2004,in_my_fathers_den,7.3,9,9,0,100,0,1,1,0,100,4.1,1184,90,http://content9.flixster.com/movie/23/79/87/2379875_det.jpg
27869,Taegukgi hwinalrimyeo,2004,taegukgi_the_brotherhood_of_war,6.7,41,33,8,80,6.6,17,14,3,82,4.2,5475,91,http://content7.flixster.com/movie/10/93/75/10937581_det.jpg
27873,Metallica: Some Kind of Monster,2004,metallica_some_kind_of_monster,7.6,121,107,14,88,7.5,32,30,2,93,3.7,5021,83,http://content6.flixster.com/movie/26/84/268408_det.jpg
27874,Going the Distance,2004,10004352-going_the_distance,2.8,5,0,5,0,0,2,0,2,0,3.3,5047,61,http://content8.flixster.com/movie/35/58/53/3558534_det.jpg
27875,Redemption: The Stan Tookie Williams Story,2004,redemption,0,0,0,0,0,0,0,0,0,0,0,0,0,http://content9.flixster.com/movie/29/18/291815_det.jpg
27876,Schultze Gets the Blues,2003,schultze_gets_the_blues,6.8,63,45,18,71,7,20,14,6,70,3.5,678,71,http://content9.flixster.com/movie/10/86/74/10867451_det.jpg
27878,Born Into Brothels: Calcutta's Red Light Kids,2004,born_into_brothels,7.9,105,101,4,96,7.9,29,27,2,93,4.2,4144,91,http://content8.flixster.com/movie/10/93/23/10932362_det.jpg
27879,Dig!,2004,dig,7.8,69,62,7,89,7.9,21,19,2,90,4.1,2189,89,http://content7.flixster.com/movie/26/82/268293_det.jpg
27882,Riding Giants,2004,riding_giants,7.5,94,87,7,92,7.5,29,28,1,96,4.1,1482,93,http://content7.flixster.com/movie/10/92/20/10922009_det.jpg
27884,Word Wars,2004,word_wars,7.1,35,31,4,88,6.9,16,13,3,81,3.5,889,66,http://content7.flixster.com/movie/10/87/33/10873337_det.jpg
27888,When Will I Be Loved,2004,when_will_i_be_loved,4.6,71,23,48,32,4.3,27,7,20,25,2.6,695,31,http://content8.flixster.com/movie/10/88/65/10886538_det.jpg
27899,What the #$*! Do We (K)now!?,2004,what_the__do_we_know,4.6,75,25,50,33,4.7,24,10,14,41,3.5,5742,69,http://content6.flixster.com/movie/10/91/67/10916748_det.jpg
27904,A Scanner Darkly,2006,scanner_darkly,6.6,174,119,55,68,6.7,37,23,14,62,3.4,46764,70,http://content8.flixster.com/movie/10/89/84/10898442_det.jpg
27905,Casshern,2004,10004734-casshern,6,9,6,3,66,0,0,0,0,0,0,0,0,http://content8.flixster.com/movie/12/87/49/1287490_det.png
27912,Outfoxed: Rupert Murdoch's War on Journalism,2004,outfoxed,6.9,59,50,9,84,6.9,18,16,2,88,3.7,1346,76,http://content8.flixster.com/movie/11/13/19/11131926_det.jpg
30659,Noel,2004,noel,4.3,34,9,25,26,3.1,12,0,12,0,3.3,1805,55,http://content7.flixster.com/movie/25/54/255421_det.jpg
30701,Campanadas a medianoche,1965,1209327-chimes_at_midnight,8,12,11,1,91,0,4,3,1,75,4.3,774,90,http://content7.flixster.com/movie/10/91/93/10919385_det.jpg
30707,Million Dollar Baby,2004,million_dollar_baby,8.3,224,204,20,91,8.6,40,38,2,95,3.8,64852,87,http://content6.flixster.com/movie/10/93/45/10934568_det.jpg
30712,The Narrow Margin,1952,10004890-narrow_margin,8.3,7,7,0,100,0,0,0,0,0,0,0,0,http://content6.flixster.com/movie/10/84/97/10849716_det.jpg
30721,Hell Is for Heroes,1962,hell_is_for_heroes,6.5,6,5,1,83,0,0,0,0,0,0,0,0,http://content8.flixster.com/movie/29/80/298030_det.jpg
30745,Gokud√¥ ky√¥fu dai-gekij√¥: Gozu,2003,gozu,6.2,53,38,15,71,6,14,11,3,78,3.9,2732,81,http://content8.flixster.com/movie/12/87/67/1287678_det.jpg
30747,Bu san,2003,goodbye-dragon-inn,7.5,33,27,6,81,7.5,11,10,1,90,3.6,632,70,http://content9.flixster.com/movie/30/07/300711_det.jpg
30749,Hotel Rwanda,2004,hotel_rwanda,7.9,188,170,18,90,7.7,37,32,5,86,4,52962,94,http://content6.flixster.com/movie/55/36/51/5536516_det.jpg
30783,Sei donne per l'assassino,1964,sei-donne-per-lassassino-blood-and-black-lace-six-women-for-the-murderer,7.6,9,7,2,77,0,0,0,0,0,0,0,0,http://content9.flixster.com/movie/10/93/42/10934247_det.jpg
30793,Charlie and the Chocolate Factory,2005,fly-thought-on-golden-wings,0,0,0,0,0,0,0,0,0,0,0,0,0,http://content8.flixster.com/movie/10/84/54/10845470_det.jpg
30803,Bin-jip,2004,3-iron,7.3,87,75,12,86,7.2,24,19,5,79,4.3,7442,93,http://content6.flixster.com/movie/10/92/26/10922620_det.jpg
30810,The Life Aquatic with Steve Zissou,2004,yves-st-laurent-his-life-and-times,6.3,14,10,4,71,5.9,9,6,3,66,3.8,65,81,http://content6.flixster.com/movie/10/91/53/10915336_det.jpg
30812,The Aviator,2004,aviator,7.8,212,185,27,87,7.5,44,36,8,81,3.4,27084,73,http://content7.flixster.com/movie/10/93/85/10938553_det.jpg
30816,The Phantom of the Opera,2004,phantom_of_the_opera,5,165,54,111,32,4.6,37,10,27,27,3.7,70849,86,http://content9.flixster.com/movie/35/84/18/3584187_det.jpg
30818,Beyond the Sea,2004,beyond_the_sea,5.2,150,63,87,42,5.1,34,14,20,41,3.3,3905,64,http://content8.flixster.com/movie/25/43/254306_det.jpg
30820,The Woodsman,2004,woodsman,7.3,129,112,17,86,7.5,34,31,3,91,3.5,4219,74,http://content9.flixster.com/movie/26/87/268719_det.jpg
30822,In Good Company,2004,in_good_company,7.1,160,134,26,83,6.9,37,28,9,75,3,9983,51,http://content8.flixster.com/movie/63/98/51/6398518_det.jpg
30825,Meet the Fockers,2004,meet_the_fockers,5.2,157,60,97,38,5.1,38,15,23,39,3.5,187397,63,http://content6.flixster.com/movie/10/86/10/10861012_det.jpg
30846,The Assassination of Richard Nixon,2004,assassination_of_richard_nixon,6.6,130,87,43,66,6.3,31,16,15,51,3.4,3593,67,http://content7.flixster.com/movie/10/18/54/10185417_det.jpg
30848,A Love Song for Bobby Long,2004,love_song_for_bobby_long,5.5,98,42,56,42,5.3,27,12,15,44,3.7,5803,80,http://content6.flixster.com/movie/26/84/268412_det.jpg
30850,The Merchant of Venice,2004,merchant_of_venice,6.7,123,88,35,71,6.8,35,24,11,68,3.5,4764,72,http://content7.flixster.com/movie/10/94/27/10942789_det.jpg
30883,Fat Albert,2004,fat_albert,4.4,81,18,63,22,4.4,30,7,23,23,2.7,6431,53,http://content6.flixster.com/movie/25/52/255216_det.jpg
30890,Le chiavi di casa,2004,chiavi_di_casa,6.9,25,20,5,80,7.4,7,6,1,85,3.7,367,75,http://content9.flixster.com/movie/29/92/299219_det.jpg
30892,In the Realms of the Unreal,2004,in_the_realms_of_the_unreal,6.8,61,43,18,70,7,19,15,4,78,3.8,1043,77,http://content9.flixster.com/movie/10/87/10/10871095_det.jpg
30894,White Noise,2005,white_noise,3.5,146,13,133,8,3.5,33,3,30,9,2.7,14878,44,http://content9.flixster.com/movie/11/15/30/11153027_det.jpg
30896,Underclassman,2005,underclassman,2.8,79,5,74,6,2.8,25,1,24,4,2.7,3200,44,http://content9.flixster.com/movie/25/00/250099_det.jpg
30898,The Upside of Anger,2005,upside_of_anger,6.8,168,125,43,74,6.5,34,23,11,67,3.2,4962,60,http://content6.flixster.com/movie/10/83/85/10838504_det.jpg
30942,Arrowhead,1953,arrowhead,0,1,0,1,0,0,0,0,0,0,0,0,0,http://content7.flixster.com/movie/30/32/303213_det.jpg
30949,The Grateful Dead,1977,the-grateful-dead,0,0,0,0,0,0,0,0,0,0,0,0,0,http://content6.flixster.com/movie/10/83/90/10839040_det.jpg
30952,Last Train from Gun Hill,1959,last_train_from_gun_hill,0,4,3,1,75,0,0,0,0,0,0,0,0,http://content6.flixster.com/movie/10/85/80/10858068_det.jpg
30954,The Naked Jungle,1954,naked_jungle,7,6,5,1,83,0,0,0,0,0,0,0,0,http://content8.flixster.com/movie/10/20/45/10204522_det.jpg
30970,A Handful of Dust,1988,handful_of_dust,0,3,2,1,66,0,1,1,0,100,3,754,41,http://content9.flixster.com/movie/10/90/51/10905103_det.jpg
30977,The Pickle,1993,pickle,4.5,5,1,4,20,0,2,1,1,50,2.4,58,19,http://content6.flixster.com/movie/10/84/82/10848288_det.jpg
30981,Wetherby,1985,wetherby,7.6,5,4,1,80,0,1,1,0,100,3.1,194,43,http://content6.flixster.com/movie/27/64/276496_det.jpg
30991,Powwow Highway,1989,powwow_highway,7.2,9,9,0,100,0,1,1,0,100,4,600,87,http://content9.flixster.com/movie/10/89/41/10894195_det.jpg
30994,Little Miss Marker,1934,,\N,\N,\N,\N,\N,\N,\N,\N,\N,\N,\N,\N,\N,\N
30996,Little Miss Marker,1934,,\N,\N,\N,\N,\N,\N,\N,\N,\N,\N,\N,\N,\N,\N
31000,Sweet Liberty,1986,sweet_liberty,5.7,12,9,3,75,0,1,0,1,0,3,337,34,http://content9.flixster.com/movie/10/89/17/10891711_det.jpg
31004,La vie promise,2002,vie_promise,5.6,22,10,12,45,5.2,10,4,6,40,3.2,202,48,http://content6.flixster.com/movie/11/01/72/11017208_det.jpg
31011,It's All True,1993,its_all_true,7,20,16,4,80,6.4,5,4,1,80,3.2,261,56,http://content9.flixster.com/movie/25/29/252915_det.jpg
31026,The Phantom of the Opera,2004,phantom_of_the_opera,5,165,54,111,32,4.6,37,10,27,27,3.7,70849,86,http://content9.flixster.com/movie/35/84/18/3584187_det.jpg
31030,I Remember Mama,1948,i_remember_mama,7.5,15,14,1,93,0,2,2,0,100,4,582,83,http://content9.flixster.com/movie/92/20/03/9220035_det.jpg
31032,The Last Horror Movie,2003,last_horror_movie,5.9,9,5,4,55,0,0,0,0,0,0,0,0,http://content8.flixster.com/movie/10/87/75/10877522_det.jpg
31035,Testament,1983,testament,7.2,7,6,1,85,0,1,1,0,100,3.7,455,70,http://content6.flixster.com/movie/10/85/37/10853752_det.jpg
31038,Smooth Talk,1985,smooth_talk,6.6,9,7,2,77,0,2,1,1,50,3.1,280,41,http://content9.flixster.com/movie/10/87/07/10870755_det.jpg
31040,Distant Thunder,1988,1005967-distant_thunder,5.2,6,3,3,50,0,1,1,0,100,3.1,151,37,http://content9.flixster.com/movie/74/20/26/7420263_det.jpg
31042,Hell's Angels,1930,hells_angels,7.3,10,9,1,90,0,0,0,0,0,0,0,0,http://content7.flixster.com/movie/10/87/08/10870805_det.jpg
31047,Jinxed!,1982,jinxed,0,1,0,1,0,0,0,0,0,0,0,0,0,http://content9.flixster.com/movie/10/86/60/10866067_det.jpg
31049,Out Cold,2001,out_cold,2.9,48,4,44,8,3,15,1,14,6,3.5,7234,84,http://content7.flixster.com/movie/18/78/38/1878389_det.jpg
31053,Heart of America,2002,1138315-heart_of_america,0,4,1,3,25,0,0,0,0,0,0,0,0,http://content6.flixster.com/movie/43/14/14/4314140_det.jpg
31060,A Show of Force,1990,show_of_force,0,0,0,0,0,0,0,0,0,0,0,0,0,http://content6.flixster.com/movie/10/87/67/10876716_det.jpg
31079,Kaij√ªt√¥ no kessen: Gojira no musuko,1967,,5.1,7,5,2,71,0,0,0,0,0,0,0,0,http://content8.flixster.com/movie/10/87/24/10872498_det.jpg
31083,Man Trouble,1992,man_trouble,3.7,11,2,9,18,0,1,0,1,0,2.6,637,17,http://content8.flixster.com/movie/26/58/265818_det.jpg
31086,Jingi naki tatakai,1973,yakuza_papers_battles_without_honor_and_humanity,6.5,6,3,3,50,0,0,0,0,0,0,0,0,http://content7.flixster.com/movie/10/88/44/10884481_det.jpg
31090,F√ºhrer Ex,2002,fuehrer_ex,0,1,0,1,0,0,0,0,0,0,0,0,0,http://content7.flixster.com/movie/30/82/308209_det.jpg
31101,Stander,2003,stander,6.5,62,45,17,72,6.5,16,12,4,75,3.6,1039,77,http://content9.flixster.com/movie/27/57/275795_det.jpg
31104,Hester Street,1975,hester_street,6.2,6,4,2,66,0,0,0,0,0,0,0,0,http://content9.flixster.com/movie/26/27/262715_det.jpg
31107,Mikey and Nicky,1976,mikey_and_nicky,6.4,11,8,3,72,0,0,0,0,0,0,0,0,http://content9.flixster.com/movie/48/66/25/4866251_det.jpg
31109,The Bigamist,1953,bigamist,0,2,2,0,100,0,0,0,0,0,0,0,0,http://content9.flixster.com/movie/10/19/90/10199019_det.jpg
31112,Libertarias,1996,libertarias_1996,0,0,0,0,0,0,0,0,0,0,0,0,0,http://content9.flixster.com/movie/15/26/31/1526315_det.jpg
31114,Imaginary Heroes,2004,imaginary_heroes,5.2,101,35,66,34,5,30,11,19,36,3.8,3294,80,http://content6.flixster.com/movie/10/90/37/10903752_det.jpg
31116,Sergeant York,1941,sergeant_york,6.9,18,15,3,83,0,2,1,1,50,4,1263,87,http://content8.flixster.com/movie/10/93/42/10934210_det.jpg
31123,Tais-toi!,2003,taistoi,0,1,1,0,100,0,0,0,0,0,0,0,0,http://content7.flixster.com/movie/25/74/36/2574365_det.jpg
31148,Dzien swira,2002,day_of_the_wacko,0,2,2,0,100,0,0,0,0,0,0,0,0,http://content7.flixster.com/movie/31/01/310105_det.jpg
31150,The Wizard,1989,wizard,4.3,17,4,13,23,0,3,0,3,0,3.1,3783,60,http://content6.flixster.com/movie/10/92/08/10920824_det.jpg
31156,Abbott and Costello Meet the Invisible Man,1951,abbott_and_costello_meet_the_invisible_man,5.5,8,6,2,75,0,0,0,0,0,0,0,0,http://content7.flixster.com/movie/10/22/12/10221273_det.jpg
31160,"Abbott and Costello Meet the Killer, Boris Karloff",1949,abbott_and_costello_meet_the_killer,0,0,0,0,0,0,0,0,0,0,0,0,0,http://content7.flixster.com/movie/10/22/12/10221217_det.jpg
31162,The Life and Death of Peter Sellers,2004,1142298-life_and_death_of_peter_sellers,6.2,19,14,5,73,0,3,1,2,33,3.4,2594,69,http://content8.flixster.com/movie/10/90/85/10908566_det.jpg
31184,Appurush√Ædo,2004,1144029-appleseed,4.7,32,8,24,25,4.4,14,2,12,14,3.7,5608,76,http://content7.flixster.com/movie/31/40/314013_det.jpg
31188,La voie lact√©e,1969,1013912-milky_way,7.7,14,13,1,92,0,2,2,0,100,4,669,84,http://content6.flixster.com/movie/10/90/21/10902192_det.jpg
31193,The Many Adventures of Winnie the Pooh,1977,many_adventures_of_winnie_the_pooh,8.1,11,10,1,90,0,1,1,0,100,3.6,3913,81,http://content8.flixster.com/movie/25/08/250806_det.jpg
31221,Elektra,2005,elektra,3.7,150,15,135,10,3.8,33,4,29,12,2.6,26366,47,http://content7.flixster.com/movie/25/43/254397_det.jpg
31223,Racing Stripes,2005,racing_stripes,4.9,98,34,64,34,5.1,25,12,13,48,3,10332,56,http://content6.flixster.com/movie/10/84/02/10840216_det.jpg
31225,Coach Carter,2005,coach_carter,6.1,142,92,50,64,6,35,21,14,60,3.7,56395,85,http://content8.flixster.com/movie/25/50/255014_det.jpg
31247,Sullivan's Travels,1941,sullivans_travels,8.7,29,29,0,100,0,2,2,0,100,4.2,2289,90,http://content7.flixster.com/movie/29/34/293401_det.jpg
31251,Iceman,1984,1010362-iceman,0,1,1,0,100,0,0,0,0,0,0,0,0,http://content7.flixster.com/movie/10/83/91/10839117_det.jpg
31255,Ice Station Zebra,1968,ice_station_zebra,5.3,12,6,6,50,0,1,0,1,0,3.2,1042,53,http://content6.flixster.com/movie/94/51/84/9451840_det.jpg
31260,Boys Town,1938,boys_town,7.1,14,14,0,100,0,0,0,0,0,0,0,0,http://content6.flixster.com/movie/68/78/86/6878868_det.jpg
31263,Torremolinos 73,2003,1155730-torremolinos_73,6.4,40,28,12,70,6.7,20,15,5,75,3.5,502,68,http://content7.flixster.com/movie/12/82/29/1282293_det.jpg
31270,Shivers,1975,1021211-shivers,6.8,19,16,3,84,0,2,1,1,50,3.4,2264,61,http://content9.flixster.com/movie/28/21/282195_det.jpg
31309,Rocco e i suoi fratelli,1960,rocco_and_his_brothers,7.8,17,16,1,94,0,4,3,1,75,4.2,1288,92,http://content8.flixster.com/movie/30/34/303426_det.jpg
31347,Christmas in July,1940,christmas_in_july,7.9,16,15,1,93,0,4,3,1,75,4,244,87,http://content6.flixster.com/movie/97/49/55/9749552_det.jpg
31349,I Married a Witch,1942,i_married_a_witch,7.7,14,14,0,100,0,2,2,0,100,3.7,260,67,http://content8.flixster.com/movie/10/83/82/10838278_det.jpg
31359,Moolaad√©,2004,moolaad,0,0,0,0,0,0,0,0,0,0,0,0,0,http://content9.flixster.com/movie/10/84/28/10842879_det.jpg
31362,This Girl's Life,2003,1139947-this_girls_life,5.6,7,3,4,42,0,1,1,0,100,3.1,508,47,http://content6.flixster.com/movie/31/08/310892_det.jpg
31364,Salinui chueok,2003,memories-of-murder,7.7,34,30,4,88,7.9,9,9,0,100,4.2,3096,93,http://content7.flixster.com/movie/10/92/26/10922621_det.jpg
31367,The Chase,1994,1049183-chase,4.8,16,5,11,31,0,3,0,3,0,2.6,2631,36,http://content6.flixster.com/movie/25/77/257704_det.jpg
31408,Sommersturm,2004,1156285-summer_storm,5.7,30,15,15,50,5.7,13,7,6,53,3.8,1586,80,http://content8.flixster.com/movie/13/23/41/1323414_det.jpg
31410,Der Untergang,2004,joseph-the-man-closest-to-christ2007,0,0,0,0,0,0,0,0,0,0,0,0,0,http://content7.flixster.com/movie/10/84/43/10844313_det.jpg
31420,Assault on Precinct 13,2005,assault_on_precinct_13,5.9,160,96,64,60,6,36,23,13,63,3.1,12635,54,http://content7.flixster.com/movie/26/88/268805_det.jpg
31422,Are We There Yet?,2005,1141102-are_we_there_yet,3.3,113,13,100,11,3.6,32,3,29,9,3.1,29416,62,http://content6.flixster.com/movie/25/47/254708_det.jpg
31424,Alone in the Dark,2005,alone_in_the_dark,1.7,116,1,115,0,1.7,26,0,26,0,2.1,8641,21,http://content6.flixster.com/movie/10/92/96/10929640_det.jpg
31427,Hide and Seek,2005,1141193-hide_and_seek,3.8,153,19,134,12,4.3,35,6,29,17,3.1,22573,60,http://content7.flixster.com/movie/10/88/28/10882841_det.jpg
31429,Aliens of the Deep,2005,aliens_of_the_deep,7,61,51,10,83,7.5,21,18,3,85,3.2,1182,50,http://content9.flixster.com/movie/10/88/21/10882159_det.jpg
31431,Boogeyman,2005,boogeyman,3.4,85,11,74,12,3.2,11,0,11,0,2.5,13866,38,http://content9.flixster.com/movie/97/10/26/9710267_det.jpg
31433,The Wedding Date,2005,wedding_date,3.8,136,14,122,10,3.9,31,3,28,9,3.2,34530,68,http://content9.flixster.com/movie/10/89/24/10892423_det.jpg
31435,Inside I'm Dancing,2004,rory_o_shea_was_here,5.8,69,34,35,49,5.6,21,9,12,42,4.1,2819,89,http://content9.flixster.com/movie/10/85/61/10856115_det.jpg
31437,Dare mo shiranai,2004,nobody_knows,8,91,85,6,93,8.4,28,27,1,96,4.2,3440,92,http://content8.flixster.com/movie/10/92/60/10926066_det.jpg
31445,Employee of the Month,2006,employee_of_the_month,4,88,18,70,20,3.9,25,4,21,16,3.2,54090,61,http://content7.flixster.com/movie/28/18/36/2818365_det.jpg
31447,Magic in the Water,1995,magic_in_the_water,3.6,8,1,7,12,0,2,0,2,0,3.3,642,59,http://content6.flixster.com/movie/26/45/264512_det.jpg
31467,The Great White Hope,1970,great_white_hope,5.5,6,2,4,33,0,3,1,2,33,3.8,213,74,http://content6.flixster.com/movie/63/07/18/6307184_det.jpg
31485,L√©on,1994,professional,6.8,39,30,9,76,5.8,8,4,4,50,4.1,59011,94,http://content7.flixster.com/movie/28/62/286221_det.jpg
31494,Everyday People,2004,1137476-everyday_people,6.3,8,6,2,75,0,4,4,0,100,2.9,87,41,http://content6.flixster.com/movie/10/84/76/10847672_det.jpg
31522,Die Ehe der Maria Braun,1979,the-brd-trilogy-the-marriage-of-maria-braun,8.5,14,13,1,92,0,3,3,0,100,4.1,858,89,http://content8.flixster.com/movie/10/93/75/10937582_det.jpg
31528,Beau Geste,1939,beau_geste,8.1,9,9,0,100,0,0,0,0,0,0,0,0,http://content6.flixster.com/movie/88/41/35/8841352_det.jpg
31545,The Hole,2001,1125456-hole,5.8,15,8,7,53,0,1,0,1,0,3.1,5670,58,http://content7.flixster.com/movie/26/97/269725_det.jpg
31547,Lektionen in Finsternis,1992,lessons-of-darkness,8,9,9,0,100,0,0,0,0,0,0,0,0,http://content6.flixster.com/movie/93/51/53/9351536_det.jpg
31553,Double Dragon,1994,double_dragon,3.2,10,0,10,0,0,3,0,3,0,2.1,3610,29,http://content9.flixster.com/movie/26/40/264095_det.jpg
31555,Mac and Me,1988,mac_and_me,2.4,14,0,14,0,0,2,0,2,0,2.7,2264,43,http://content7.flixster.com/movie/26/08/260893_det.jpg
31577,Scorchers,1991,scorchers,0,0,0,0,0,0,0,0,0,0,0,0,0,http://content6.flixster.com/movie/10/86/83/10868388_det.jpg
31584,Rosenstrasse,2003,rosenstrasse,5.8,61,34,27,55,5.6,25,13,12,52,3.5,359,66,http://content9.flixster.com/movie/10/86/06/10860611_det.jpg
31588,Casque d'or,1952,casque_dor,8.4,11,11,0,100,0,3,3,0,100,3.7,397,76,http://content7.flixster.com/movie/10/86/74/10867413_det.jpg
31590,Touchez pas au grisbi,1954,grisbi,8.3,23,23,0,100,8.8,7,7,0,100,4,630,83,http://content6.flixster.com/movie/10/93/94/10939452_det.jpg
31594,The MatchMaker,1997,1079208-matchmaker,5.6,26,14,12,53,0,4,2,2,50,3.3,1220,66,http://content9.flixster.com/movie/28/03/280315_det.jpg
31598,The Ballad of the Sad Cafe,1991,ballad_of_the_sad_cafe,6.4,5,4,1,80,0,3,2,1,66,3.6,69,64,http://content8.flixster.com/movie/10/83/93/10839302_det.jpg
31600,The Deceivers,1988,deceivers,5.1,5,1,4,20,0,1,0,1,0,3.1,252,50,http://content7.flixster.com/movie/10/92/30/10923005_det.jpg
31610,Zi hudie,2003,purple_butterfly,5.5,20,9,11,45,5.8,8,4,4,50,3.1,578,42,http://content9.flixster.com/movie/27/59/275923_det.jpg
31613,Five Easy Pieces,1970,five_easy_pieces,8.2,30,25,5,83,6.5,5,3,2,60,3.9,4148,85,http://content6.flixster.com/movie/27/03/270308_det.jpg
31617,El Cid,1961,el_cid,6.5,12,11,1,91,0,1,1,0,100,3.6,1234,73,http://content9.flixster.com/movie/61/75/15/6175159_det.jpg
31658,Hauru no ugoku shiro,2004,howls_moving_castle,7.5,148,127,21,85,7.3,36,30,6,83,4.1,56005,93,http://content6.flixster.com/movie/10/93/88/10938808_det.jpg
31660,Such√Æmub√¥i,2004,steamboy,6,87,51,36,58,6.1,28,16,12,57,3.5,4805,70,http://content8.flixster.com/movie/11/15/31/11153138_det.jpg
31682,The Nomi Song,2004,nomi_song,7.2,36,34,2,94,7.3,15,15,0,100,3.8,302,79,http://content8.flixster.com/movie/31/33/313302_det.jpg
31685,Hitch,2005,hitch,6.3,178,122,56,68,6.3,34,21,13,61,3.4,189230,65,http://content7.flixster.com/movie/16/90/56/1690569_det.jpg
31687,Pooh's Heffalump Movie,2005,poohs_heffalump_movie,6.6,84,67,17,79,6.2,23,17,6,73,3.5,2927,71,http://content6.flixster.com/movie/25/08/250808_det.jpg
31689,Deep Throat,1972,,\N,\N,\N,\N,\N,\N,\N,\N,\N,\N,\N,\N,\N,\N
31692,Uncle Nino,2003,1211777-uncle_nino,4.4,33,7,26,21,4.2,13,3,10,23,3.7,109,70,http://content8.flixster.com/movie/89/40/33/8940330_det.jpg
31694,Bride & Prejudice,2004,bride_and_prejudice,6.1,131,84,47,64,6.8,32,26,6,81,3.3,17555,67,http://content8.flixster.com/movie/25/38/253894_det.jpg
31696,Constantine,2005,constantine,5.5,214,98,116,45,4.7,42,10,32,23,3.5,71421,75,http://content6.flixster.com/movie/10/93/34/10933464_det.jpg
31698,Son of the Mask,2005,son_of_the_mask,2.8,101,6,95,5,3.1,25,0,25,0,2.1,4576,32,http://content7.flixster.com/movie/10/88/16/10881685_det.jpg
31700,Because of Winn-Dixie,2005,because_of_winndixie,5.8,118,63,55,53,5.8,31,17,14,54,3.3,6908,70,http://content9.flixster.com/movie/10/87/85/10878563_det.jpg
31702,Lakposhtha parvaz mikonand,2004,turtles_can_fly,7.8,70,62,8,88,7.7,21,19,2,90,4.3,2998,93,http://content7.flixster.com/movie/10/70/23/10702313_det.jpg
31705,Beautiful Boxer,2003,beautiful_boxer,6.7,35,28,7,80,6.7,12,9,3,75,3.9,879,88,http://content6.flixster.com/movie/10/89/35/10893596_det.jpg
31724,Pauly Shore Is Dead,2003,pauly-shore-is-dead,5.7,13,8,5,61,0,1,1,0,100,2.4,2127,28,http://content7.flixster.com/movie/20/53/50/2053509_det.jpg
31737,Bunny Lake Is Missing,1965,bunny_lake_is_missing,6.9,9,8,1,88,0,1,1,0,100,3.7,715,76,http://content6.flixster.com/movie/10/88/57/10885764_det.jpg
31742,Jeremy,1973,jeremy,0,1,1,0,100,0,0,0,0,0,0,0,0,http://content7.flixster.com/movie/10/83/86/10838665_det.jpg
31747,Don't Tell Her It's Me,1990,dont_tell_her_its_me,0,1,1,0,100,0,0,0,0,0,0,0,0,http://content8.flixster.com/movie/10/86/94/10869406_det.jpg
31750,Until September,1984,until_september,3.3,5,0,5,0,0,2,0,2,0,3.5,159,63,http://content8.flixster.com/movie/27/37/273722_det.jpg
31770,Night and the City,1992,1040890-night_and_the_city,5.7,10,6,4,60,0,2,1,1,50,3,376,33,http://content7.flixster.com/movie/83/85/54/8385545_det.jpg
31785,Paha maa,2005,frozen-land-paha-maa,0,0,0,0,0,0,0,0,0,0,0,0,0,http://content7.flixster.com/movie/10/87/00/10870005_det.jpg
31804,Nochnoy dozor,2004,1148279-night_watch,5.9,125,73,52,58,5.9,30,17,13,56,3.3,19774,70,http://content8.flixster.com/movie/22/60/07/2260074_det.jpg
31807,Dot the I,2003,dot_the_i,4.6,59,15,44,25,4.6,23,4,19,17,3.8,2535,78,http://content9.flixster.com/movie/26/91/269107_det.jpg
31854,Road to Morocco,1942,road_to_morocco,7.8,12,11,1,91,0,0,0,0,0,0,0,0,http://content7.flixster.com/movie/10/90/94/10909409_det.jpg
31867,Man of the House,2005,man_of_the_house,3.3,60,5,55,8,3.9,16,4,12,25,3.1,10877,59,http://content9.flixster.com/movie/10/91/27/10912719_det.jpg
31878,Kung fu,2004,kung_fu_hustle,7.6,172,154,18,89,7.4,39,33,6,84,3.6,37633,86,http://content6.flixster.com/movie/10/88/90/10889084_det.jpg
31900,Travellers and Magicians,2003,,\N,\N,\N,\N,\N,\N,\N,\N,\N,\N,\N,\N,\N,\N
31903,Zelary,2003,1139436-zelary,6.7,51,37,14,72,6.6,15,11,4,73,4.1,638,89,http://content6.flixster.com/movie/10/88/45/10884576_det.jpg
31909,Dr. Giggles,1992,dr_giggles,3.9,14,3,11,21,0,0,0,0,0,0,0,0,http://content8.flixster.com/movie/28/12/281214_det.jpg
31923,The Three Musketeers,1993,1046772-three_musketeers,4.8,24,7,17,29,0,3,0,3,0,3.2,13783,67,http://content7.flixster.com/movie/50/26/53/5026533_det.jpg
31930,Masculin f√©minin: 15 faits pr√©cis,1966,,\N,\N,\N,\N,\N,\N,\N,\N,\N,\N,\N,\N,\N,\N
31934,The Four Feathers,2002,four_feathers,5.4,149,61,88,40,5.6,32,13,19,40,3.2,6869,65,http://content8.flixster.com/movie/10/83/86/10838682_det.jpg
31950,Night of the Demon,1957,curse_of_the_demon,8,10,10,0,100,0,0,0,0,0,0,0,0,http://content9.flixster.com/movie/10/91/73/10917319_det.jpg
31952,Kontroll,2003,kontroll,7,64,52,12,81,6.6,18,13,5,72,4,2770,88,http://content7.flixster.com/movie/27/27/272721_det.jpg
31956,5x2,2004,5x2,6.2,68,44,24,64,6,20,12,8,60,3.6,1684,69,http://content6.flixster.com/movie/25/74/42/2574420_det.jpg
31973,Germania anno zero,1948,germania-anno-zero-germany-year-zero,9.2,9,9,0,100,0,0,0,0,0,0,0,0,http://content7.flixster.com/movie/30/10/301013_det.jpg
31998,Ett h√•l i mitt hj√§rta,2004,hole_in_my_heart,4,17,7,10,41,3.6,8,2,6,25,2.8,704,39,http://content9.flixster.com/movie/32/03/14/3203147_det.jpg
32002,Bigger Than the Sky,2005,bigger_than_the_sky,3.6,16,2,14,12,3.2,9,0,9,0,3.1,458,51,http://content6.flixster.com/movie/26/40/264092_det.jpg
32009,Diary of a Mad Black Woman,2005,diary_of_a_mad_black_woman,3.9,108,17,91,15,4.4,30,8,22,26,4,28144,89,http://content6.flixster.com/movie/10/88/08/10880856_det.jpg
32011,Cursed,2005,you-must-kill,0,0,0,0,0,0,0,0,0,0,0,0,0,http://content7.flixster.com/movie/10/84/78/10847865_det.jpg
32013,In the Loop,2009,in_the_loop,7.8,158,148,10,93,7.7,29,27,2,93,2.9,31450,76,http://content6.flixster.com/movie/10/89/39/10893980_det.jpg
32017,The Pacifier,2005,pacifier,3.7,127,26,101,20,3.4,32,5,27,15,3.2,48314,70,http://content6.flixster.com/movie/24/97/249744_det.jpg
32019,Be Cool,2005,be_cool,4.6,168,50,118,29,4.2,38,6,32,15,2.8,15817,48,http://content8.flixster.com/movie/55/35/66/5535662_det.jpg
32022,Gunner Palace,2004,gunner_palace,7,102,86,16,84,7.2,32,27,5,84,3.4,649,63,http://content9.flixster.com/movie/25/53/255315_det.jpg
32025,Walk on Water,2004,walk_on_water,6.5,74,53,21,71,6.1,23,15,8,65,4,1438,86,http://content6.flixster.com/movie/28/59/285904_det.jpg
32029,Hostage,2005,1141099-hostage,5,154,54,100,35,4.3,36,6,30,16,3.3,22771,69,http://content9.flixster.com/movie/10/86/50/10865031_det.jpg
32031,"I, Robot",2004,domain-of-murder,0,0,0,0,0,0,0,0,0,0,0,0,0,http://content9.flixster.com/movie/10/84/80/10848035_det.jpg
32049,The Laughing Policeman,1973,laughing_policeman,5.9,5,4,1,80,0,1,1,0,100,3.1,219,43,http://content9.flixster.com/movie/27/23/272399_det.jpg
32058,Class Action,1991,1034008-class_action,6.1,23,17,6,73,0,4,4,0,100,3,742,45,http://content7.flixster.com/movie/27/31/273101_det.jpg
32060,The Cat and the Canary,1927,1003747-cat_and_the_canary,6.9,6,5,1,83,0,0,0,0,0,0,0,0,http://content6.flixster.com/movie/31/11/311196_det.jpg
32062,Courage Mountain,1990,courage_mountain,0,0,0,0,0,0,0,0,0,0,0,0,0,http://content8.flixster.com/movie/20/99/51/2099514_det.jpg
32074,Kiss the Bride,2002,kiss-the-bride,5.4,6,2,4,33,0,0,0,0,0,0,0,0,http://content9.flixster.com/movie/10/88/16/10881615_det.jpg
32076,"Gojira, Ebir√¢, Mosura: Nankai no daiketto",1966,godzilla_vs_the_sea_monster,0,2,1,1,50,0,0,0,0,0,0,0,0,http://content8.flixster.com/movie/55/84/23/5584238_det.jpg
32078,Gojira VS Mekagojira,1993,godzilla-vs-mechagodzilla-ii,0,2,2,0,100,0,0,0,0,0,0,0,0,http://content8.flixster.com/movie/10/89/01/10890178_det.jpg
32082,That Championship Season,1982,1021128-that_championship_season,6.2,5,3,2,60,0,0,0,0,0,0,0,0,http://content9.flixster.com/movie/10/86/46/10864667_det.jpg
32084,Crush,2001,,\N,\N,\N,\N,\N,\N,\N,\N,\N,\N,\N,\N,\N,\N
32088,DNA,1997,1077310-dna,0,1,0,1,0,0,0,0,0,0,0,0,0,http://content9.flixster.com/movie/63/38/17/6338171_det.jpg
32090,The Riches,2007,,\N,\N,\N,\N,\N,\N,\N,\N,\N,\N,\N,\N,\N,\N
32109,Les triplettes de Belleville,2003,acid-drinkers-15-screwed-years2004,0,0,0,0,0,0,0,0,0,0,0,0,0,http://content8.flixster.com/movie/10/85/10/10851046_det.jpg
32116,"Oh, God! You Devil",1984,oh_god_you_devil,5.1,7,2,5,28,0,0,0,0,0,0,0,0,http://content7.flixster.com/movie/10/78/71/10787105_det.jpg
32120,A Killer Among Friends,1992,,\N,\N,\N,\N,\N,\N,\N,\N,\N,\N,\N,\N,\N,\N
32124,Deus √â Brasileiro,2003,deus-e-brasileiro-god-is-brazilian,0,0,0,0,0,0,0,0,0,0,0,0,0,http://content8.flixster.com/movie/10/85/80/10858014_det.jpg
32128,Blackball,2003,blackball,4.8,13,5,8,38,0,0,0,0,0,0,0,0,http://content7.flixster.com/movie/27/93/279317_det.jpg
32139,The Agony and the Ecstasy,1965,agony_and_the_ecstasy,7,5,5,0,100,0,0,0,0,0,0,0,0,http://content7.flixster.com/movie/10/85/76/10857657_det.jpg
32141,Return to Peyton Place,1961,return_to_peyton_place,0,1,0,1,0,0,0,0,0,0,0,0,0,http://content8.flixster.com/movie/11/14/20/11142070_det.jpg
32149,Butch and Sundance: The Early Days,1979,butch-and-sundance-the-early-days,0,0,0,0,0,0,0,0,0,0,0,0,0,http://content7.flixster.com/movie/10/93/10/10931057_det.jpg
32151,It Happened to Jane,1959,it_happened_to_jane,0,2,0,2,0,0,0,0,0,0,0,0,0,http://content8.flixster.com/movie/10/90/04/10900486_det.jpg
32153,Once Upon a Forest,1993,once_upon_a_forest,4.4,5,0,5,0,0,2,0,2,0,3.3,913,67,http://content9.flixster.com/movie/25/24/252415_det.jpg
32156,Hello Down There,1969,hello_down_there,0,2,2,0,100,0,0,0,0,0,0,0,0,http://content6.flixster.com/movie/25/17/251708_det.jpg
32158,All in a Night's Work,1961,all_in_a_nights_work,0,0,0,0,0,0,0,0,0,0,0,0,0,http://content8.flixster.com/movie/10/88/17/10881718_det.jpg
32160,Twentieth Century,1934,twentieth_century,7.7,24,21,3,87,0,2,2,0,100,3.7,487,74,http://content9.flixster.com/movie/29/35/293599_det.jpg
32162,My Sister Eileen,1942,10008742-my_sister_eileen,6.6,5,4,1,80,0,1,1,0,100,3.7,99,73,http://content7.flixster.com/movie/11/15/20/11152089_det.jpg
32166,Strangers When We Meet,1960,strangers_when_we_meet,0,4,3,1,75,0,0,0,0,0,0,0,0,http://content8.flixster.com/movie/29/54/295406_det.jpg
32170,The Chronicles of Narnia: Prince Caspian,2008,chronicles_of_narnia_prince_caspian,6.3,179,120,59,67,6.2,37,23,14,62,3.8,154104,78,http://content6.flixster.com/movie/11/12/92/11129292_det.jpg
32174,The Green Berets,1968,1008931-green_berets,3.5,8,2,6,25,0,0,0,0,0,0,0,0,http://content7.flixster.com/movie/25/16/251625_det.jpg
32179,Ascenseur pour l'√©chafaud,1958,elevator_to_the_gallows,8,41,38,3,92,8.1,14,13,1,92,4.2,1819,91,http://content7.flixster.com/movie/21/88/81/2188813_det.jpg
32211,Thriller - en grym film,1974,thriller_a_cruel_picture,4.3,5,2,3,40,0,1,0,1,0,3.5,1247,67,http://content7.flixster.com/movie/10/89/13/10891389_det.jpg
32213,Cube Zero,2004,1139738-cube_zero,0,3,3,0,100,0,0,0,0,0,0,0,0,http://content9.flixster.com/movie/27/08/270891_det.jpg
32234,Being Julia,2004,being_julia,6.7,123,94,29,76,6.5,35,24,11,68,3.5,1947,71,http://content8.flixster.com/movie/10/84/02/10840218_det.jpg
32239,Jigureul jikyeora!,2003,10004650-save_the_green_planet,7.3,38,33,5,86,7.4,12,11,1,91,4,1746,86,http://content7.flixster.com/movie/29/85/298505_det.jpg
32261,Thirty Seconds Over Tokyo,1944,thirty_seconds_over_tokyo,0,4,4,0,100,0,0,0,0,0,0,0,0,http://content9.flixster.com/movie/89/13/28/8913283_det.jpg
32285,The Boys from County Clare,2003,boys_and_girl_from_county_clare,5.9,28,13,15,46,5.8,11,4,7,36,3.4,443,67,http://content7.flixster.com/movie/10/90/11/10901121_det.jpg
32289,Ice Princess,2005,ice_princess,5.6,102,53,49,51,5.4,29,14,15,48,3.1,33981,66,http://content9.flixster.com/movie/25/09/250907_det.jpg
32291,Melinda and Melinda,2004,melinda_and_melinda,5.8,154,82,72,53,6,39,22,17,56,3.1,2565,45,http://content7.flixster.com/movie/10/92/26/10922673_det.jpg
32294,Milk and Honey,2003,,\N,\N,\N,\N,\N,\N,\N,\N,\N,\N,\N,\N,\N,\N
32296,Miss Congeniality 2: Armed & Fabulous,2005,miss_congeniality_2,4,144,21,123,14,4,33,3,30,9,3,34010,59,http://content9.flixster.com/movie/55/05/36/5505367_det.jpg
32298,Guess Who,2005,guess_who,5.4,148,64,84,43,4.7,36,9,27,25,3.1,27344,59,http://content8.flixster.com/movie/25/39/253994_det.jpg
32300,D.E.B.S.,2004,debs,4.7,58,23,35,39,4.7,21,8,13,38,2.9,4690,52,http://content7.flixster.com/movie/60/49/01/6049013_det.jpg
32302,A League of Ordinary Gentlemen,2004,league_of_ordinary_gentlemen,7.3,34,31,3,91,7.2,14,13,1,92,3.5,155,64,http://content8.flixster.com/movie/10/89/97/10899770_det.jpg
32314,Incident at Loch Ness,2004,incident_at_loch_ness,6.2,47,29,18,61,5.5,16,7,9,43,3.4,894,66,http://content6.flixster.com/movie/26/26/262604_det.jpg
32316,Frozen River,2008,frozen_river,7.3,125,109,16,87,7.9,26,24,2,92,3.2,9338,71,http://content6.flixster.com/movie/10/93/37/10933756_det.jpg
32318,Virginia's Run,2002,,\N,\N,\N,\N,\N,\N,\N,\N,\N,\N,\N,\N,\N,\N
32325,Yanks,1979,yanks,5.9,7,5,2,71,0,0,0,0,0,0,0,0,http://content7.flixster.com/movie/27/44/274409_det.jpg
32329,Paradise Alley,1978,paradise_alley,0,4,1,3,25,0,0,0,0,0,0,0,0,http://content9.flixster.com/movie/26/17/261707_det.jpg
32333,M√°vahl√°tur,2001,seagulls_laughter,6.7,32,27,5,84,7.3,12,11,1,91,3.4,199,64,http://content8.flixster.com/movie/30/13/301318_det.jpg
32335,Caballos salvajes,1995,caballos-salvajes,0,0,0,0,0,0,0,0,0,0,0,0,0,http://content6.flixster.com/movie/10/87/93/10879324_det.jpg
32342,Woman Thou Art Loosed,2004,woman_thou_art_loosed,5.5,56,29,27,51,5.4,23,12,11,52,4,869,86,http://content7.flixster.com/movie/26/86/268605_det.jpg
32345,Arrowsmith,1931,arrowsmith,7.1,6,5,1,83,0,0,0,0,0,0,0,0,http://content9.flixster.com/movie/86/03/56/8603567_det.jpg
32347,Barbary Coast,1935,barbary_coast,7.4,10,10,0,100,0,2,2,0,100,3.1,211,43,http://content8.flixster.com/movie/30/87/308714_det.jpg
32349,Stella Dallas,1937,stella_dallas,6.2,5,4,1,80,0,0,0,0,0,0,0,0,http://content7.flixster.com/movie/29/76/297617_det.jpg
32352,The Princess and the Cobbler,1993,thief_and_the_cobbler,0,4,1,3,25,0,1,0,1,0,3.7,1335,74,http://content8.flixster.com/movie/25/26/252618_det.jpg
32354,B√∂se Zellen,2003,free_radicals,6.4,16,10,6,62,7.1,5,4,1,80,3.2,206,50,http://content6.flixster.com/movie/30/81/308120_det.jpg
32361,Come and Get It,1936,come_and_get_it,7.5,9,8,1,88,0,2,2,0,100,3.1,281,48,http://content6.flixster.com/movie/11/13/86/11138676_det.jpg
32369,Panic in the Streets,1950,panic_in_the_streets,7.3,18,17,1,94,0,2,2,0,100,3.5,554,72,http://content8.flixster.com/movie/10/91/39/10913982_det.jpg
32371,Call Northside 777,1948,call_northside_777,7.2,15,11,4,73,0,1,0,1,0,3.5,657,70,http://content6.flixster.com/movie/10/86/37/10863708_det.jpg
32375,Der junge T√∂rless,1966,young-torless,0,0,0,0,0,0,0,0,0,0,0,0,0,http://content8.flixster.com/movie/30/50/305002_det.jpg
32381,Bells Are Ringing,1960,bells_are_ringing,6.8,8,6,2,75,0,0,0,0,0,0,0,0,http://content9.flixster.com/movie/10/50/23/10502311_det.jpg
32383,Finian's Rainbow,1968,finians_rainbow,5.6,11,6,5,54,0,4,2,2,50,3.3,1023,57,http://content9.flixster.com/movie/72/11/06/7211067_det.jpg
32385,Toolbox Murders,2004,toolbox_murders,5.9,15,7,8,46,0,1,1,0,100,2.8,1770,36,http://content9.flixster.com/movie/10/94/73/10947359_det.jpg
32387,Dai-bosatsu t√¥ge,1966,sword_of_doom,6.9,7,5,2,71,0,0,0,0,0,0,0,0,http://content6.flixster.com/movie/10/92/11/10921144_det.jpg
32389,Profundo carmes√≠,1996,deep-crimson1997,0,0,0,0,0,0,0,0,0,0,0,0,0,http://content9.flixster.com/movie/10/88/85/10888579_det.jpg
32392,800 balas,2002,800_balas,5.8,11,5,6,45,5.6,5,2,3,40,3.2,1505,56,http://content9.flixster.com/movie/30/85/308515_det.jpg
32395,Matango,1963,attack_of_the_mushroom_people,0,3,2,1,66,0,0,0,0,0,0,0,0,http://content9.flixster.com/movie/46/78/99/4678995_det.jpg
32444,U-Carmen e-Khayelitsha,2005,ucarmen-ekhayelitsha,7.4,20,19,1,95,7.8,7,7,0,100,3.2,1204,50,http://content7.flixster.com/movie/33/19/82/3319829_det.jpg
32456,Heisei tanuki gassen pompoko,1994,1148583-pom_poko,7,5,4,1,80,0,0,0,0,0,0,0,0,http://content8.flixster.com/movie/25/76/257602_det.jpg
32460,Knockin' on Heaven's Door,1997,knockin-on-heavens-door,0,0,0,0,0,0,0,0,0,0,0,0,0,http://content9.flixster.com/movie/69/00/38/6900387_det.jpg
32469,We're No Angels,1989,1023286-were_no_angels,5.1,18,9,9,50,0,1,1,0,100,2.9,2176,43,http://content8.flixster.com/movie/26/25/262514_det.jpg
32525,Madame de...,1953,earrings_of_madame_de,8.7,22,22,0,100,7.7,5,5,0,100,4.3,591,94,http://content9.flixster.com/movie/11/12/33/11123351_det.jpg
32582,The Wild Parrots of Telegraph Hill,2003,wild_parrots_of_telegraph_hill,7.7,94,89,5,94,7.7,28,28,0,100,3.9,1161,83,http://content8.flixster.com/movie/31/22/312294_det.jpg
32584,The Ballad of Jack and Rose,2005,ballad_of_jack_and_rose,5.7,110,51,59,46,5.6,34,15,19,44,3.4,2469,64,http://content9.flixster.com/movie/27/35/273591_det.jpg
32587,Sin City,2005,,\N,\N,\N,\N,\N,\N,\N,\N,\N,\N,\N,\N,\N,\N
32589,Beauty Shop,2005,1139289-beauty_shop,5.3,114,43,71,37,5.8,28,14,14,50,3.3,11288,70,http://content9.flixster.com/movie/31/29/312911_det.jpg
32591,Comme une image,2004,look_at_me,7.6,98,85,13,86,8,31,29,2,93,3.5,1003,66,http://content8.flixster.com/movie/10/88/44/10884474_det.jpg
32593,Dust to Glory,2005,dust_to_glory,6.2,68,41,27,60,6,21,12,9,57,4.2,728,86,http://content9.flixster.com/movie/10/50/21/10502183_det.jpg
32596,Sahara,2005,1144274-sahara,5.2,171,66,105,38,5,34,15,19,44,3,24489,61,http://content6.flixster.com/movie/24/97/249732_det.jpg
32598,Fever Pitch,2005,fever_pitch,6.2,172,110,62,63,6,38,19,19,50,3,14004,62,http://content7.flixster.com/movie/24/97/249737_det.jpg
32600,Eros,2004,,\N,\N,\N,\N,\N,\N,\N,\N,\N,\N,\N,\N,\N,\N
32602,Winter Solstice,2004,winter_solstice,6.4,80,48,32,60,6.8,25,18,7,72,3,420,44,http://content6.flixster.com/movie/27/49/274904_det.jpg
32605,Smile,2005,10005057-smile,4,13,2,11,15,3.9,5,1,4,20,3.5,585,69,http://content9.flixster.com/movie/10/87/99/10879935_det.jpg
32617,Sinbad and the Eye of the Tiger,1977,sinbad_and_the_eye_of_the_tiger,6,8,5,3,62,0,0,0,0,0,0,0,0,http://content7.flixster.com/movie/10/93/16/10931669_det.jpg
32620,Pas sur la bouche,2003,not_on_the_lips,7.1,8,6,2,75,0,2,2,0,100,3.1,663,48,http://content7.flixster.com/movie/10/88/74/10887497_det.jpg
32625,Krakatoa: East of Java,1969,krakatoa_east_of_java,3.7,6,0,6,0,0,0,0,0,0,0,0,0,http://content8.flixster.com/movie/10/92/33/10923358_det.jpg
32627,Rhinestone,1984,rhinestone,2.8,9,1,8,11,0,1,0,1,0,2.5,1290,37,http://content9.flixster.com/movie/25/82/258211_det.jpg
32632,Electra Glide in Blue,1973,electra_glide_in_blue,6.2,8,6,2,75,0,0,0,0,0,0,0,0,http://content9.flixster.com/movie/26/07/260791_det.jpg
32646,Bring on the Night,1985,bring-on-the-night,0,0,0,0,0,0,0,0,0,0,0,0,0,http://content9.flixster.com/movie/25/78/257899_det.jpg
32649,Una giornata particolare,1977,special_day,0,2,2,0,100,0,0,0,0,0,0,0,0,http://content9.flixster.com/movie/55/83/49/5583495_det.jpg
32657,L'homme qui plantait des arbres,1988,lhomme-qui-plantait-des-arbres-the-man-who-planted-trees,0,0,0,0,0,0,0,0,0,0,0,0,0,http://content8.flixster.com/movie/52/63/57/5263570_det.jpg
32666,Lady Killers,2003,gold-digger-killer,0,0,0,0,0,0,0,0,0,0,0,0,0,http://content6.flixster.com/movie/10/88/01/10880136_det.jpg
32668,Blind Horizon,2003,blind_horizon,0,4,2,2,50,0,0,0,0,0,0,0,0,http://content8.flixster.com/movie/68/99/30/6899302_det.jpg
32674,Islands in the Stream,1977,1010762-islands_in_the_stream,6.3,5,4,1,80,0,0,0,0,0,0,0,0,http://content7.flixster.com/movie/10/86/05/10860545_det.jpg
32677,Go for Broke!,1951,1008429-go_for_broke,0,4,1,3,25,0,0,0,0,0,0,0,0,http://content6.flixster.com/movie/30/49/304900_det.jpg
32721,Battle of the Bulge,1965,1001806-battle_of_the_bulge,6.7,6,4,2,66,0,0,0,0,0,0,0,0,http://content6.flixster.com/movie/10/94/86/10948672_det.jpg
32743,Ringu 0: B√¢sudei,2000,ringu-0,0,2,1,1,50,0,0,0,0,0,0,0,0,http://content7.flixster.com/movie/31/33/313393_det.jpg
32770,Br√∏dre,2004,1144988-brothers,7.5,71,63,8,88,7.8,24,22,2,91,3.8,1141,84,http://content7.flixster.com/movie/99/57/73/9957733_det.jpg
32781,Hawaii,1966,1009293-hawaii,0,1,0,1,0,0,0,0,0,0,0,0,0,http://content7.flixster.com/movie/10/90/24/10902461_det.jpg
32792,Il deserto rosso,1964,deserto_rosso,8.4,11,11,0,100,0,2,2,0,100,4.1,1182,86,http://content8.flixster.com/movie/10/88/55/10885538_det.jpg
32825,Seksmisja,1984,sexmission,0,0,0,0,0,0,0,0,0,0,0,0,0,http://content6.flixster.com/movie/67/70/87/6770872_det.jpg
32844,Waterloo Bridge,1940,waterloo_bridge,6.4,5,4,1,80,0,1,1,0,100,4,1003,88,http://content8.flixster.com/movie/29/42/14/2942146_det.jpg
32853,Le chagrin et la piti√©,1969,,\N,\N,\N,\N,\N,\N,\N,\N,\N,\N,\N,\N,\N,\N
32862,With Six You Get Eggroll,1968,with_six_you_get_eggroll,0,2,2,0,100,0,0,0,0,0,0,0,0,http://content9.flixster.com/movie/25/08/250891_det.jpg
32875,Jour de f√™te,1949,the-big-day-jour-de-fete,8.2,13,13,0,100,0,1,1,0,100,4,736,83,http://content7.flixster.com/movie/10/87/61/10876133_det.jpg
32882,The Big Store,1941,big_store,5.3,9,6,3,66,0,0,0,0,0,0,0,0,http://content8.flixster.com/movie/10/83/96/10839622_det.jpg
32892,Ivanovo detstvo,1962,my_name_is_ivan,8.6,9,9,0,100,0,1,1,0,100,4.2,1542,93,http://content8.flixster.com/movie/10/92/00/10920078_det.jpg
32954,The Chant of Jimmie Blacksmith,1978,1201493-chant_of_jimmie_blacksmith,0,3,3,0,100,0,0,0,0,0,0,0,0,http://content8.flixster.com/movie/10/87/92/10879218_det.jpg
32966,Let Him Have It,1991,let_him_have_it,7.3,12,11,1,91,0,1,1,0,100,3.9,381,83,http://content6.flixster.com/movie/10/87/99/10879992_det.jpg
32988,Sunshine Cleaning,2008,sunshine_cleaning,6.3,158,112,46,70,6.4,34,26,8,76,3.3,81677,59,http://content8.flixster.com/movie/10/87/75/10877574_det.jpg
33004,The Hitch Hikers Guide to the Galaxy,1981,,\N,\N,\N,\N,\N,\N,\N,\N,\N,\N,\N,\N,\N,\N
33036,The Eiger Sanction,1975,eiger_sanction,6.4,12,9,3,75,0,1,1,0,100,0,0,0,http://content9.flixster.com/movie/26/96/269619_det.jpg
33072,V√©rit√©s et mensonges,1973,f-for-fake,7.3,24,21,3,87,0,3,3,0,100,4.1,1945,89,http://content9.flixster.com/movie/10/91/93/10919383_det.jpg
33085,The Amityville Horror,2005,amityville_horror,4.2,155,37,118,23,3.9,33,7,26,21,3.2,31070,64,http://content8.flixster.com/movie/24/97/249734_det.jpg
33113,Act of Violence,1948,act_of_violence,6.8,10,9,1,90,0,2,2,0,100,3.8,227,78,http://content6.flixster.com/movie/10/92/27/10922720_det.jpg
33124,NaPolA,2004,napola_elite_fur_den_fuhrer,6.5,38,26,12,68,6.6,13,9,4,69,3.9,1085,86,http://content6.flixster.com/movie/10/87/50/10875040_det.jpg
33126,The Frisco Kid,1979,frisco_kid,5.8,14,8,6,57,0,1,0,1,0,3.3,1432,60,http://content7.flixster.com/movie/10/87/90/10879037_det.jpg
33132,State Property 2,2005,state_property_two,3.5,14,2,12,14,4,10,2,8,20,3.9,1114,82,http://content8.flixster.com/movie/27/39/273902_det.jpg
33134,The Year of the Yao,2004,year_of_the_yao,6.2,32,21,11,65,6.1,11,7,4,63,3.6,562,67,http://content8.flixster.com/movie/10/88/66/10886674_det.jpg
33136,House of D,2004,house_of_d,3.8,101,10,91,9,3.6,29,2,27,6,3.6,2769,74,http://content6.flixster.com/movie/19/84/57/1984572_det.jpg
33138,Palindromes,2004,palindromes,5.3,113,47,66,41,5.7,34,16,18,47,3.5,3088,70,http://content6.flixster.com/movie/29/23/292304_det.jpg
33145,A Lot Like Love,2005,lot_like_love,4.9,123,50,73,40,5,33,12,21,36,3.5,20461,76,http://content9.flixster.com/movie/10/83/95/10839567_det.jpg
33148,King's Ransom,2005,kings_ransom,2.4,50,1,49,2,2.2,14,0,14,0,2.7,933,37,http://content6.flixster.com/movie/10/91/77/10917780_det.jpg
33150,The Game of Their Lives,2005,miracle_match,0,0,0,0,0,0,0,0,0,0,0,0,0,http://content9.flixster.com/movie/10/91/95/10919539_det.jpg
33152,The Bridges of Madison County,1995,bridges_of_madison_county,7.2,40,36,4,90,7.9,9,9,0,100,3.6,11573,83,http://content6.flixster.com/movie/10/92/73/10927328_det.jpg
33154,Enron: The Smartest Guys in the Room,2005,,\N,\N,\N,\N,\N,\N,\N,\N,\N,\N,\N,\N,\N,\N
33158,xXx: State of the Union,2005,xxx2_state_of_the_union,3.8,135,22,113,16,3.9,31,4,27,12,2.9,20840,53,http://content8.flixster.com/movie/11/15/33/11153374_det.jpg
33162,Kingdom of Heaven,2005,kingdom_of_heaven,5.5,185,72,113,38,5.9,37,19,18,51,3.5,82821,72,http://content7.flixster.com/movie/10/93/34/10933417_det.jpg
33164,House of Wax,2005,house_of_wax,4.3,148,37,111,25,4.5,30,6,24,20,2.8,39495,54,http://content9.flixster.com/movie/10/92/43/10924347_det.jpg
33166,Crash,2004,1144992-crash,7.1,197,148,49,75,7.1,39,30,9,76,4,98746,89,http://content7.flixster.com/movie/24/97/249717_det.jpg
33168,Jiminy Glick in Lalawood,2004,jiminy-glick-in-la-la-wood,4.6,44,10,34,22,4.7,19,4,15,21,2.6,694,31,http://content8.flixster.com/movie/10/92/19/10921938_det.jpg
33171,Mysterious Skin,2004,mysterious_skin,7.2,99,83,16,83,7.6,29,26,3,89,4,9458,89,http://content7.flixster.com/movie/10/87/40/10874017_det.jpg
33188,Mischief,1985,1013984-mischief,5.2,5,3,2,60,0,0,0,0,0,0,0,0,http://content8.flixster.com/movie/26/76/267626_det.jpg
33191,Jubal,1956,jubal,0,4,4,0,100,0,0,0,0,0,0,0,0,http://content9.flixster.com/movie/29/65/296507_det.jpg
33193,Viva Maria!,1965,viva_maria,0,2,0,2,0,0,0,0,0,0,0,0,0,http://content6.flixster.com/movie/11/13/79/11137992_det.jpg
33237,San Francisco,1936,san_francisco,7.4,7,7,0,100,0,0,0,0,0,0,0,0,http://content9.flixster.com/movie/53/81/73/5381731_det.jpg
33296,Buying the Cow,2002,buying-the-cow,0,3,1,2,33,0,0,0,0,0,0,0,0,http://content6.flixster.com/movie/10/91/52/10915212_det.jpg
33312,The Cocoanuts,1929,cocoanuts,7.5,19,18,1,94,0,2,2,0,100,3.6,1293,71,http://content8.flixster.com/movie/30/05/300526_det.jpg
33340,Kizzu rit√¢n,1996,kids_return,0,4,4,0,100,0,0,0,0,0,0,0,0,http://content9.flixster.com/movie/30/62/306211_det.jpg
33358,Off the Map,2003,off-the-map,6.6,92,64,28,69,6.6,26,18,8,69,3.8,818,82,http://content7.flixster.com/movie/10/89/42/10894229_det.jpg
33410,Crackerjack,2002,crackerjack-molloy-boy-productions,6.5,5,5,0,100,0,0,0,0,0,0,0,0,http://content9.flixster.com/movie/21/87/34/2187347_det.jpg
33421,Dear Wendy,2005,dear_wendy,5.1,60,22,38,36,4.2,16,3,13,18,3.2,7054,54,http://content7.flixster.com/movie/10/91/90/10919001_det.jpg
33437,Danny the Dog,2005,1145385-unleashed,6.2,128,83,45,64,5.9,31,15,16,48,3.5,17781,77,http://content9.flixster.com/movie/24/97/249719_det.jpg
33451,"Brutti, sporchi e cattivi",1976,,\N,\N,\N,\N,\N,\N,\N,\N,\N,\N,\N,\N,\N,\N
33454,L√©olo,1992,leolo,8.3,9,9,0,100,0,3,3,0,100,4.1,1393,87,http://content9.flixster.com/movie/10/89/56/10895619_det.jpg
33493,Star Wars: Episode III - Revenge of the Sith,2005,star_wars_3,7.2,253,202,51,79,6.6,43,29,14,67,3.1,198824,64,http://content8.flixster.com/movie/10/94/47/10944718_det.jpg
33495,Kicking & Screaming,2005,kicking_and_screaming,5.1,137,57,80,41,5,31,12,19,38,3,14260,51,http://content9.flixster.com/movie/24/97/249715_det.jpg
33499,Monster-in-Law,2005,monsterinlaw,4.2,162,26,136,16,3.9,40,5,35,12,3.2,50840,63,http://content8.flixster.com/movie/10/93/78/10937826_det.jpg
33539,Deep Blue Sea,1999,1090759-deep_blue_sea,5.7,89,51,38,57,5.8,22,14,8,63,2.8,26286,44,http://content7.flixster.com/movie/27/10/271021_det.jpg
33558,The Snow Walker,2003,1143677-snow_walker,6.8,13,11,2,84,0,3,2,1,66,3.7,895,76,http://content7.flixster.com/movie/25/84/258417_det.jpg
33564,Divorzio all'italiana,1961,divorce_italian_style,7.9,16,16,0,100,7.8,5,5,0,100,4,1181,90,http://content9.flixster.com/movie/10/89/11/10891115_det.jpg
33585,9 Songs,2004,9_songs,4.4,92,23,69,25,4.5,29,8,21,27,2.7,3152,35,http://content7.flixster.com/movie/28/57/285721_det.jpg
33592,Nabbeun namja,2001,nabbeun-namja-bad-guy,5.2,31,13,18,41,5,10,3,7,30,3.6,1440,72,http://content6.flixster.com/movie/29/79/297992_det.jpg
33603,Simon,2004,1157813-simon,5.6,5,3,2,60,0,4,2,2,50,4.1,338,87,http://content7.flixster.com/movie/24/84/66/2484669_det.jpg
33608,December 7th,1943,december-7th-1942,0,0,0,0,0,0,0,0,0,0,0,0,0,http://content9.flixster.com/movie/10/91/88/10918859_det.jpg
33615,Madagascar,2005,madagascar,6,185,102,83,55,6,36,14,22,38,3.4,131512,70,http://content7.flixster.com/movie/24/97/249793_det.jpg
33621,Somersault,2004,somersault,6.9,64,53,11,82,6.8,18,15,3,83,3.2,9811,53,http://content7.flixster.com/movie/10/88/55/10885509_det.jpg
33629,Airborne,1993,1046035-airborne,2.9,6,1,5,16,0,1,0,1,0,0,0,0,http://content9.flixster.com/movie/15/96/72/1596727_det.jpg
33639,Mad Hot Ballroom,2005,mad_hot_ballroom,7.1,115,96,19,83,7.5,32,31,1,96,3.8,2138,80,http://content6.flixster.com/movie/25/36/253612_det.jpg
33644,Dominion: Prequel to the Exorcist,2005,dominion_prequel_to_the_exorcist,4.7,43,13,30,30,4.7,15,4,11,26,2.7,5628,35,http://content6.flixster.com/movie/55/37/56/5537560_det.jpg
33646,The Longest Yard,2005,longest_yard,4.8,163,51,112,31,5.2,35,14,21,40,3.3,198675,67,http://content8.flixster.com/movie/10/86/70/10867014_det.jpg
33649,Saving Face,2004,saving_face,6.7,81,70,11,86,7,25,23,2,92,4,2669,87,http://content9.flixster.com/movie/60/49/00/6049003_det.jpg
33660,Cinderella Man,2005,cinderella_man,7.4,206,164,42,79,7.6,43,35,8,81,3.8,44272,88,http://content7.flixster.com/movie/24/97/249797_det.jpg
33669,The Sisterhood of the Traveling Pants,2005,sisterhood_of_the_traveling_pants,6.7,128,98,30,76,7.2,31,29,2,93,3.4,38616,78,http://content6.flixster.com/movie/24/98/249800_det.jpg
33672,Lords of Dogtown,2005,lords_of_dogtown,6,141,77,64,54,6.5,33,20,13,60,3.6,15495,81,http://content8.flixster.com/movie/55/36/80/5536806_det.jpg
33675,Apr√®s vous...,2003,apres-vous,6,64,36,28,56,6.3,20,12,8,60,3.5,850,67,http://content9.flixster.com/movie/10/88/92/10889263_det.jpg
33677,The School of Rock,2003,school_of_rock,7.8,188,172,16,91,8.2,39,38,1,97,3.2,183700,63,http://content6.flixster.com/movie/10/84/98/10849856_det.jpg
33679,Mr. & Mrs. Smith,2005,mr_and_mrs_smith,6,202,116,86,57,5.6,39,18,21,46,3.4,230941,63,http://content8.flixster.com/movie/24/98/249802_det.jpg
33681,The Adventures of Sharkboy and Lavagirl 3-D,2005,the-adventures-of-sharkboy-and-lavagirl-in-3d,4.3,120,24,96,20,4,31,5,26,16,2.5,5829,42,http://content8.flixster.com/movie/24/98/249810_det.jpg
33683,Haute tension,2003,high-tension-switchblade-romance,5.2,126,52,74,41,4.9,24,11,13,45,3.4,11124,68,http://content8.flixster.com/movie/11/14/29/11142906_det.jpg
33685,The Honeymooners,2005,1146572-honeymooners,3.6,109,15,94,13,3.6,30,4,26,13,2.8,2118,42,http://content8.flixster.com/movie/25/75/257518_det.jpg
33688,Parineeta,2005,10005381-parineeta,0,2,2,0,100,0,1,1,0,100,3.8,1102,81,http://content6.flixster.com/movie/25/30/253000_det.jpg
33722,Ladies in Lavender.,2004,ladies_in_lavender,6.1,89,56,33,62,6.3,27,17,10,62,3.5,2044,65,http://content6.flixster.com/movie/24/97/249740_det.jpg
33725,It's All Gone Pete Tong,2004,its_all_gone_pete_tong,6.5,70,54,16,77,6.1,21,14,7,66,3.9,3974,87,http://content7.flixster.com/movie/26/91/269197_det.jpg
33750,Voces inocentes,2004,innocent_voices,6.8,47,32,15,68,7.1,16,11,5,68,4.3,1831,93,http://content8.flixster.com/movie/25/03/250318_det.jpg
33781,Quo Vadis,1951,1017021-quo_vadis,6.4,8,7,1,87,0,0,0,0,0,0,0,0,http://content7.flixster.com/movie/10/89/80/10898061_det.jpg
33794,Batman Begins,2005,batman_begins,7.7,257,217,40,84,6.6,43,26,17,60,3.9,184482,90,http://content7.flixster.com/movie/16/90/34/1690349_det.jpg
33815,The Perfect Man,2005,perfect_man,3.2,117,6,111,5,3.5,31,3,28,9,3.2,49341,69,http://content6.flixster.com/movie/10/86/14/10861428_det.jpg
33817,My Summer of Love,2004,my_summer_of_love,7.4,87,78,9,89,7.8,30,29,1,96,3.5,3593,69,http://content6.flixster.com/movie/10/89/92/10899276_det.jpg
33819,Heights,2005,heights,6.3,101,65,36,64,5.8,29,16,13,55,3.6,1284,73,http://content6.flixster.com/movie/26/71/267104_det.jpg
33821,The Deal,2008,1190825-deal,0,4,2,2,50,0,2,0,2,0,2.7,714,28,http://content7.flixster.com/movie/10/85/67/10856717_det.jpg
33823,The Bridge of San Luis Rey,2004,10002635-bridge_of_san_luis_rey,2.9,24,1,23,4,2.8,11,0,11,0,2.7,689,34,http://content8.flixster.com/movie/10/92/73/10927334_det.jpg
33826,Saint Ralph,2004,10005178-saint_ralph,6.3,67,42,25,62,6.1,24,15,9,62,3.8,1289,83,http://content7.flixster.com/movie/10/86/87/10868781_det.jpg
33830,Herbie Fully Loaded,2005,herbie_fully_loaded,5.4,139,58,81,41,5.6,32,15,17,46,2.8,18840,54,http://content8.flixster.com/movie/10/86/97/10869786_det.jpg
33832,Yes Man,2008,yes_man,5.2,144,62,82,43,4.9,31,12,19,38,3.7,141478,72,http://content8.flixster.com/movie/10/85/26/10852650_det.jpg
33834,Land of the Dead,2005,land_of_the_dead,6.6,169,124,45,73,6.4,32,21,11,65,3.1,28194,56,http://content7.flixster.com/movie/24/98/249809_det.jpg
33836,Bewitched,2005,bewitched,4.6,182,44,138,24,4.3,41,8,33,19,2.5,17310,39,http://content8.flixster.com/movie/10/84/02/10840286_det.jpg
33838,Rize,2005,rize,7,89,74,15,83,7,29,25,4,86,4,2579,84,http://content8.flixster.com/movie/24/98/249814_det.jpg
33880,Me and You and Everyone We Know,2005,me_and_you_and_everyone_we_know,7.4,108,88,20,81,7.6,35,29,6,82,3.9,12252,85,http://content6.flixster.com/movie/99/42/44/9942444_det.jpg
33896,Sam gang yi,2004,threeextremes,6.8,62,52,10,83,6.5,23,16,7,69,3.7,5014,75,http://content9.flixster.com/movie/25/04/250423_det.jpg
33903,Die fetten Jahre sind vorbei,2004,edukators,6.5,75,52,23,69,6.4,22,14,8,63,4,6418,89,http://content7.flixster.com/movie/10/26/18/10261817_det.jpg
33905,Somebody Up There Likes Me,1956,somebody_up_there_likes_me,6.7,10,8,2,80,0,3,3,0,100,3.9,753,86,http://content6.flixster.com/movie/10/92/09/10920920_det.jpg
33966,Cop and ¬Ω,1993,cop_and_a_half,2.8,12,2,10,16,0,2,1,1,50,2.3,1861,33,http://content7.flixster.com/movie/26/48/264897_det.jpg
34002,Room Service,1938,room_service,5.8,10,7,3,70,0,0,0,0,0,0,0,0,http://content8.flixster.com/movie/70/32/67/7032678_det.jpg
34018,At the Circus,1939,at_the_circus,6.9,9,9,0,100,0,0,0,0,0,0,0,0,http://content6.flixster.com/movie/10/94/25/10942596_det.jpg
34048,War of the Worlds,2005,war_of_the_worlds,7,244,178,66,72,6.7,42,28,14,66,2.9,162092,45,http://content8.flixster.com/movie/10/86/82/10868202_det.jpg
34065,Billion Dollar Brain,1967,billion_dollar_brain,0,4,2,2,50,0,1,0,1,0,3.1,957,45,http://content8.flixster.com/movie/29/22/292222_det.jpg
34072,La marche de l'empereur,2005,march_of_the_penguins,7.8,163,153,10,93,7.6,38,35,3,92,3.5,18536,76,http://content7.flixster.com/movie/24/99/249901_det.jpg
34129,Rebound,2005,rebound,3.7,89,12,77,13,4,29,4,25,13,2.9,5853,52,http://content9.flixster.com/movie/24/98/249819_det.jpg
34143,Dark Water,2005,dark_water,5.5,148,67,81,45,5.3,36,15,21,41,2.7,18535,38,http://content6.flixster.com/movie/11/12/84/11128476_det.jpg
34148,De battre mon coeur s'est arr√™t√©,2005,beat_that_my_heart_skipped,7.2,91,77,14,84,6.9,28,22,6,78,3.9,3473,83,http://content9.flixster.com/movie/18/93/97/1893979_det.jpg
34150,Fantastic Four,2005,fantastic_four,4.5,200,54,146,27,4.7,34,10,24,29,3.2,95962,57,http://content8.flixster.com/movie/10/90/66/10906682_det.jpg
34153,Murderball,2005,murderball,8.4,137,134,3,97,8.4,35,35,0,100,3.9,3228,87,http://content6.flixster.com/movie/10/16/22/10162248_det.jpg
34155,Saraband,2003,saraband,7.9,78,73,5,93,8.2,26,24,2,92,3.9,1427,83,http://content8.flixster.com/movie/21/01/14/2101146_det.jpg
34158,Julie Johnson,2001,julie-johnson,0,0,0,0,0,0,0,0,0,0,0,0,0,http://content8.flixster.com/movie/99/32/43/9932434_det.jpg
34162,Wedding Crashers,2005,wedding_crashers,6.7,180,135,45,75,6.9,38,28,10,73,3.5,215271,70,http://content9.flixster.com/movie/24/98/249823_det.jpg
34164,Happy Endings,2005,happy_endings,6,104,58,46,55,6,33,16,17,48,3.4,3035,63,http://content6.flixster.com/movie/11/13/76/11137620_det.jpg
34170,C.H.O.M.P.S,1979,chomps,0,2,0,2,0,0,0,0,0,0,0,0,0,http://content6.flixster.com/movie/31/88/86/3188864_det.jpg
34177,The Hindenburg,1975,1009649-hindenburg,5.1,11,5,6,45,0,1,0,1,0,3,497,40,http://content9.flixster.com/movie/26/06/260607_det.jpg
34185,Staying Together,1989,staying_together,5.8,5,4,1,80,0,1,0,1,0,3.2,295,61,http://content7.flixster.com/movie/10/88/85/10888533_det.jpg
34189,Twin Sitters,1994,twin_sitters,0,0,0,0,0,0,0,0,0,0,0,0,0,http://content9.flixster.com/movie/26/54/265499_det.jpg
34193,Earth: Final Conflict,1997,,\N,\N,\N,\N,\N,\N,\N,\N,\N,\N,\N,\N,\N,\N
34198,Les poup√©es russes,2005,russian_dolls,6.6,47,34,13,72,6.8,17,11,6,64,3.6,8145,76,http://content6.flixster.com/movie/27/23/02/2723024_det.jpg
34271,Hustle & Flow,2005,hustle_and_flow,7.3,153,126,27,82,7.5,37,30,7,81,3.6,17513,80,http://content6.flixster.com/movie/24/99/249904_det.jpg
34292,Hardware,1990,hardware,6.1,9,5,4,55,0,1,0,1,0,3.2,1157,60,http://content7.flixster.com/movie/20/48/27/2048277_det.jpg
34299,Appaloosa,2008,10008785-appaloosa,6.6,156,119,37,76,6.6,34,25,9,73,3.2,19629,55,http://content6.flixster.com/movie/10/85/47/10854708_det.jpg
34319,The Island,2005,island,5.4,184,74,110,40,5.2,36,14,22,38,3.3,41199,67,http://content7.flixster.com/movie/85/25/14/8525141_det.jpg
34321,The Bad News Bears,1976,1001567-bad_news_bears,7.4,24,22,2,91,7.2,5,5,0,100,3.3,4926,74,http://content9.flixster.com/movie/10/87/82/10878251_det.jpg
34323,The Devil's Rejects,2005,devils_rejects,5.4,131,70,61,53,5.4,27,13,14,48,3.6,27834,79,http://content7.flixster.com/movie/24/99/249905_det.jpg
34326,Last Days,2005,last_days,5.9,111,64,47,57,6,35,23,12,65,3.1,5692,53,http://content8.flixster.com/movie/97/93/84/9793842_det.jpg
34330,V for Vendetta,2006,v_for_vendetta,6.8,233,169,64,72,6.2,37,23,14,62,3.9,226041,88,http://content9.flixster.com/movie/31/32/313291_det.jpg
34332,Sky High,2005,1142872-sky_high,6.5,124,90,34,72,6.6,27,18,9,66,3,28338,58,http://content9.flixster.com/movie/24/98/249899_det.jpg
34334,Stealth,2005,1146673-1146673-stealth,3.8,138,18,120,13,3.6,31,2,29,6,2.9,14786,50,http://content7.flixster.com/movie/10/93/21/10932137_det.jpg
34336,Must Love Dogs,2005,must_love_dogs,5,145,50,95,34,5,32,11,21,34,3,16710,57,http://content6.flixster.com/movie/10/87/23/10872352_det.jpg
34338,The Aristocrats,2005,conjure,0,0,0,0,0,0,0,0,0,0,0,0,0,http://content7.flixster.com/movie/10/84/62/10846253_det.jpg
34353,Twice in a Lifetime,1985,twice_in_a_lifetime,7.4,6,5,1,83,0,1,1,0,100,3,200,45,http://content9.flixster.com/movie/72/56/39/7256399_det.jpg
34359,Georgy Girl,1966,georgy_girl,7.1,9,8,1,88,0,0,0,0,0,0,0,0,http://content9.flixster.com/movie/30/40/304015_det.jpg
34405,Serenity,2005,serenity,7.1,176,143,33,81,7.1,33,28,5,84,3.8,60506,89,http://content8.flixster.com/movie/25/02/250218_det.jpg
34437,Broken Flowers,2005,broken_flowers,7.4,184,160,24,86,7.4,40,34,6,85,3.3,21466,68,http://content9.flixster.com/movie/24/99/249911_det.jpg
34482,The Browning Version,1994,1055873-browning_version,6.7,16,13,3,81,0,3,1,2,33,3.5,322,63,http://content9.flixster.com/movie/28/01/280191_det.jpg
34499,The Heart Is Deceitful Above All Things,2004,the-heart-is-deceitful-above-all-things,5,49,20,29,40,3,15,1,14,6,3.6,2672,70,http://content6.flixster.com/movie/59/62/13/5962136_det.jpg
34520,The Dukes of Hazzard,2005,dukes_of_hazzard,3.6,164,22,142,13,3.7,37,8,29,21,2.9,27455,58,http://content9.flixster.com/movie/10/88/62/10886235_det.jpg
34523,The Chumscrubber,2005,chumscrubber,4.9,58,20,38,34,4.8,8,3,5,37,3.5,6925,76,http://content7.flixster.com/movie/24/99/249913_det.jpg
34526,Secuestro express,2005,secuestro_express,5.7,42,22,20,52,6.2,13,8,5,61,3.2,1109,73,http://content7.flixster.com/movie/24/99/249917_det.jpg
34528,Junebug,2005,junebug,7.5,126,108,18,85,7.8,33,31,2,93,3.4,7517,72,http://content9.flixster.com/movie/24/99/249907_det.jpg
34530,Deuce Bigalow: European Gigolo,2005,deuce_bigelow_european_gigolo,2.8,100,10,90,10,3,24,2,22,8,2.7,16038,51,http://content9.flixster.com/movie/24/99/249923_det.jpg
34532,The Skeleton Key,2005,1149472-skeleton_key,5.3,147,56,91,38,5,33,8,25,24,3.1,23528,63,http://content7.flixster.com/movie/24/99/249993_det.jpg
34534,Four Brothers,2005,hard-four,0,0,0,0,0,0,0,0,0,0,0,0,0,http://content6.flixster.com/movie/10/87/64/10876488_det.jpg
34536,The Great Raid,2005,great_raid,5.3,119,43,76,36,4.9,28,8,20,28,3.6,3417,73,http://content9.flixster.com/movie/24/99/249927_det.jpg
34538,Asylum,2008,10009261-asylum,0,2,0,2,0,0,1,0,1,0,2.2,1071,17,http://content8.flixster.com/movie/10/85/28/10852822_det.jpg
34540,Pretty Persuasion,2005,pretty_persuasion,5,76,25,51,32,4.4,27,4,23,14,3.4,2958,64,http://content8.flixster.com/movie/24/99/249998_det.jpg
34542,Grizzly Man,2005,grizzly_man,8,134,125,9,93,8.3,35,35,0,100,3.6,9472,82,http://content6.flixster.com/movie/24/99/249996_det.jpg
34579,The 24th Day,2004,1135414-24th_day,3.7,14,3,11,21,3.8,8,2,6,25,3.4,768,60,http://content7.flixster.com/movie/26/74/267405_det.jpg
34583,Prime Cut,1972,prime_cut,5.8,10,7,3,70,0,1,1,0,100,3.3,584,60,http://content6.flixster.com/movie/10/87/26/10872652_det.jpg
34608,The Best of Everything,1959,best_of_everything,0,4,2,2,50,0,0,0,0,0,0,0,0,http://content9.flixster.com/movie/35/53/85/3553851_det.jpg
34643,The Three Stooges Meet Hercules,1962,three_stooges_meet_hercules,0,3,0,3,0,0,0,0,0,0,0,0,0,http://content7.flixster.com/movie/10/91/19/10911905_det.jpg
34645,Race with the Devil,1975,race_with_the_devil,5,5,2,3,40,0,0,0,0,0,0,0,0,http://content7.flixster.com/movie/25/69/256993_det.jpg
34648,Akasia,2003,acacia_2004,0,0,0,0,0,0,0,0,0,0,0,0,0,http://content8.flixster.com/movie/27/62/276298_det.jpg
34767,My Date with Drew,2004,my_date_with_drew,6,64,45,19,70,5.7,21,14,7,66,3.1,2652,53,http://content9.flixster.com/movie/24/99/249915_det.jpg
35015,Duma,2005,duma,7.5,59,55,4,93,7.4,25,23,2,92,3.3,11201,57,http://content6.flixster.com/movie/25/02/250224_det.jpg
35836,The 40 Year Old Virgin,2005,40_year_old_virgin,7.2,179,153,26,85,7.1,36,31,5,86,3.6,141534,81,http://content8.flixster.com/movie/25/00/250002_det.jpg
35957,Red Eye,2005,1149496-1149496-red_eye,6.7,178,141,37,79,7.2,37,33,4,89,3.2,32710,66,http://content9.flixster.com/movie/25/00/250003_det.jpg
36056,Man of the West,1958,man_of_the_west,8.7,6,6,0,100,0,0,0,0,0,0,0,0,http://content7.flixster.com/movie/89/40/46/8940465_det.jpg
36152,A Nightmare on Elm Street: The Dream Child,1989,nightmare_on_elm_street_5_the_dream_child,4.1,27,8,19,29,0,4,1,3,25,2.9,17837,56,http://content8.flixster.com/movie/10/95/40/10954010_det.jpg
36276,Cach√©,2005,1153493-cache,7.8,128,113,15,88,8.2,31,29,2,93,3.5,16387,71,http://content8.flixster.com/movie/31/17/311798_det.jpg
36397,Valiant,2005,valiant,5,109,33,76,30,4.6,25,3,22,12,2.8,6330,39,http://content9.flixster.com/movie/25/00/250007_det.jpg
36401,The Brothers Grimm,2005,brothers_grimm,5.1,177,66,111,37,4.8,34,10,24,29,2.9,36907,47,http://content9.flixster.com/movie/10/88/08/10880899_det.jpg
36477,The Baxter,2005,10005403-the_baxter,5.1,73,24,49,32,4.8,24,6,18,25,3.7,1793,76,http://content7.flixster.com/movie/25/00/250021_det.jpg
36509,The Cave,2005,cave,3.5,105,12,93,11,3,24,1,23,4,2.8,10980,38,http://content9.flixster.com/movie/10/88/22/10882223_det.jpg
36511,Undiscovered,2005,undiscovered,3.2,66,5,61,7,3.5,24,3,21,12,3.1,1795,53,http://content9.flixster.com/movie/25/00/250019_det.jpg
36513,Dirty Deeds,2002,dirty_deeds,5.7,13,8,5,61,0,3,1,2,33,0,0,0,http://content7.flixster.com/movie/10/92/17/10921713_det.jpg
36517,The Constant Gardener,2005,constant_gardener,7.6,181,151,30,83,8.2,36,33,3,91,3.5,31578,81,http://content6.flixster.com/movie/25/00/250092_det.jpg
36519,Transporter 2,2005,62,0,0,0,0,0,0,0,0,0,0,0,0,0,http://content8.flixster.com/movie/10/84/50/10845022_det.jpg
36523,Margaret Cho: Assassin,2005,margaret_cho_assassin,4.7,24,9,15,37,5.1,12,6,6,50,3.3,467,61,http://content7.flixster.com/movie/19/42/37/1942373_det.jpg
36525,Just Like Heaven,2005,just_like_heaven,5.7,148,84,64,56,5.2,30,12,18,40,3.6,90795,77,http://content8.flixster.com/movie/25/01/250114_det.jpg
36527,Proof,2005,proof,6.4,138,87,51,63,6.4,34,20,14,58,3.2,15629,57,http://content7.flixster.com/movie/10/89/83/10898325_det.jpg
36529,Lord of War,2005,,6.2,141,86,55,60,5.6,33,14,19,42,3.6,51125,84,http://content6.flixster.com/movie/25/01/250116_det.jpg
36531,Venom,2005,1151780-venom,3.1,62,6,56,9,3.5,19,3,16,15,2.6,2557,30,http://content8.flixster.com/movie/25/01/250118_det.jpg
36533,Cry_Wolf,2005,cry-wolf,4,43,10,33,23,4.6,10,4,6,40,3,9727,57,http://content6.flixster.com/movie/10/89/13/10891348_det.jpg
36535,Everything Is Illuminated,2005,everything_is_illuminated,6.5,118,79,39,66,6.3,30,17,13,56,3.9,17347,88,http://content7.flixster.com/movie/25/01/250121_det.jpg
36537,Thumbsucker,2005,thumbsucker,6.7,107,75,32,70,6.8,27,19,8,70,3.3,10573,68,http://content9.flixster.com/movie/25/01/250195_det.jpg
36539,The Thing About My Folks,2005,thing_about_my_folk,5.5,64,28,36,43,5,20,8,12,40,2.8,3150,40,http://content8.flixster.com/movie/25/01/250194_det.jpg
36541,Succubus: Hell Bent,2007,,\N,\N,\N,\N,\N,\N,\N,\N,\N,\N,\N,\N,\N,\N
36553,In Old Chicago,1937,in_old_chicago,0,3,1,2,33,0,0,0,0,0,0,0,0,http://content8.flixster.com/movie/29/31/293118_det.jpg
36708,Family Guy Presents Stewie Griffin: The Untold Story,2005,my-stupid-neighbor,0,0,0,0,0,0,0,0,0,0,0,0,0,http://content8.flixster.com/movie/10/86/99/10869990_det.jpg
36752,Revenge of the Ninja,1983,revenge_of_the_ninja,0,0,0,0,0,0,0,0,0,0,0,0,0,http://content6.flixster.com/movie/27/81/278108_det.jpg
37211,Go West,1940,1008437-go_west,6.5,9,8,1,88,0,0,0,0,0,0,0,0,http://content6.flixster.com/movie/10/81/62/10816296_det.jpg
37240,Why We Fight,2005,1155622-why_we_fight,7,108,86,22,79,7.1,32,24,8,75,3.3,6585,79,http://content9.flixster.com/movie/31/28/312891_det.jpg
37287,Gertrud,1964,gertrud,7.7,9,6,3,66,0,1,0,1,0,3.8,476,77,http://content9.flixster.com/movie/14/80/86/1480863_det.jpg
37335,Da zui xia,1966,come-drink-with-me,0,0,0,0,0,0,0,0,0,0,0,0,0,http://content7.flixster.com/movie/10/87/64/10876437_det.jpg
37380,Doom,2005,doom,3.9,128,24,104,18,3.8,24,4,20,16,2.7,28789,47,http://content9.flixster.com/movie/25/03/250391_det.jpg
37382,Domino,2005,dominos,0,0,0,0,0,0,0,0,0,0,0,0,0,http://content9.flixster.com/movie/10/84/25/10842559_det.jpg
37384,Waiting...,2005,waiting,4.2,87,26,61,29,3.9,25,6,19,24,3.4,35090,76,http://content7.flixster.com/movie/10/86/90/10869037_det.jpg
37386,√Üon Flux,2005,aeon_flux,3.3,102,10,92,9,3.5,19,2,17,10,2.9,50363,47,http://content6.flixster.com/movie/31/16/311612_det.jpg
37475,An Unfinished Life,2005,unfinished_life,5.9,140,74,66,52,5.4,32,14,18,43,3.3,13634,65,http://content9.flixster.com/movie/25/01/250111_det.jpg
37477,Yes Man,2008,yes_man,5.2,144,62,82,43,4.9,31,12,19,38,3.7,141478,72,http://content8.flixster.com/movie/10/85/26/10852650_det.jpg
37545,Woyzeck,1979,1031653-woyzeck,7.3,11,9,2,81,0,2,1,1,50,3.8,1117,79,http://content7.flixster.com/movie/34/10/67/3410673_det.jpg
37720,The Exorcism of Emily Rose,2005,the-nameless,4.9,6,2,4,33,0,0,0,0,0,0,0,0,http://content9.flixster.com/movie/27/83/278399_det.jpg
37727,Flightplan,2005,flightplan,5.3,169,63,106,37,5.5,35,13,22,37,3.2,35131,56,http://content9.flixster.com/movie/25/01/250199_det.jpg
37729,Corpse Bride,2005,corpse_bride,7.2,182,152,30,83,7.6,34,31,3,91,3.5,98441,76,http://content8.flixster.com/movie/25/01/250198_det.jpg
37731,Hooligans,2005,green_street_hooligans,5.5,61,28,33,45,5.4,19,9,10,47,3.9,56992,87,http://content9.flixster.com/movie/25/01/250107_det.jpg
37733,A History of Violence,2005,history_of_violence,7.9,201,175,26,87,8.4,36,34,2,94,3.4,45849,68,http://content9.flixster.com/movie/25/03/250311_det.jpg
37736,Oliver Twist,2005,charles-dickens-the-man-who-asked-for-more,0,0,0,0,0,0,0,0,0,0,0,0,0,http://content8.flixster.com/movie/10/87/39/10873958_det.jpg
37739,The Greatest Game Ever Played,2005,greatest_game_ever_played,6.2,109,68,41,62,5.7,27,15,12,55,3.6,15763,76,http://content6.flixster.com/movie/25/02/250212_det.jpg
37741,Capote,2005,1151898-capote,8.2,179,161,18,89,8.6,39,39,0,100,3.5,35934,72,http://content6.flixster.com/movie/25/02/250220_det.jpg
37830,Final Fantasy VII: Advent Children,2005,final_fantasy_7_advent_children,5.7,6,2,4,33,0,0,0,0,0,0,0,0,http://content6.flixster.com/movie/42/45/96/4245964_det.jpg
37837,Crustac√©s et coquillages,2005,1155198-cote_dazur,5.6,50,25,25,50,5,16,7,9,43,3.5,393,63,http://content8.flixster.com/movie/25/01/250106_det.jpg
37844,Roll Bounce,2005,california_roll,0,0,0,0,0,0,0,0,0,0,0,0,0,http://content7.flixster.com/movie/10/84/26/10842689_det.jpg
37846,Daltry Calhoun,2005,secret_life_of_daltry_calhoun,3.6,28,2,26,7,3.8,9,0,9,0,2.6,4398,34,http://content9.flixster.com/movie/10/89/83/10898327_det.jpg
37853,Into the Blue,2005,into_the_blue,4,123,26,97,21,4.5,31,10,21,32,3.1,24229,67,http://content8.flixster.com/movie/25/02/250214_det.jpg
37855,"The Prize Winner of Defiance, Ohio",2005,prize_winner_of_defiance_ohio,6.1,79,46,33,58,6.1,28,14,14,50,3.2,7811,55,http://content6.flixster.com/movie/25/02/250216_det.jpg
37857,MirrorMask,2005,mirrormask,5.9,87,47,40,54,5.6,26,11,15,42,3.6,20173,77,http://content9.flixster.com/movie/25/02/250291_det.jpg
37955,Innocence,2004,1185734-innocence,6.7,17,11,6,64,6.9,8,6,2,75,3.7,1170,73,http://content7.flixster.com/movie/10/92/29/10922973_det.jpg
37957,Indiana Jones and the Kingdom of the Crystal Skull,2008,indiana_jones_and_the_kingdom_of_the_crystal_skull,6.9,246,190,56,77,6.1,41,25,16,60,3.4,252104,59,http://content6.flixster.com/movie/10/86/88/10868884_det.jpg
37976,"Francesco, giullare di Dio",1950,francesco_giullare_di_dio,8.4,14,14,0,100,0,2,2,0,100,3.9,443,84,http://content7.flixster.com/movie/10/91/66/10916677_det.jpg
38038,Wallace & Gromit in The Curse of the Were-Rabbit,2005,wallace_and_gromit_curse_of_the_wererabbit,8.1,172,163,9,94,7.8,35,33,2,94,3.4,30852,72,http://content6.flixster.com/movie/25/02/250296_det.jpg
38061,Kiss Kiss Bang Bang,2005,kiss_kiss_bang_bang,7.4,146,122,24,83,7,35,28,7,80,3.7,46555,83,http://content9.flixster.com/movie/10/88/59/10885939_det.jpg
38095,Dalkomhan insaeng,2005,a-bittersweet-life-dalkomhan-insaeng,8.1,8,8,0,100,0,0,0,0,0,0,0,0,http://content9.flixster.com/movie/10/87/69/10876915_det.jpg
38188,Bubble,2005,,0,0,0,0,0,0,0,0,0,0,0,0,0,http://content8.flixster.com/movie/10/91/54/10915482_det.jpg
38198,Darwin's Nightmare,2004,1159353-darwins_nightmare,7.6,51,47,4,92,7.5,20,18,2,90,3.9,1596,83,http://content8.flixster.com/movie/31/33/313398_det.jpg
38294,Beowulf & Grendel,2005,beowulf_and_grendel,5.4,33,16,17,48,5.2,13,5,8,38,2.9,7530,43,http://content6.flixster.com/movie/31/37/313724_det.jpg
38304,No Direction Home: Bob Dylan,2005,1148076-no_direction_home_bob_dylan,8,14,13,1,92,0,3,3,0,100,4.3,3390,94,http://content6.flixster.com/movie/10/91/53/10915368_det.jpg
38388,Goal!,2005,1158528-goal,5.2,80,35,45,43,5.2,23,10,13,43,3.7,33414,77,http://content8.flixster.com/movie/10/92/30/10923010_det.jpg
38499,Angels in America,2003,,\N,\N,\N,\N,\N,\N,\N,\N,\N,\N,\N,\N,\N,\N
38600,Factotum,2005,factotum,6.8,111,84,27,75,6.5,29,17,12,58,3.2,9868,51,http://content6.flixster.com/movie/21/37/16/2137160_det.jpg
38701,Don't Come Knocking,2005,dont_come_knocking,5.4,100,42,58,42,5.4,27,11,16,40,3,13487,40,http://content6.flixster.com/movie/10/89/84/10898416_det.jpg
38798,In Her Shoes,2005,in_her_shoes,6.9,162,121,41,74,6.4,38,23,15,60,3.2,31531,65,http://content9.flixster.com/movie/25/02/250299_det.jpg
38824,√Ñideist√§ parhain,2005,mother_of_mine-2005,0,3,3,0,100,0,1,1,0,100,4,941,85,http://content7.flixster.com/movie/10/95/09/10950913_det.jpg
38886,The Squid and the Whale,2005,squid_and_the_whale,7.9,138,129,9,93,8.2,35,35,0,100,3.6,28511,76,http://content6.flixster.com/movie/25/02/250292_det.jpg
38992,Two for the Money,2005,two_for_the_money,4.7,109,23,86,21,5.3,29,5,24,17,3.1,9296,52,http://content7.flixster.com/movie/25/03/250301_det.jpg
38994,Separate Lies,2005,separate_lies,6.8,88,63,25,71,7.1,29,22,7,75,3.2,726,46,http://content6.flixster.com/movie/25/01/250192_det.jpg
39052,Star Wreck: In the Pirkinning,2005,star-wreck-in-the-pirkinning,0,0,0,0,0,0,0,0,0,0,0,0,0,http://content9.flixster.com/movie/28/96/12/2896123_det.jpg
39183,Brokeback Mountain,2005,brokeback_mountain,8.2,233,202,31,86,8.1,42,38,4,90,3.4,82054,77,http://content7.flixster.com/movie/31/17/311705_det.jpg
39231,Elizabethtown,2005,elizabethtown,4.6,168,46,122,27,4.1,36,7,29,19,3.1,42584,65,http://content9.flixster.com/movie/25/03/250315_det.jpg
39234,North Country,2005,north_country,6.7,166,114,52,68,6.8,38,26,12,68,3.5,14739,72,http://content8.flixster.com/movie/25/03/250394_det.jpg
39292,"Good Night, and Good Luck.",2005,1152019-good_night_and_good_luck,8.1,213,200,13,93,8.2,41,39,2,95,3.6,37838,73,http://content7.flixster.com/movie/25/03/250309_det.jpg
39307,Dreamer: Inspired by a True Story,2005,dreamer,6.3,115,73,42,63,6.1,29,17,12,58,3.6,21404,74,http://content6.flixster.com/movie/25/03/250392_det.jpg
39369,Detective Story,1951,1054081-detective_story,6.1,9,6,3,66,0,0,0,0,0,0,0,0,http://content9.flixster.com/movie/29/08/290819_det.jpg
39381,The Proposition,2005,proposition,7.3,123,107,16,86,7.4,31,27,4,87,3.6,20228,77,http://content6.flixster.com/movie/31/42/314204_det.jpg
39390,The Gospel,2005,gospel,4.9,37,12,25,32,5.1,13,5,8,38,3.5,1967,78,http://content8.flixster.com/movie/25/02/250298_det.jpg
39394,Dandelion,2004,dandelion,6.2,12,8,4,66,0,4,2,2,50,3.7,657,75,http://content8.flixster.com/movie/10/88/40/10884026_det.jpg
39398,C.S.A.: The Confederate States of America,2004,csa_confederate_states_of_america,7,65,51,14,78,7,20,16,4,80,3.2,1917,50,http://content7.flixster.com/movie/15/53/07/1553077_det.jpg
39400,The Fog,2005,fog,2.7,66,3,63,4,2.8,11,0,11,0,2.5,14642,35,http://content7.flixster.com/movie/25/03/250317_det.jpg
39402,Loggerheads,2005,loggerheads,6.5,46,33,13,71,6.4,18,13,5,72,2.8,4784,36,http://content6.flixster.com/movie/25/03/250320_det.jpg
39408,Left Behind: World at War,2005,left_behind_world_at_war,0,2,0,2,0,0,0,0,0,0,0,0,0,http://content8.flixster.com/movie/25/36/253610_det.jpg
39410,Protocols of Zion,2005,protocols_of_zion,6.4,56,39,17,69,5.8,19,11,8,57,2.9,4921,40,http://content9.flixster.com/movie/25/04/250403_det.jpg
39414,Shopgirl,2005,,6.3,146,88,58,60,6.5,37,24,13,64,3,17702,51,http://content7.flixster.com/movie/25/04/250405_det.jpg
39416,Kids in America,2005,same-sex-america,0,0,0,0,0,0,0,0,0,0,0,0,0,http://content6.flixster.com/movie/10/84/89/10848996_det.jpg
39419,Where the Truth Lies,2005,atom,0,0,0,0,0,0,0,0,0,0,0,0,0,http://content6.flixster.com/movie/10/84/26/10842680_det.jpg
39421,After School Special,2003,national_lampoons_barely_legal,0,2,0,2,0,0,1,0,1,0,2.9,2657,39,http://content6.flixster.com/movie/11/12/16/11121620_det.jpg
39425,Emmanuel's Gift,2005,emmanuels_gift,6.4,22,18,4,81,5.6,8,6,2,75,3.6,352,76,http://content8.flixster.com/movie/25/03/250398_det.jpg
39427,Stay,2005,stay,4.6,119,31,88,26,4.2,33,5,28,15,3.4,20956,68,http://content8.flixster.com/movie/10/89/83/10898338_det.jpg
39429,I Confess,1953,i_confess,7.2,20,17,3,85,0,3,2,1,66,3.6,2474,70,http://content7.flixster.com/movie/95/95/29/9595297_det.jpg
39435,The Legend of Zorro,2005,legend_of_zorro,4.8,133,34,99,25,4.8,30,8,22,26,3.2,32197,61,http://content8.flixster.com/movie/25/04/250410_det.jpg
39441,New York Doll,2005,new_york_doll,7.3,51,46,5,90,7.1,14,13,1,92,3.9,843,84,http://content7.flixster.com/movie/25/04/250417_det.jpg
39444,The Weather Man,2005,weather_man,6.1,131,76,55,58,6,33,17,16,51,2.9,22086,51,http://content9.flixster.com/movie/25/04/250415_det.jpg
39446,Saw II,2005,saw_ii,4.6,116,41,75,35,3.9,27,6,21,22,3.2,183455,66,http://content8.flixster.com/movie/25/04/250414_det.jpg
39449,Prime,2005,prime,5.6,116,57,59,49,5.7,31,15,16,48,3.1,17427,52,http://content6.flixster.com/movie/25/04/250412_det.jpg
39474,Subarashiki nichiy√¥bi,1947,one_wonderful_sunday,6.8,7,6,1,85,0,3,3,0,100,3.7,268,75,http://content7.flixster.com/movie/10/84/06/10840637_det.jpg
39659,Teorema,1968,teorema,7.4,14,12,2,85,0,4,4,0,100,4,1151,80,http://content8.flixster.com/movie/10/85/76/10857654_det.jpg
39703,Little Fish,2005,1157387-little_fish,6.6,21,18,3,85,6.2,6,5,1,83,2.8,6910,47,http://content8.flixster.com/movie/10/91/40/10914058_det.jpg
39715,American Pie Presents Band Camp,2005,american_pie_presents_band_camp,3.7,5,1,4,20,0,0,0,0,0,0,0,0,http://content8.flixster.com/movie/11/12/27/11122774_det.jpg
39869,Manderlay,2005,manderlay,5.6,97,49,48,50,4.3,26,8,18,30,3.6,3901,77,http://content6.flixster.com/movie/10/89/84/10898408_det.jpg
39886,Nine Lives,2005,1151916-1151916-nine_lives,6.7,84,63,21,75,7.3,23,19,4,82,3.1,4724,54,http://content8.flixster.com/movie/10/91/49/10914934_det.jpg
39896,Don't Be a Menace to South Central While Drinking Your Juice in the Hood,1996,dont_be_a_menace,4.5,24,7,17,29,5.6,7,3,4,42,0,0,0,http://content8.flixster.com/movie/28/69/286926_det.jpg
40010,Temporada de patos,2004,duck_season_2006,7.1,73,66,7,90,7.6,22,20,2,90,0,0,0,http://content6.flixster.com/movie/10/89/84/10898412_det.jpg
40148,Revolver,2005,revolver2005,3.5,61,10,51,16,3.1,19,1,18,5,3.3,15328,60,http://content8.flixster.com/movie/10/60/54/10605486_det.jpg
40278,Jarhead,2005,1152567-jarhead,6.3,195,119,76,61,6,40,21,19,52,3.3,52128,68,http://content7.flixster.com/movie/25/04/250493_det.jpg
40337,Ha-Ushpizin,2004,ushpizin,7.4,61,57,4,93,7.7,21,21,0,100,4,763,86,http://content9.flixster.com/movie/25/03/250327_det.jpg
40339,Chicken Little,2005,chicken_little,5.4,156,56,100,35,5.5,34,8,26,23,3.2,54371,56,http://content9.flixster.com/movie/25/04/250491_det.jpg
40412,Dead Man's Shoes,2004,dead_mans_shoes,5.7,40,23,17,57,4.5,11,4,7,36,3.9,22081,83,http://content7.flixster.com/movie/10/84/03/10840369_det.jpg
40414,Joyeux No√´l,2005,joyeux_noel,6.8,91,69,22,75,7.1,26,22,4,84,3.6,9688,80,http://content9.flixster.com/movie/31/28/312815_det.jpg
40491,Tulitikkutehtaan tytt√∂,1990,match_factory_girl,0,3,3,0,100,0,0,0,0,0,0,0,0,http://content8.flixster.com/movie/89/59/16/8959162_det.jpg
40494,Zombie ja Kummitusjuna,1991,zombie_and_the_ghost_train,0,3,3,0,100,0,0,0,0,0,0,0,0,http://content9.flixster.com/movie/10/89/15/10891523_det.jpg
40574,Get Rich or Die Tryin',2005,get_rich_or_die_tryin,4.4,118,20,98,16,5,27,6,21,22,3.3,42176,73,http://content7.flixster.com/movie/25/05/250501_det.jpg
40581,Just Friends,2005,just_friends,5.1,96,40,56,41,5,27,10,17,37,3.4,46041,73,http://content6.flixster.com/movie/25/06/250604_det.jpg
40583,Syriana,2005,syriana,6.9,193,139,54,72,7.5,43,37,6,86,3.3,38319,65,http://content9.flixster.com/movie/25/06/250615_det.jpg
40586,Calamari Union,1985,calamari-union,0,0,0,0,0,0,0,0,0,0,0,0,0,http://content9.flixster.com/movie/10/33/44/10334435_det.jpg
40614,Derailed,2005,derailed,4.6,125,25,100,20,4.6,34,6,28,17,3.1,25982,61,http://content6.flixster.com/movie/25/05/250504_det.jpg
40629,Pride & Prejudice,2005,1153077-1153077-pride_and_prejudice,7.7,164,140,24,85,7.6,37,32,5,86,3.8,101164,88,http://content8.flixster.com/movie/25/05/250518_det.jpg
40723,Wolf Creek,2005,wolf_creek,5.5,108,57,51,52,5.2,27,14,13,51,3,24198,50,http://content7.flixster.com/movie/10/88/80/10888029_det.jpg
40732,The Descent,2005,descent,7.3,165,139,26,84,7,30,22,8,73,3.3,49487,71,http://content7.flixster.com/movie/11/14/69/11146933_det.jpg
40752,Takeshis',2005,takeshis,5.4,5,2,3,40,0,0,0,0,0,0,0,0,http://content7.flixster.com/movie/10/87/32/10873265_det.jpg
40815,Harry Potter and the Goblet of Fire,2005,harry_potter_and_the_goblet_of_fire,7.4,216,190,26,87,7.2,36,32,4,88,3.4,275215,74,http://content9.flixster.com/movie/95/72/15/9572155_det.jpg
40817,Dinner with Friends,2001,dinner_with_friends,6.4,7,6,1,85,0,0,0,0,0,0,0,0,http://content7.flixster.com/movie/10/91/04/10910433_det.jpg
40819,Walk the Line,2005,walk_the_line,7.3,202,166,36,82,7.1,40,30,10,75,3.9,112102,86,http://content8.flixster.com/movie/25/05/250594_det.jpg
40826,Rent,2005,1152276-rent,5.8,168,79,89,47,5.5,34,13,21,38,3.5,58040,83,http://content8.flixster.com/movie/25/06/250606_det.jpg
40833,I pugni in tasca,1965,fist-in-his-pocket,0,4,4,0,100,0,0,0,0,0,0,0,0,http://content8.flixster.com/movie/10/85/77/10857774_det.jpg
40851,Zathura: A Space Adventure,2005,zathura,6.5,157,118,39,75,6.6,30,22,8,73,3,23630,54,http://content8.flixster.com/movie/25/05/250506_det.jpg
40870,Movie Crazy,1932,movie_crazy,0,1,0,1,0,0,0,0,0,0,0,0,0,http://content6.flixster.com/movie/10/88/53/10885304_det.jpg
40887,Lonesome Jim,2005,lonesome_jim,6,89,53,36,59,5.7,24,10,14,41,2.9,12480,41,http://content9.flixster.com/movie/31/35/313507_det.jpg
40946,Sarah Silverman: Jesus Is Magic,2005,sarah_silverman_jesus_is_magic,6.1,98,63,35,64,6.2,27,18,9,66,3.2,9920,55,http://content6.flixster.com/movie/25/05/250520_det.jpg
40952,Bee Season,2005,bee_season,5.4,104,44,60,42,4.9,32,11,21,34,2.8,3415,37,http://content9.flixster.com/movie/10/87/02/10870235_det.jpg
40955,Breakfast on Pluto,2005,1153341-breakfast_on_pluto,6.1,114,64,50,56,5.8,28,13,15,46,3.3,14498,73,http://content9.flixster.com/movie/25/05/250523_det.jpg
40959,The Ice Harvest,2005,harvest_2005,0,0,0,0,0,0,0,0,0,0,0,0,0,http://content6.flixster.com/movie/28/94/289424_det.jpg
40962,"Yours, Mine and Ours",2005,yours_mine_and_ours,3.3,105,6,99,5,3.7,28,1,27,3,3.2,36270,64,http://content6.flixster.com/movie/25/06/250608_det.jpg
40964,In the Mix,2005,in_the_mix,3.2,37,5,32,13,3.3,14,1,13,7,2.9,13084,48,http://content8.flixster.com/movie/25/06/250602_det.jpg
40966,The Libertine,2004,libertine,4.6,116,35,81,30,4.6,30,7,23,23,3.2,22316,57,http://content7.flixster.com/movie/25/06/250617_det.jpg
40969,First Descent,2005,first_descent,5.7,61,33,28,54,5.3,21,10,11,47,3,5006,54,http://content6.flixster.com/movie/11/14/69/11146940_det.jpg
40973,The Wild Geese,1978,wild_geese,6.8,5,3,2,60,0,0,0,0,0,0,0,0,http://content6.flixster.com/movie/26/68/266896_det.jpg
40988,Hondo,1953,hondo,7.1,5,4,1,80,0,0,0,0,0,0,0,0,http://content7.flixster.com/movie/29/05/290501_det.jpg
41014,L'uccello dalle piume di cristallo,1970,bird_with_the_crystal_plumage,7.5,21,19,2,90,0,3,2,1,66,3.7,1755,79,http://content9.flixster.com/movie/26/03/260391_det.jpg
41025,A Good Woman,2004,good_woman,5.3,81,30,51,37,5.6,25,8,17,32,2.7,9179,44,http://content9.flixster.com/movie/31/27/312707_det.jpg
41136,Taxi Driver,1976,taxi_driver,8.7,50,49,1,98,7.7,9,8,1,88,4.1,58145,93,http://content9.flixster.com/movie/10/91/39/10913987_det.jpg
41285,Match Point,2005,match_point,7.2,205,158,47,77,7.9,40,36,4,90,3.4,41276,78,http://content7.flixster.com/movie/10/89/54/10895469_det.jpg
41336,Nazar√≠n,1959,nazarin,7.8,10,8,2,80,0,2,0,2,0,4.1,418,87,http://content9.flixster.com/movie/35/41/23/3541239_det.jpg
41411,Inside Deep Throat,2005,inside_deep_throat,7,120,99,21,82,6.6,40,27,13,67,3.4,1737,61,http://content7.flixster.com/movie/28/55/285593_det.jpg
41425,The Dying Gaul,2005,dying_gaul,5.8,67,33,34,49,5.7,23,10,13,43,3.1,778,55,http://content6.flixster.com/movie/25/04/250496_det.jpg
41527,Paradise Now,2005,paradise_now,7.5,99,88,11,88,7.4,30,26,4,86,3.8,9101,81,http://content9.flixster.com/movie/25/04/250419_det.jpg
41564,The Kid & I,2005,kid_and_i,4.4,27,9,18,33,4.8,12,4,8,33,2.7,2087,40,http://content8.flixster.com/movie/26/82/97/2682974_det.jpg
41566,"The Chronicles of Narnia: The Lion, the Witch and the Wardrobe",2005,chronicles_of_narnia_lion_witch_wardrobe,6.9,206,156,50,75,7.1,38,29,9,76,3.1,260071,62,http://content8.flixster.com/movie/10/91/87/10918786_det.jpg
41569,King Kong,2005,king_kong,7.7,242,202,40,83,7.6,39,30,9,76,2.8,207337,52,http://content8.flixster.com/movie/10/93/36/10933606_det.jpg
41571,Memoirs of a Geisha,2005,memoirs_of_a_geisha,5.4,158,56,102,35,5.4,36,11,25,30,3.7,71263,82,http://content7.flixster.com/movie/10/89/12/10891225_det.jpg
41573,The Family Stone,2005,family_stone,5.9,151,79,72,52,6.1,35,21,14,60,3.2,49319,63,http://content9.flixster.com/movie/31/17/311715_det.jpg
41575,Wu ji,2005,1154356-promise,5.2,77,24,53,31,5.2,26,11,15,42,2.9,11585,41,http://content7.flixster.com/movie/10/86/15/10861597_det.jpg
41585,Kiss of Death,1995,1060720-kiss_of_death,6.4,36,24,12,66,7.2,12,9,3,75,2.9,2125,39,http://content6.flixster.com/movie/27/76/277616_det.jpg
41617,Havoc,2005,havoc,5.2,10,4,6,40,0,0,0,0,0,0,0,0,http://content8.flixster.com/movie/32/67/00/3267006_det.jpg
41627,J√¥i-uchi: Hairy√¥ tsuma shimatsu,1967,samurai_rebellion,7.4,7,7,0,100,0,2,2,0,100,4.1,907,91,http://content8.flixster.com/movie/10/93/54/10935442_det.jpg
41699,Ivan Groznyy: Skaz vmroy - Boyarskyy zagovor,1958,1112470-eisenstein,6.2,11,7,4,63,6.2,5,4,1,80,2.4,42,33,http://content8.flixster.com/movie/11/14/05/11140558_det.jpg
41716,Matador,1986,matador,7.2,16,15,1,93,7.3,5,4,1,80,3.7,5436,75,http://content6.flixster.com/movie/16/90/49/1690492_det.jpg
41721,Look Both Ways,2005,1161542-look_both_ways,6.6,56,43,13,76,6.8,20,16,4,80,3.5,2027,69,http://content7.flixster.com/movie/10/89/84/10898437_det.jpg
41769,Mozart and the Whale,2005,mozart_and_the_whale,0,3,2,1,66,0,2,2,0,100,3.8,3940,77,http://content8.flixster.com/movie/10/89/84/10898450_det.jpg
41831,They Died with Their Boots On,1941,they_died_with_their_boots_on,6.5,10,8,2,80,0,0,0,0,0,0,0,0,http://content6.flixster.com/movie/96/31/06/9631068_det.jpg
41863,The Three Burials of Melquiades Estrada,2005,three_burials_of_melquiades_estrada,7.4,136,115,21,84,7.5,33,26,7,78,3.7,7818,80,http://content7.flixster.com/movie/31/17/311713_det.jpg
41997,Munich,2005,munich,7.5,197,153,44,77,6.8,38,23,15,60,3.6,47552,78,http://content6.flixster.com/movie/11/12/73/11127320_det.jpg
42002,The Producers,2005,producers_the_movie_musical,5.8,150,76,74,50,5,36,10,26,27,3.1,31343,63,http://content7.flixster.com/movie/31/17/311717_det.jpg
42004,Transamerica,2005,transamerica,6.8,134,102,32,76,6.8,35,27,8,77,3.6,21396,77,http://content9.flixster.com/movie/52/17/521767_det.jpg
42007,Rumor Has It...,2005,rumor_has_it,4.4,110,22,88,20,4.2,30,4,26,13,3,41917,51,http://content9.flixster.com/movie/31/18/311803_det.jpg
42009,Cheaper by the Dozen 2,2005,cheaper_by_the_dozen_2,3.6,91,6,85,6,3.9,27,3,24,11,3.2,93712,64,http://content6.flixster.com/movie/10/87/02/10870276_det.jpg
42011,Fun with Dick and Jane,2005,fun_with_dick_and_jane,4.9,131,38,93,29,5.2,30,9,21,30,3.2,80127,58,http://content8.flixster.com/movie/31/17/311794_det.jpg
42013,The Ring,2002,ring,6.6,169,120,49,71,6.3,32,18,14,56,3,146246,50,http://content8.flixster.com/movie/10/86/94/10869458_det.jpg
42015,Casanova,2005,1156246-casanova,5.6,130,56,74,43,6,37,18,19,48,3.1,29998,57,http://content7.flixster.com/movie/31/18/311809_det.jpg
42018,Mrs Henderson Presents,2005,mrs_henderson_presents,6.6,136,90,46,66,6.7,36,26,10,72,3.3,11358,64,http://content8.flixster.com/movie/10/90/09/10900914_det.jpg
42021,The White Countess,2005,white_countess,6,87,44,43,50,6,27,15,12,55,2.9,8910,39,http://content6.flixster.com/movie/51/17/511748_det.jpg
42053,Dirty Love,2005,dirty_love,2.2,28,1,27,3,1.6,10,0,10,0,3.4,3700,67,http://content9.flixster.com/movie/10/92/39/10923995_det.jpg
42094,El esp√≠ritu de la colmena,1973,spirit_of_the_beehive,8.9,18,18,0,100,8.8,7,7,0,100,0,0,0,http://content7.flixster.com/movie/10/86/28/10862801_det.jpg
42197,Keeping Mum,2005,keeping_mum,5.9,85,48,37,56,5.9,25,15,10,60,3.6,6183,74,http://content9.flixster.com/movie/28/54/95/2854951_det.jpg
42213,"Goodnight, Mister Tom",1998,goodnight_mister_tom,0,0,0,0,0,0,0,0,0,0,0,0,0,http://content9.flixster.com/movie/10/90/80/10908003_det.jpg
42217,Banshun,1949,late_spring,8.8,17,17,0,100,0,3,3,0,100,4.3,1093,92,http://content8.flixster.com/movie/12/88/15/1288154_det.jpg
42418,The New World,2005,1152954-new_world,6.6,169,102,67,60,6.7,40,22,18,55,2.9,27173,51,http://content6.flixster.com/movie/52/18/521800_det.jpg
42556,7 Faces of Dr. Lao,1964,seven_faces_of_dr_lao,7.2,5,5,0,100,0,0,0,0,0,0,0,0,http://content7.flixster.com/movie/11/15/34/11153473_det.jpg
42602,The Boys of Baraka,2005,boys_of_baraka,6.8,42,31,11,73,6.8,13,10,3,76,4,627,84,http://content9.flixster.com/movie/72/91/87/7291875_det.jpg
42632,Chinjeolhan geumjassi,2005,1153496-lady_vengeance,7,84,62,22,73,7.3,22,18,4,81,4,23638,86,http://content7.flixster.com/movie/10/89/05/10890561_det.jpg
42634,Chlopaki nie placza,2000,,\N,\N,\N,\N,\N,\N,\N,\N,\N,\N,\N,\N,\N,\N
42681,49th Parallel,1941,49th_parallel,7.1,8,7,1,87,0,0,0,0,0,0,0,0,http://content7.flixster.com/movie/10/92/41/10924149_det.jpg
42718,Banlieue 13,2004,district_b13,7,108,87,21,80,6.7,29,23,6,79,3.6,25880,72,http://content6.flixster.com/movie/10/90/90/10909056_det.jpg
42721,BloodRayne,2005,bloodrayne,2.3,49,2,47,4,2.3,13,1,12,7,2.5,34745,31,http://content6.flixster.com/movie/52/91/529104_det.jpg
42723,Hostel,2005,hostel,5.8,100,59,41,59,5.6,16,6,10,37,3.1,72216,59,http://content6.flixster.com/movie/10/93/09/10930920_det.jpg
42725,Grandma's Boy,2006,grandmas_boy,3.7,60,11,49,18,2.8,16,1,15,6,3.8,55076,85,http://content6.flixster.com/movie/31/21/312192_det.jpg
42728,Tristan + Isolde,2006,10004209-tristan_and_isolde,4.9,121,39,82,32,5.3,30,13,17,43,3.4,53037,73,http://content9.flixster.com/movie/10/88/40/10884003_det.jpg
42730,Glory Road,2006,the-road2006,0,0,0,0,0,0,0,0,0,0,0,0,0,http://content9.flixster.com/movie/10/89/22/10892263_det.jpg
42732,Last Holiday,2006,10004662-last_holiday,5.8,114,62,52,54,6.1,27,16,11,59,3.3,31706,70,http://content6.flixster.com/movie/10/88/62/10886280_det.jpg
42734,Hoodwinked!,2005,1155109-hoodwinked,5.5,122,58,64,47,4.8,28,10,18,35,3.1,60552,58,http://content7.flixster.com/movie/31/21/312197_det.jpg
42736,April's Shower,2003,aprils-shower,3.6,14,3,11,21,4.2,9,3,6,33,2.6,750,37,http://content8.flixster.com/movie/31/22/312202_det.jpg
42738,Underworld: Evolution,2006,underworld_evolution,3.7,100,15,85,15,3.5,16,1,15,6,3.6,111035,77,http://content9.flixster.com/movie/31/24/312403_det.jpg
42740,Looking for Comedy in the Muslim World,2005,looking_for_comedy_in_the_muslim_world,5.4,108,46,62,42,5.4,30,11,19,36,2.5,4171,26,http://content8.flixster.com/movie/10/91/36/10913654_det.jpg
42783,Tini zabutykh predkiv,1964,shadows-of-forgotten-ancestors,8,16,16,0,100,8.8,5,5,0,100,4.4,312,91,http://content6.flixster.com/movie/10/87/92/10879260_det.jpg
42900,Cul-de-sac,1966,culdesac,7.5,14,12,2,85,0,4,2,2,50,3.8,1039,78,http://content8.flixster.com/movie/35/35/77/3535778_det.jpg
43011,The Dunwich Horror,1970,dunwich_horror,4.4,5,1,4,20,0,0,0,0,0,0,0,0,http://content8.flixster.com/movie/11/15/05/11150574_det.jpg
43333,Water,2005,water,7.6,89,81,8,91,7.8,30,28,2,93,3.9,14962,81,http://content6.flixster.com/movie/31/30/313096_det.jpg
43376,Sophie Scholl - Die letzten Tage,2005,sophie_scholl_die_letzten_tage,7.3,94,82,12,87,7.2,25,23,2,92,3.8,7998,83,http://content9.flixster.com/movie/10/90/69/10906903_det.jpg
43391,Matti,2006,matti,0,2,2,0,100,0,1,1,0,100,2.7,533,27,http://content7.flixster.com/movie/58/32/27/5832273_det.jpg
43396,The World's Fastest Indian,2005,worlds_fastest_indian,6.9,136,111,25,81,6.3,29,20,9,68,3.8,6841,88,http://content7.flixster.com/movie/45/46/05/4546057_det.jpg
43419,Bandidas,2006,bandidas,5.4,13,8,5,61,0,2,1,1,50,3,8063,47,http://content9.flixster.com/movie/10/89/81/10898123_det.jpg
43460,A Cock and Bull Story,2005,tristram_shandy_a_cock_and_bull_story,7.6,120,109,11,90,7.9,32,30,2,93,3.3,8622,60,http://content8.flixster.com/movie/10/85/61/10856178_det.jpg
43556,Annapolis,2006,annapolis,3.9,110,11,99,10,4.1,29,1,28,3,3.2,13763,64,http://content7.flixster.com/movie/31/24/312409_det.jpg
43558,Big Momma's House 2,2006,1154157-big_mommas_house_2,3.1,70,4,66,5,3.4,17,2,15,11,3.4,86119,69,http://content8.flixster.com/movie/55/05/61/5505610_det.jpg
43560,Nanny McPhee,2005,1153987-nanny_mcphee,6.6,130,95,35,73,6.4,29,19,10,65,3.2,48480,63,http://content7.flixster.com/movie/10/92/77/10927717_det.jpg
43679,Final Destination 3,2006,final_destination_3,5.1,114,51,63,44,5,25,8,17,32,3.4,76527,69,http://content6.flixster.com/movie/10/93/47/10934756_det.jpg
43684,Something New,2006,something_new,6.1,105,64,41,60,6.8,26,21,5,80,3.1,15411,65,http://content9.flixster.com/movie/31/27/312703_det.jpg
43708,Da Block Party,2004,da_block_party,0,0,0,0,0,0,0,0,0,0,0,0,0,http://content9.flixster.com/movie/10/86/57/10865791_det.jpg
43710,Madame Curie,1943,madame_curie,6.3,6,5,1,83,0,0,0,0,0,0,0,0,http://content8.flixster.com/movie/91/41/45/9141454_det.jpg
43744,Imagine Me & You,2005,imagine_me_and_you,4.9,94,30,64,31,4.7,23,5,18,21,3.4,21511,68,http://content9.flixster.com/movie/10/92/69/10926971_det.jpg
43836,The Pink Panther,2006,pink_panther,4.1,139,31,108,22,4.1,32,6,26,18,3,52976,59,http://content9.flixster.com/movie/10/87/61/10876159_det.jpg
43853,The Business,2005,10005666-business,5.8,6,3,3,50,0,0,0,0,0,0,0,0,http://content7.flixster.com/movie/31/31/313113_det.jpg
43869,Curious George,2006,1153951-curious_george,6.1,103,71,32,68,6.1,27,19,8,70,3.2,24897,65,http://content7.flixster.com/movie/10/94/34/10943485_det.jpg
43871,Firewall,2006,firewall,4.6,153,29,124,18,4.8,38,6,32,15,3,32315,48,http://content7.flixster.com/movie/31/26/312697_det.jpg
43899,Tony Takitani,2004,tony_takitani,7.4,52,46,6,88,8.1,17,17,0,100,3.9,1083,80,http://content9.flixster.com/movie/30/25/54/3025547_det.jpg
43904,When a Stranger Calls,2006,when_a_stranger_calls,3.2,88,8,80,9,3.1,14,1,13,7,3.1,53427,55,http://content9.flixster.com/movie/10/92/11/10921175_det.jpg
43906,Tamara,2005,tamara,4.3,28,9,19,32,4.7,8,2,6,25,2.7,7152,43,http://content7.flixster.com/movie/31/26/312601_det.jpg
43908,London,2005,1157247-london,3.3,36,5,31,13,2.7,14,0,14,0,2.9,7900,57,http://content6.flixster.com/movie/31/27/312700_det.jpg
43910,Neil Young: Heart of Gold,2006,heart_of_gold,8,97,87,10,89,7.9,32,28,4,87,2.9,12241,51,http://content6.flixster.com/movie/10/88/01/10880144_det.jpg
43912,Freedomland,2006,freedomland,4.6,148,34,114,22,4.7,36,13,23,36,2.7,15783,31,http://content6.flixster.com/movie/31/27/312712_det.jpg
43914,Winter Passing,2005,winter_passing,5.4,52,21,31,40,5.2,18,7,11,38,2.9,7599,57,http://content8.flixster.com/movie/10/88/14/10881410_det.jpg
43917,Eight Below,2006,eight_below,6.5,139,99,40,71,6.1,31,16,15,51,3.4,27593,80,http://content6.flixster.com/movie/31/28/312800_det.jpg
43919,Date Movie,2006,1155470-date_movie,2.4,83,5,78,6,2.7,15,2,13,13,2.8,89201,51,http://content8.flixster.com/movie/31/27/312710_det.jpg
43921,Running Scared,2006,10004288-running_scared,4.5,128,51,77,39,4.4,31,10,21,32,3.6,35992,77,http://content8.flixster.com/movie/31/27/312798_det.jpg
43923,Madea's Family Reunion,2006,madeas_family_reunion,4.5,53,14,39,26,4.9,17,7,10,41,3.7,23761,85,http://content9.flixster.com/movie/10/87/66/10876631_det.jpg
43926,Doogal,2006,1156283-doogal,3.1,49,4,45,8,2.6,15,0,15,0,2.5,8367,27,http://content7.flixster.com/movie/31/27/312721_det.jpg
43928,Ultraviolet,2006,10004504-ultraviolet,2.8,76,7,69,9,2.1,17,0,17,0,2.6,46298,42,http://content7.flixster.com/movie/31/27/312725_det.jpg
43930,Just My Luck,2006,just_my_luck,3.7,108,14,94,12,3.9,30,4,26,13,3,85958,60,http://content9.flixster.com/movie/10/89/89/10898939_det.jpg
43932,Pulse,2006,pulse,3.5,66,7,59,10,3.1,19,1,18,5,2.7,30788,38,http://content8.flixster.com/movie/78/63/786390_det.jpg
43934,Deep Sea,2006,deep_sea_3d,7.7,32,29,3,90,7,12,10,2,83,3.8,3812,75,http://content6.flixster.com/movie/27/36/72/2736720_det.jpg
43936,16 Blocks,2006,16_blocks,5.9,157,87,70,55,5.8,35,18,17,51,3.2,31478,60,http://content6.flixster.com/movie/31/28/312808_det.jpg
43987,Half Light,2006,half-light,4.1,7,2,5,28,0,0,0,0,0,0,0,0,http://content9.flixster.com/movie/10/91/82/10918207_det.jpg
44004,Failure to Launch,2006,failure_to_launch,4.6,147,37,110,25,5.2,33,13,20,39,3.2,86609,60,http://content6.flixster.com/movie/31/28/312892_det.jpg
44022,Ice Age: The Meltdown,2006,ice_age_2,6.1,142,82,60,57,6.2,27,16,11,59,3.6,162267,76,http://content7.flixster.com/movie/34/60/10/3460109_det.jpg
44058,The Big White,2005,1161913-big_white,4,10,3,7,30,0,2,0,2,0,3.3,2197,56,http://content7.flixster.com/movie/18/18/33/1818333_det.jpg
44073,Stromboli,1950,stromboli,6.5,5,4,1,80,0,0,0,0,0,0,0,0,http://content8.flixster.com/movie/83/83/94/8383942_det.jpg
44161,Free Zone,2005,1159177-free_zone,5,46,12,34,26,4.8,14,2,12,14,2.7,10638,26,http://content8.flixster.com/movie/10/89/81/10898182_det.jpg
44168,The Naked Spur,1953,naked_spur,8,11,11,0,100,0,1,1,0,100,3.8,668,77,http://content8.flixster.com/movie/34/87/43/3487438_det.jpg
44189,Ask the Dust,2006,ask_the_dust,5.1,103,37,66,35,5.5,32,16,16,50,2.8,14077,37,http://content7.flixster.com/movie/10/89/83/10898381_det.jpg
44191,V for Vendetta,2006,v_for_vendetta,6.8,233,169,64,72,6.2,37,23,14,62,3.9,226041,88,http://content9.flixster.com/movie/31/32/313291_det.jpg
44193,She's the Man,2006,im-doing-the-right-thing-with-the-wrong-man,0,0,0,0,0,0,0,0,0,0,0,0,0,http://content9.flixster.com/movie/10/89/81/10898199_det.jpg
44195,Thank You for Smoking,2005,thank_you_for_smoking,7.3,177,152,25,85,6.9,38,28,10,73,3.7,55103,84,http://content6.flixster.com/movie/31/32/313296_det.jpg
44197,Find Me Guilty,2006,find_me_guilty,6,104,62,42,59,6.2,32,17,15,53,3.1,19411,51,http://content8.flixster.com/movie/31/33/313322_det.jpg
44199,Inside Man,2006,inside_man,7.3,195,168,27,86,7.5,40,35,5,87,3.7,84980,81,http://content9.flixster.com/movie/10/89/84/10898419_det.jpg
44204,Tsotsi,2005,tsotsi,7.4,126,102,24,80,7.8,29,26,3,89,3.8,11397,83,http://content9.flixster.com/movie/31/27/312791_det.jpg
44225,Aquamarine,2006,aquamarine,5.5,86,45,41,52,5.6,27,15,12,55,3.1,60073,66,http://content8.flixster.com/movie/31/28/312810_det.jpg
44301,Laitakaupungin valot,2006,lights_in_the_dusk,6.4,37,25,12,67,5.5,12,6,6,50,3.6,1806,69,http://content9.flixster.com/movie/35/54/03/3554035_det.jpg
44397,The Hills Have Eyes,2006,hills_have_eyes,5.3,133,65,68,48,5,30,12,18,40,3.1,75042,64,http://content9.flixster.com/movie/10/91/33/10913327_det.jpg
44399,The Shaggy Dog,2006,shaggy_dog,4.4,103,28,75,27,4.8,29,10,19,34,2.9,41890,50,http://content9.flixster.com/movie/10/89/84/10898411_det.jpg
44494,Son of the Pink Panther,1993,son_of_the_pink_panther,2.8,18,3,15,16,0,2,0,2,0,2.5,1039,29,http://content7.flixster.com/movie/10/87/22/10872249_det.jpg
44511,Unknown White Male,2005,1155609-unknown_white_male,6.5,76,56,20,73,6.7,22,17,5,77,2.7,6598,42,http://images.rottentomatoescdn.com/images/defaults/poster_default.gif
44555,Das Leben der Anderen,2006,the_lives_of_others,8.2,148,138,10,93,8.3,43,41,2,95,4.4,48886,95,http://content7.flixster.com/movie/10/85/44/10854437_det.jpg
44587,Nanook of the North,1922,nanook-of-the-north,8.6,21,21,0,100,0,3,3,0,100,3.7,1130,77,http://content7.flixster.com/movie/29/93/299393_det.jpg
44595,Alien: Resurrection,1997,alien_resurrection,5.8,64,35,29,54,6.1,17,9,8,52,3,25498,50,http://content8.flixster.com/movie/10/92/14/10921410_det.jpg
44613,Take the Lead,2006,take_the_lead,5.4,119,52,67,43,5.2,31,12,19,38,3.5,92007,78,http://content9.flixster.com/movie/10/87/38/10873803_det.jpg
44633,The Devil and Daniel Johnston,2005,1158179-devil_and_daniel_johnston,7.5,105,93,12,88,7.9,28,26,2,92,3.7,11571,74,http://content8.flixster.com/movie/10/89/59/10895946_det.jpg
44653,L'argent,1983,largent,8.3,16,15,1,93,0,1,1,0,100,4,719,83,http://content8.flixster.com/movie/29/51/295198_det.jpg
44657,Mouchette,1967,mouchette-1967,7.3,11,9,2,81,0,3,2,1,66,4.2,975,89,http://content6.flixster.com/movie/28/18/39/2818396_det.jpg
44665,Lucky Number Slevin,2006,the-bruce-movie,0,0,0,0,0,0,0,0,0,0,0,0,0,http://content6.flixster.com/movie/10/84/20/10842040_det.jpg
44694,Volver,2006,volver,7.8,160,147,13,91,7.9,41,39,2,95,4,29813,88,http://content8.flixster.com/movie/12/88/34/1288346_det.jpg
44709,Akeelah and the Bee,2006,akeelah_and_the_bee,7,132,110,22,83,7,28,23,5,82,3.6,27397,74,http://content8.flixster.com/movie/10/84/08/10840854_det.jpg
44729,Larry the Cable Guy: Health Inspector,2006,larry_the_cable_guy_health_inspector,2.4,37,2,35,5,2.2,13,0,13,0,3.1,8141,66,http://content8.flixster.com/movie/31/37/313794_det.jpg
44731,Stay Alive,2006,10006370-stay_alive,3,57,5,52,8,2.8,14,1,13,7,3.3,40388,60,http://content8.flixster.com/movie/10/87/03/10870338_det.jpg
44759,Basic Instinct 2,2006,basic_instinct_2,3.1,149,10,139,6,3.2,35,1,34,2,2.5,28208,33,http://content8.flixster.com/movie/10/89/83/10898386_det.jpg
44761,Brick,2005,brick,7.1,134,106,28,79,7.1,31,25,6,80,3.9,44891,82,http://content6.flixster.com/movie/10/89/84/10898420_det.jpg
44777,Evil Aliens,2005,1184415-evil_aliens,5.6,10,6,4,60,0,0,0,0,0,0,0,0,http://content9.flixster.com/movie/10/89/82/10898271_det.jpg
44788,This Film Is Not Yet Rated,2006,this_film_is_not_yet_rated,7.2,115,96,19,83,7,35,28,7,80,3.7,11879,74,http://content9.flixster.com/movie/10/86/08/10860827_det.jpg
44815,ATL,2006,atl,5.9,86,54,32,62,5.7,29,17,12,58,4,55291,81,http://content7.flixster.com/movie/31/34/313493_det.jpg
44828,Slither,2006,slither,6.9,129,110,19,85,6.4,29,22,7,75,3.2,31835,58,http://content7.flixster.com/movie/31/35/313501_det.jpg
44840,The Benchwarmers,2006,benchwarmers,3.1,69,8,61,11,3.2,11,2,9,18,3.4,92722,71,http://content6.flixster.com/movie/31/36/313692_det.jpg
44844,Phat Girlz,2006,phat_girlz,3.8,43,10,33,23,4.1,13,4,9,30,3.2,19754,64,http://content6.flixster.com/movie/31/36/313696_det.jpg
44849,Renaissance,2006,renaissance,5.4,68,29,39,42,5.7,17,7,10,41,3.3,10097,58,http://content8.flixster.com/movie/26/57/52/2657526_det.jpg
44864,Friends with Money,2006,we-r-friends,0,0,0,0,0,0,0,0,0,0,0,0,0,http://content9.flixster.com/movie/10/84/18/10841867_det.jpg
44889,Reefer Madness: The Movie Musical,2005,10004941-reefer_madness,6.4,5,3,2,60,0,0,0,0,0,0,0,0,http://content6.flixster.com/movie/10/93/43/10934348_det.jpg
44911,Magic,1978,magic,6.8,18,15,3,83,0,2,1,1,50,3.2,1627,56,http://content7.flixster.com/movie/20/48/89/2048893_det.jpg
44929,Candy,2006,candy,5.8,74,36,38,48,6.1,24,14,10,58,3.8,9542,78,http://content8.flixster.com/movie/10/88/35/10883510_det.jpg
44937,L'enfant,2005,enfant,7.5,104,89,15,85,7.7,29,25,4,86,3.2,15237,54,http://content7.flixster.com/movie/10/89/84/10898421_det.jpg
44949,Hoot,2006,hoot,4.7,95,25,70,26,4.8,28,8,20,28,3.2,22689,58,http://content9.flixster.com/movie/31/41/314195_det.jpg
44972,Scary Movie 4,2006,scary_movie_4,4.7,125,46,79,36,5.1,23,10,13,43,3.1,149474,65,http://content8.flixster.com/movie/31/39/313998_det.jpg
44974,Hard Candy,2005,hard_candy,6.4,133,91,42,68,6.3,33,22,11,66,3.7,41391,76,http://content7.flixster.com/movie/31/40/314001_det.jpg
44978,Dead Birds,2004,1140781-dead_birds,5.9,7,4,3,57,0,0,0,0,0,0,0,0,http://content9.flixster.com/movie/10/92/06/10920615_det.jpg
45028,A Prairie Home Companion,2006,prairie_home_companion,7.1,188,153,35,81,6.7,39,28,11,71,3,24547,49,http://content8.flixster.com/movie/78/59/785962_det.jpg
45062,The Sentinel,2006,sentinel,5,134,44,90,32,5.1,32,11,21,34,3.1,26716,47,http://content8.flixster.com/movie/31/40/314022_det.jpg
45074,The Wild,2006,wild,4.5,111,21,90,18,4.8,30,8,22,26,3.1,59950,53,http://content6.flixster.com/movie/31/40/314000_det.jpg
45081,Silent Hill,2006,silent_hill,4.5,89,26,63,29,3,16,0,16,0,3.2,81448,65,http://content6.flixster.com/movie/31/40/314024_det.jpg
45106,American Dreams,2002,,\N,\N,\N,\N,\N,\N,\N,\N,\N,\N,\N,\N,\N,\N
45175,Kinky Boots,2005,kinky_boots,5.7,106,60,46,56,5.7,32,16,16,50,3.3,19339,63,http://content9.flixster.com/movie/31/40/314003_det.jpg
45183,Tom yum goong,2005,protector,5.6,90,50,40,55,5.4,23,11,12,47,3.6,21374,75,http://content9.flixster.com/movie/23/86/17/2386179_det.jpg
45186,Mission: Impossible III,2006,mission_impossible_3,6.6,217,152,65,70,6.2,42,26,16,61,3.3,86328,69,http://content6.flixster.com/movie/10/93/36/10933612_det.jpg
45208,RV,2006,1156340-rv,4.2,119,28,91,23,4,31,6,25,19,3,55493,59,http://content9.flixster.com/movie/31/41/314103_det.jpg
45210,United 93,2006,united_93,8.2,200,181,19,90,7.8,40,35,5,87,3.6,39922,76,http://content8.flixster.com/movie/31/41/314102_det.jpg
45221,Stick It,2006,stick_it,4.9,96,30,66,31,5,25,9,16,36,3.5,82123,76,http://content8.flixster.com/movie/31/40/314026_det.jpg
45335,Footlight Parade,1933,footlight_parade,8.4,8,8,0,100,0,0,0,0,0,0,0,0,http://content8.flixster.com/movie/50/90/89/5090890_det.jpg
45361,An American Haunting,2005,american_haunting,3.5,68,8,60,11,3.5,15,2,13,13,3,32251,48,http://content8.flixster.com/movie/10/87/72/10877250_det.jpg
45382,Down in the Valley,2005,down_in_the_valley,6,101,52,49,51,5.6,31,13,18,41,3,15861,47,http://content8.flixster.com/movie/10/90/59/10905930_det.jpg
45412,Kakushi ken oni no tsume,2004,hidden_blade,7.2,31,27,4,87,7.4,7,7,0,100,3.1,10744,50,http://content7.flixster.com/movie/10/37/88/1037881_det.jpg
45431,Over the Hedge,2006,over_the_hedge,6.8,163,121,42,74,6.3,34,22,12,64,3.6,155694,73,http://content8.flixster.com/movie/31/42/314214_det.jpg
45440,Art School Confidential,2006,art_school_confidential,5.4,133,47,86,35,5.4,33,14,19,42,3,9231,48,http://content9.flixster.com/movie/10/89/54/10895487_det.jpg
45442,Poseidon,2006,poseidon,4.9,196,65,131,33,4.8,39,11,28,28,3,65499,57,http://content9.flixster.com/movie/10/93/20/10932027_det.jpg
45447,The Da Vinci Code,2006,da_vinci_code,4.8,219,54,165,24,4.1,42,4,38,9,3.2,124708,64,http://content7.flixster.com/movie/31/42/314213_det.jpg
45499,X-Men: The Last Stand,2006,x_men_3_the_last_stand,5.9,227,129,98,56,5.6,42,22,20,52,3.6,198041,73,http://content7.flixster.com/movie/11/13/33/11133389_det.jpg
45501,The Break-Up,2006,break_up,5,187,62,125,33,4.5,40,8,32,20,3.1,107481,52,http://content8.flixster.com/movie/10/89/28/10892870_det.jpg
45503,Peaceful Warrior,2006,peaceful_warrior,4.7,72,17,55,23,4.2,23,3,20,13,3.5,16870,66,http://content6.flixster.com/movie/46/15/461532_det.jpg
45517,Cars,2006,cars,6.9,192,142,50,73,6.7,40,29,11,72,3.7,182909,80,http://content7.flixster.com/movie/10/92/20/10922005_det.jpg
45525,The Lost City,2005,10002516-lost_city,4.6,84,21,63,25,4.5,30,7,23,23,3.2,13324,50,http://content6.flixster.com/movie/11/14/23/11142384_det.jpg
45611,Vera Cruz,1954,vera_cruz,6.4,9,7,2,77,0,0,0,0,0,0,0,0,http://content6.flixster.com/movie/29/83/298308_det.jpg
45635,The Notorious Bettie Page,2005,notorious_betty_page,6,132,74,58,56,5.9,40,22,18,55,3.1,14609,46,http://content8.flixster.com/movie/10/93/59/10935954_det.jpg
45658,On a Clear Day,2005,1156415-on_a_clear_day,6.2,65,43,22,66,6.1,22,12,10,54,3.4,4873,60,http://content7.flixster.com/movie/10/89/83/10898389_det.jpg
45662,The Omen,1976,1015517-omen,7,32,27,5,84,0,2,1,1,50,3.5,17016,78,http://content6.flixster.com/movie/10/93/48/10934824_det.jpg
45664,The King,2005,the-king,6,77,43,34,55,6,25,13,12,52,3,14647,49,http://content6.flixster.com/movie/46/15/461520_det.jpg
45666,Nacho Libre,2006,nacho_libre,5.1,162,64,98,39,5,35,12,23,34,2.9,76491,57,http://content9.flixster.com/movie/45/20/452083_det.jpg
45668,The Lake House,2006,lake_house,5,154,55,99,35,4.9,40,11,29,27,3.5,118884,75,http://content8.flixster.com/movie/45/20/452082_det.jpg
45672,Click,2006,click,4.8,165,53,112,32,4.8,36,11,25,30,3.4,221348,72,http://content7.flixster.com/movie/10/88/98/10889889_det.jpg
45679,The Seventh Victim,1943,seventh_victim,7.4,11,10,1,90,0,2,1,1,50,3.6,499,68,http://content8.flixster.com/movie/10/83/91/10839154_det.jpg
45720,The Devil Wears Prada,2006,the_devil_wears_prada,6.6,183,138,45,75,6.9,42,35,7,83,3.6,163192,76,http://content9.flixster.com/movie/10/89/84/10898435_det.jpg
45722,Pirates of the Caribbean: Dead Man's Chest,2006,pirates_of_the_caribbean_dead_mans_chest,6,217,117,100,53,5.2,39,16,23,41,3.9,395865,86,http://content8.flixster.com/movie/78/63/786362_det.jpg
45726,"You, Me and Dupree",2006,you_me_and_dupree,4.3,164,34,130,20,4.2,36,4,32,11,3.2,90944,59,http://content8.flixster.com/movie/17/61/33/1761334_det.jpg
45728,Clerks II,2006,clerks_2,6.1,158,99,59,62,5.8,35,19,16,54,3.7,70058,83,http://content9.flixster.com/movie/10/93/69/10936947_det.jpg
45730,Lady in the Water,2006,lady_in_the_water,4.2,207,50,157,24,3.8,38,5,33,13,3,72266,54,http://content9.flixster.com/movie/10/89/48/10894807_det.jpg
45732,My Super Ex-Girlfriend,2006,my_super_ex_girlfriend,5.1,126,50,76,39,5.3,31,14,17,45,2.7,73211,43,http://content7.flixster.com/movie/10/87/22/10872241_det.jpg
45852,See No Evil,2006,1158185-see_no_evil,2.6,57,5,52,8,2.5,14,1,13,7,3.3,46137,61,http://content9.flixster.com/movie/31/42/314215_det.jpg
45880,Marie Antoinette,2006,1158195-marie_antoinette,6,175,96,79,54,6,40,20,20,50,3,59278,56,http://content8.flixster.com/movie/10/88/88/10888838_det.jpg
45928,Who Killed the Electric Car?,2006,who_killed_the_electric_car,7.2,103,91,12,88,7.1,30,28,2,93,3.6,16624,73,http://content8.flixster.com/movie/10/39/26/1039266_det.jpg
45950,An Inconvenient Truth,2006,inconvenient_truth,7.7,158,147,11,93,7.7,34,32,2,94,3.6,41842,75,http://content8.flixster.com/movie/46/15/461530_det.jpg
45981,Hollow Man II,2006,hollow_man_ii,0,4,0,4,0,0,0,0,0,0,0,0,0,http://content6.flixster.com/movie/17/95/05/1795052_det.jpg
46034,Kekexili,2004,mountain-patrol-kekexili,7.6,49,48,1,97,7.6,19,18,1,94,4,844,88,http://content8.flixster.com/movie/28/55/07/2855074_det.jpg
46062,High School Musical,2006,high_school_musical,5.4,8,5,3,62,0,0,0,0,0,0,0,0,http://content9.flixster.com/movie/10/89/47/10894779_det.jpg
46194,Adam & Steve,2005,1156352-adam_and_steve,5.5,38,21,17,55,5.3,17,9,8,52,2.9,13053,39,http://content8.flixster.com/movie/10/89/84/10898422_det.jpg
46231,Stoned,2005,stoned,4.1,47,7,40,14,3.7,17,1,16,5,3,12252,44,http://content8.flixster.com/movie/95/87/41/9587410_det.jpg
46258,Marked Woman,1937,marked_woman,0,4,4,0,100,0,0,0,0,0,0,0,0,http://content6.flixster.com/movie/94/19/30/9419304_det.jpg
46322,Huo Yuan Jia,2006,fearless-a-chinese-hero,0,0,0,0,0,0,0,0,0,0,0,0,0,http://content9.flixster.com/movie/10/85/48/10854871_det.jpg
46335,The Fast and the Furious: Tokyo Drift,2006,fast_and_the_furious_tokyo_drift,4.7,107,38,69,35,5.1,30,13,17,43,3.6,152700,80,http://content7.flixster.com/movie/10/89/31/10893121_det.jpg
46337,Garfield: A Tail of Two Kitties,2006,garfield_2,3.5,73,8,65,10,4.4,22,6,16,27,3.2,42950,60,http://content8.flixster.com/movie/29/59/16/2959162_det.jpg
46347,Metal: A Headbanger's Journey,2005,metal_a_headbangers_journey,6.9,29,26,3,89,6.6,10,9,1,90,4.1,3059,89,http://content9.flixster.com/movie/83/08/830895_det.jpg
46430,Waist Deep,2006,waist_deep,4.3,77,21,56,27,4.7,24,9,15,37,3.6,25532,74,http://content8.flixster.com/movie/45/20/452090_det.jpg
46530,Superman Returns,2006,superman_returns,7.1,254,193,61,75,6.8,43,31,12,72,3.3,112381,67,http://content6.flixster.com/movie/45/20/452092_det.jpg
46559,The Road to Guantanamo,2006,road_to_guantanamo,7.1,94,81,13,86,7,30,25,5,83,3.4,13498,63,http://content9.flixster.com/movie/10/89/10/10891003_det.jpg
46572,Edmond,2005,edmond,5.6,72,33,39,45,5.5,17,8,9,47,2.8,11822,37,http://content8.flixster.com/movie/17/63/79/1763798_det.jpg
46574,The Oh in Ohio,2006,1159100-oh_in_ohio,4.6,69,15,54,21,4.6,24,6,18,25,2.9,10204,36,http://content8.flixster.com/movie/17/63/82/1763826_det.jpg
46578,Little Miss Sunshine,2006,little_miss_sunshine,7.7,205,186,19,90,7.4,44,39,5,88,4,163418,90,http://content9.flixster.com/movie/18/56/91/1856911_det.jpg
46581,Brothers of the Head,2005,brothers_of_the_head,6.4,65,43,22,66,5.9,18,10,8,55,3,11333,42,http://content9.flixster.com/movie/10/89/42/10894211_det.jpg
46653,The 300 Spartans,1962,300_spartans,0,3,1,2,33,0,0,0,0,0,0,0,0,http://content6.flixster.com/movie/41/62/01/4162016_det.jpg
46664,The Fallen Idol,1948,fallen_idol,8.6,26,26,0,100,8.5,12,12,0,100,4,609,88,http://content6.flixster.com/movie/28/18/38/2818380_det.jpg
46723,Babel,2006,babel,6.7,192,132,60,68,6.6,42,27,15,64,3.5,86426,76,http://content9.flixster.com/movie/30/50/35/3050355_det.jpg
46772,Strangers with Candy,2005,1152191-strangers_with_candy,5.8,98,51,47,52,5.3,30,12,18,40,2.9,24171,49,http://content9.flixster.com/movie/10/39/22/1039223_det.jpg
46803,Young Mr. Lincoln,1939,,8.5,19,19,0,100,0,3,3,0,100,3.9,599,80,http://content8.flixster.com/movie/90/15/85/9015854_det.jpg
46839,Zui hao de shi guang,2005,zui-hao-de-shi-guang-three-times,7.8,50,43,7,86,7.8,21,18,3,85,3.6,1630,69,http://content7.flixster.com/movie/11/13/29/11132921_det.jpg
46850,Wordplay,2006,wordplay,7.4,120,114,6,95,7.3,36,35,1,97,3.2,12179,56,http://content9.flixster.com/movie/10/37/63/1037639_det.jpg
46855,L'arm√©e des ombres,1969,army-of-shadows-1969,8.6,72,70,2,97,8.4,22,21,1,95,4.4,2190,94,http://content6.flixster.com/movie/52/66/92/5266928_det.jpg
46865,Little Man,2006,little_man,3.2,89,11,78,12,3.9,24,6,18,25,3.1,78948,68,http://content7.flixster.com/movie/10/91/68/10916845_det.jpg
46901,The Purple Plain,1954,purple_plain,0,1,1,0,100,0,0,0,0,0,0,0,0,http://content8.flixster.com/movie/10/93/11/10931178_det.jpg
46919,End of the Spear,2005,end_of_the_spear,5.1,51,20,31,39,4.3,17,3,14,17,3.7,2835,82,http://content6.flixster.com/movie/10/87/81/10878116_det.jpg
46948,Monster House,2006,monster_house,6.8,156,115,41,73,6.2,35,24,11,68,3.2,42058,63,http://content9.flixster.com/movie/78/64/786475_det.jpg
46959,Colour Me Kubrick: A True...ish Story,2005,colour-me-kubrick,5.6,58,30,28,51,5.5,22,9,13,40,3.1,3512,43,http://content7.flixster.com/movie/10/86/96/10869625_det.jpg
46965,Snakes on a Plane,2006,snakes_on_a_plane,6.2,169,116,53,68,5.9,36,21,15,58,2.9,72394,55,http://content9.flixster.com/movie/10/88/23/10882311_det.jpg
46967,Scoop,2006,scoop,5.4,137,53,84,38,5.4,36,12,24,33,3.2,28506,56,http://content6.flixster.com/movie/10/94/61/10946196_det.jpg
46970,Talladega Nights: The Ballad of Ricky Bobby,2006,talladega_nights_the_ballad_of_ricky_bobby,6.5,182,131,51,71,6.7,39,27,12,69,3.4,130490,73,http://content8.flixster.com/movie/10/89/94/10899434_det.jpg
46972,Night at the Museum,2006,night_at_the_museum,5.3,129,56,73,43,5.3,29,12,17,41,3.6,169931,76,http://content8.flixster.com/movie/10/93/20/10932002_det.jpg
46974,World Trade Center,2006,world_trade_center,6.7,223,153,70,68,7,43,32,11,74,3.4,67835,67,http://content8.flixster.com/movie/18/57/15/1857154_det.jpg
46976,Stranger Than Fiction,2006,stranger_than_fiction,6.8,167,121,46,72,6.8,38,27,11,71,3.6,92551,82,http://content8.flixster.com/movie/10/92/11/10921174_det.jpg
47044,Miami Vice,2006,miami_vice,5.6,189,89,100,47,6.4,41,28,13,68,2.8,55637,48,http://content8.flixster.com/movie/78/65/786578_det.jpg
47049,Shadowboxer,2005,shadowboxer,4,57,11,46,19,3.6,21,2,19,9,2.9,11651,40,http://content9.flixster.com/movie/18/56/86/1856867_det.jpg
47099,The Pursuit of Happyness,2006,pursuit_of_happyness,6.4,166,110,56,66,6.1,38,25,13,65,4.1,211913,88,http://content8.flixster.com/movie/28/97/35/2897358_det.jpg
47117,Fah talai jone,2000,tears_of_the_black_tiger,6.6,61,46,15,75,7,18,15,3,83,3.7,894,73,http://content7.flixster.com/movie/10/86/88/10868885_det.jpg
47122,John Tucker Must Die,2006,john_tucker_must_die,4.3,92,23,69,25,4.2,26,4,22,15,3.6,194452,74,http://content7.flixster.com/movie/10/87/26/10872657_det.jpg
47124,The Ant Bully,2006,ant_bully,6.2,113,71,42,62,6.2,30,18,12,60,3.1,34181,51,http://content9.flixster.com/movie/18/56/91/1856919_det.jpg
47148,Mrs Palfrey at The Claremont,2005,mrs_palfrey_at_the_claremont,6.4,55,38,17,69,7,20,15,5,75,3.8,1500,77,http://content6.flixster.com/movie/10/90/09/10900916_det.jpg
47200,Crank,2006,crank,6,87,53,34,60,5,14,4,10,28,3.5,85861,72,http://content8.flixster.com/movie/10/87/49/10874942_det.jpg
47202,The Secret Life of Words,2005,secret_life_of_words,6.3,38,27,11,71,5.9,14,10,4,71,4.1,2452,87,http://content8.flixster.com/movie/25/05/20/2505206_det.jpg
47254,Chaos,2005,10006150-chaos,0,4,1,3,25,0,0,0,0,0,0,0,0,http://content9.flixster.com/movie/46/23/91/4623911_det.jpg
47261,The Night Listener,2006,the_night_listener,5.4,133,53,80,39,5.2,29,9,20,31,2.9,28560,36,http://content7.flixster.com/movie/18/57/11/1857117_det.jpg
47264,Barnyard,2006,barnyard_the_original_party_animals,4.4,92,21,71,22,5.1,26,9,17,34,3.3,56716,61,http://content8.flixster.com/movie/18/57/06/1857066_det.jpg
47274,Le souffle au coeur,1971,murmur_of_the_heart,8.3,9,8,1,88,0,1,1,0,100,4,1029,86,http://content9.flixster.com/movie/22/19/64/2219643_det.jpg
47306,I racconti di Canterbury,1972,canterbury_tales,6.8,7,5,2,71,0,1,0,1,0,3.5,627,63,http://content7.flixster.com/movie/10/88/33/10883329_det.jpg
47330,Dirty Mary Crazy Larry,1974,dirty_mary_crazy_larry,4.4,12,5,7,41,0,2,0,2,0,3.4,1249,66,http://content9.flixster.com/movie/25/45/254507_det.jpg
47382,Step Up,2006,step_up,4.5,99,19,80,19,4.5,27,6,21,22,3.9,236004,85,http://content7.flixster.com/movie/10/86/86/10868653_det.jpg
47384,Zoom,2006,zoom,3,58,2,56,3,2.7,15,0,15,0,3,23825,51,http://content7.flixster.com/movie/11/14/29/11142937_det.jpg
47394,"Bon Cop, Bad Cop",2006,10007333-bon_cop_bad_cop,6.1,6,4,2,66,0,2,2,0,100,3.8,4674,82,http://content7.flixster.com/movie/23/17/40/2317401_det.jpg
47423,Half Nelson,2006,half_nelson,7.6,151,136,15,90,7.9,35,33,2,94,3.8,16884,82,http://content7.flixster.com/movie/10/88/62/10886297_det.jpg
47446,La moustache,2005,moustache,7.3,41,35,6,85,7.4,18,16,2,88,3.4,1156,62,http://content9.flixster.com/movie/41/91/26/4191263_det.jpg
47465,Tideland,2005,tideland,4,73,21,52,28,2.8,21,1,20,4,3.3,15608,62,http://content8.flixster.com/movie/10/93/80/10938022_det.jpg
47493,Cabin in the Sky,1943,cabin_in_the_sky,6.9,10,8,2,80,0,0,0,0,0,0,0,0,http://content7.flixster.com/movie/98/52/18/9852189_det.jpg
47516,Material Girls,2006,material_girls,2.5,50,2,48,4,2.2,13,1,12,7,3,80733,57,http://content6.flixster.com/movie/21/37/15/2137152_det.jpg
47518,Accepted,2006,accepted,5,109,40,69,36,4.7,28,7,21,25,3.5,88251,75,http://content6.flixster.com/movie/10/88/98/10889888_det.jpg
47610,The Illusionist,2006,illusionist,6.9,178,131,47,73,7.3,37,32,5,86,3.8,105389,83,http://content9.flixster.com/movie/11/14/28/11142887_det.jpg
47615,Adventures of Don Juan,1948,adventures_of_don_juan,0,1,1,0,100,0,0,0,0,0,0,0,0,http://content8.flixster.com/movie/58/90/07/5890078_det.jpg
47629,The Queen,2006,queen,8.4,180,174,6,96,8.6,40,40,0,100,3.5,39506,74,http://content7.flixster.com/movie/10/89/17/10891733_det.jpg
47634,36 Quai des Orf√®vres,2004,thirty_six_quai_des_orfevres,7.5,5,5,0,100,0,0,0,0,0,0,0,0,http://content9.flixster.com/movie/10/87/15/10871551_det.jpg
47640,Beerfest,2006,beerfest,5,104,41,63,39,4.4,26,7,19,26,3.4,42736,76,http://content7.flixster.com/movie/21/92/34/2192341_det.jpg
47642,How to Eat Fried Worms,2006,how_to_eat_fried_worms,6,71,41,30,57,5.8,25,13,12,52,3,15503,51,http://content8.flixster.com/movie/10/91/74/10917454_det.jpg
47644,Invincible,2006,invincible,6.4,132,94,38,71,6.2,32,19,13,59,3.6,34698,75,http://content9.flixster.com/movie/21/92/35/2192351_det.jpg
47646,Idlewild,2006,idlewild,5.7,125,59,66,47,5.7,35,15,20,42,3.3,11257,63,http://content8.flixster.com/movie/21/92/34/2192346_det.jpg
47721,Le ballon rouge,1956,red_balloon,8.4,15,15,0,100,0,2,2,0,100,4.2,2073,90,http://content9.flixster.com/movie/29/72/45/2972455_det.jpg
47723,Way Out West,1937,way_out_west,8.5,7,7,0,100,0,0,0,0,0,0,0,0,http://content9.flixster.com/movie/31/30/313019_det.jpg
47725,Angel-A,2005,angela-2007,5.5,86,38,48,44,5.1,28,8,20,28,3.4,17241,73,http://content7.flixster.com/movie/10/89/25/10892593_det.jpg
47728,Green for Danger,1946,green_for_danger,7.6,10,8,2,80,0,2,1,1,50,3.8,410,81,http://content7.flixster.com/movie/31/92/49/3192493_det.jpg
47778,Quincea√±era,2006,quinceanera,7.1,94,81,13,86,6.9,30,25,5,83,3.2,9983,53,http://content9.flixster.com/movie/20/06/60/2006603_det.jpg
47793,The Puffy Chair,2005,enjoying-wine-with-mark-phillips2006,0,0,0,0,0,0,0,0,0,0,0,0,0,http://content6.flixster.com/movie/10/84/46/10844656_det.jpg
47805,Lassie,1994,1053155-lassie,6.8,8,6,2,75,0,2,2,0,100,2.9,2577,52,http://content8.flixster.com/movie/26/34/263402_det.jpg
47810,The Wicker Man,1973,1023637-wicker_man,7.7,45,41,4,91,0,4,4,0,100,3.6,8988,79,http://content7.flixster.com/movie/26/90/269021_det.jpg
47815,Crossover,2006,crossover,3.2,63,2,61,3,3.1,22,0,22,0,3.3,23508,61,http://content8.flixster.com/movie/10/84/07/10840774_det.jpg
47830,The Quiet,2005,the_quiet,4,93,20,73,21,3.5,26,3,23,11,3.1,10194,51,http://content8.flixster.com/movie/10/90/98/10909862_det.jpg
47836,Sketches of Frank Gehry,2005,sketches_of_frank_gehry,6.9,78,63,15,80,6.9,26,19,7,73,2.9,10414,41,http://content8.flixster.com/movie/31/42/314206_det.jpg
47894,The Wind That Shakes the Barley,2006,wind_that_shakes_the_barley,7.6,111,98,13,88,7.3,26,23,3,88,4,12108,86,http://content6.flixster.com/movie/10/84/04/10840436_det.jpg
47907,Sorstalans√°g,2005,1153570-fateless,7.9,63,58,5,92,8.3,20,19,1,95,3.4,5242,63,http://content6.flixster.com/movie/95/49/954948_det.jpg
47937,Severance,2006,severance,6,85,55,30,64,6.1,28,18,10,64,3.3,30894,62,http://content9.flixster.com/movie/64/27/07/6427075_det.jpg
47940,Le temps qui reste,2005,time_to_leave,6.6,50,38,12,76,6.6,16,12,4,75,3.4,8681,62,http://content6.flixster.com/movie/10/88/89/10888936_det.jpg
47950,Hollywoodland,2006,hollywoodland,6.5,178,122,56,68,6.5,37,23,14,62,3,27144,47,http://content6.flixster.com/movie/10/86/63/10866328_det.jpg
47952,The Covenant,2006,covenant,2.7,71,2,69,2,2.8,18,0,18,0,3.3,56344,68,http://content8.flixster.com/movie/23/86/16/2386162_det.jpg
47956,The Assassination of Jesse James by the Coward Robert Ford,2007,assassination_of_jesse_james_by_the_coward_robert_ford,7.1,162,121,41,74,6.6,36,22,14,61,3.7,57534,73,http://content8.flixster.com/movie/10/93/78/10937894_det.jpg
47970,The Last Kiss,2006,last_kiss,5.7,124,57,67,45,6,31,15,16,48,3.2,37077,59,http://content8.flixster.com/movie/10/88/16/10881610_det.jpg
47976,Trust the Man,2005,trust_the_man,4.6,100,27,73,27,4.5,25,3,22,12,2.9,11451,38,http://content8.flixster.com/movie/21/37/19/2137190_det.jpg
47978,SherryBaby,2006,fly-words-remembered,0,0,0,0,0,0,0,0,0,0,0,0,0,http://content7.flixster.com/movie/10/84/18/10841841_det.jpg
47997,Idiocracy,2006,idiocracy,6.5,40,29,11,72,5.4,5,3,2,60,3.2,21918,57,http://content9.flixster.com/movie/27/43/42/2743427_det.jpg
47999,Jesus Camp,2006,jesus_camp,7.2,97,84,13,86,7.2,24,21,3,87,3.6,17583,76,http://content9.flixster.com/movie/10/91/79/10917947_det.jpg
48032,La tigre e la neve,2005,tiger_and_the_snow,3.6,23,4,19,17,3.1,8,2,6,25,4.1,3393,84,http://content9.flixster.com/movie/10/92/19/10921939_det.jpg
48043,The Fountain,2006,,5.9,189,96,93,50,4.4,41,11,30,26,3.4,57823,73,http://content6.flixster.com/movie/21/54/18/2154184_det.jpg
48061,Snoopy Come Home,1972,snoopy-come-home,7.6,9,8,1,88,0,2,1,1,50,3.7,738,80,http://content8.flixster.com/movie/50/75/22/5075226_det.jpg
48082,La science des r√™ves,2006,the_science_of_sleep,6.6,153,107,46,69,6.5,34,23,11,67,3.8,53923,81,http://content6.flixster.com/movie/10/89/25/10892548_det.jpg
48142,The Black Dahlia,2006,black_dahlia,4.8,182,60,122,32,4.3,38,4,34,10,2.7,40782,32,http://content6.flixster.com/movie/11/14/62/11146256_det.jpg
48150,The Wood,1999,wood,6,56,34,22,60,5.7,17,10,7,58,3.9,6421,90,http://content7.flixster.com/movie/26/79/267909_det.jpg
48159,Everyone's Hero,2006,everyones_hero,5.1,66,26,40,39,5.6,25,11,14,44,3.1,15884,51,http://content7.flixster.com/movie/25/04/16/2504169_det.jpg
48161,Gridiron Gang,2006,gridiron_gang,5.6,99,41,58,41,5.2,26,8,18,30,3.7,74026,84,http://content8.flixster.com/movie/25/04/17/2504178_det.jpg
48198,Streamers,1983,streamers,6.1,9,5,4,55,0,2,0,2,0,3.2,136,49,http://content9.flixster.com/movie/10/83/90/10839027_det.jpg
48214,Land of Plenty,2004,1153319-land_of_plenty,6.3,25,16,9,64,6,7,4,3,57,3.5,683,63,http://content8.flixster.com/movie/10/90/27/10902750_det.jpg
48231,Taxidermia,2006,taxidermia,6.7,46,37,9,80,7.8,7,6,1,85,3.8,2168,78,http://content7.flixster.com/movie/10/88/79/10887901_det.jpg
48262,The Bridge,2006,1169498-bridge,6.4,55,37,18,67,7,15,13,2,86,3.7,3171,74,http://content7.flixster.com/movie/10/87/69/10876961_det.jpg
48301,The Private Life of Henry VIII.,1933,private_life_of_henry_viii,8,10,10,0,100,0,0,0,0,0,0,0,0,http://content7.flixster.com/movie/10/87/41/10874185_det.jpg
48304,Apocalypto,2006,apocalypto,6.3,184,117,67,63,5.8,43,25,18,58,3.7,132213,79,http://content7.flixster.com/movie/32/92/32/3292329_det.jpg
48319,Flyboys,2006,1161034-flyboys,4.9,126,41,85,32,4.1,30,5,25,16,3.4,25191,69,http://content8.flixster.com/movie/10/87/64/10876494_det.jpg
48322,Jackass Number Two,2006,jackass_number_2,5.8,103,65,38,63,5.6,24,14,10,58,3.6,75153,83,http://content8.flixster.com/movie/10/88/83/10888302_det.jpg
48326,All the King's Men,2006,,0,0,0,0,0,0,0,0,0,0,0,0,0,http://content6.flixster.com/movie/10/84/23/10842352_det.jpg
48342,Conversations with Other Women,2005,conversations_with_other_women,6.5,58,42,16,72,5.7,17,9,8,52,3.7,4754,74,http://content6.flixster.com/movie/10/89/81/10898112_det.jpg
48374,Otets Sergiy,1917,otets-sergiy-father-sergius,0,0,0,0,0,0,0,0,0,0,0,0,0,http://content7.flixster.com/movie/10/91/43/10914381_det.jpg
48385,Borat: Cultural Learnings of America for Make Benefit Glorious Nation of Kazakhstan,2006,borat,8,209,191,18,91,8.1,41,40,1,97,3.4,141091,76,http://content7.flixster.com/movie/32/05/57/3205577_det.jpg
48394,El laberinto del fauno,2006,pans_labyrinth,8.6,193,184,9,95,8.8,39,39,0,100,4.1,183647,90,http://content8.flixster.com/movie/10/86/20/10862042_det.jpg
48412,The Guardian,2006,guardian,5.2,143,54,89,37,5.2,34,11,23,32,3.7,58919,83,http://content8.flixster.com/movie/10/89/81/10898122_det.jpg
48414,Open Season,2006,open_season,5.4,98,46,52,46,5.7,24,13,11,54,3.4,91895,66,http://content8.flixster.com/movie/10/91/66/10916662_det.jpg
48416,School for Scoundrels,2006,school_for_scoundrels,4.6,137,35,102,25,4.5,32,8,24,25,3.2,39981,57,http://content7.flixster.com/movie/27/22/94/2722945_det.jpg
48516,The Departed,2006,departed,8.2,228,211,17,92,8,44,41,3,93,4.1,195210,92,http://content9.flixster.com/movie/10/93/80/10938015_det.jpg
48518,The Texas Chainsaw Massacre: The Beginning,2006,texas_chainsaw_massacre_the_beginning,3.5,79,10,69,12,3.1,14,1,13,7,3.2,72600,64,http://content7.flixster.com/movie/11/13/31/11133153_det.jpg
48520,Employee of the Month,2006,employee_of_the_month,4,88,18,70,20,3.9,25,4,21,16,3.2,54090,61,http://content7.flixster.com/movie/28/18/36/2818365_det.jpg
48522,Stormbreaker,2006,stormbreaker,4.7,65,21,44,32,4.7,23,8,15,34,3.3,16210,64,http://content6.flixster.com/movie/95/21/11/9521116_det.jpg
48560,Running with Scissors,2006,running_with_scissors,5,129,39,90,30,5,38,12,26,31,3.1,39912,55,http://content6.flixster.com/movie/97/36/08/9736088_det.jpg
48567,Public Enemies,2009,10009526-public_enemies,6.4,245,166,79,67,5.9,40,24,16,60,3.2,244294,65,http://content9.flixster.com/movie/11/15/34/11153475_det.jpg
48584,Ellie Parker,2005,ellie_parker,5.6,46,24,22,52,5.6,16,8,8,50,2.9,1159,41,http://content8.flixster.com/movie/25/05/250514_det.jpg
48591,The Grudge 2,2006,grudge_2,3.4,71,7,64,9,3.4,17,1,16,5,2.8,45131,57,http://content9.flixster.com/movie/27/09/95/2709951_det.jpg
48593,Man of the Year,2006,man_of_the_year,4.4,141,30,111,21,5,35,11,24,31,3,29127,51,http://content9.flixster.com/movie/11/12/89/11128939_det.jpg
48596,The Marine,2006,marine,4,45,9,36,20,4.5,11,3,8,27,3.2,48769,69,http://content6.flixster.com/movie/27/43/18/2743188_det.jpg
48598,Infamous,2006,infamous,6.8,145,104,41,71,6.7,37,26,11,70,3.3,9766,60,http://content7.flixster.com/movie/29/59/10/2959105_det.jpg
48600,One Night with the King,2006,one_night_with_the_king,4.3,25,4,21,16,4.4,9,2,7,22,3.9,8409,81,http://content6.flixster.com/movie/29/07/98/2907980_det.jpg
48649,Chapaev,1934,chapayev,0,0,0,0,0,0,0,0,0,0,0,0,0,http://content8.flixster.com/movie/11/15/31/11153110_det.jpg
48678,Feast,2005,feast,5.8,49,27,22,55,4.6,11,5,6,45,3.3,6353,62,http://content9.flixster.com/movie/10/87/63/10876395_det.jpg
48682,Offside,2006,offside,8,82,78,4,95,8.2,25,24,1,96,3.6,2373,71,http://content7.flixster.com/movie/76/01/54/7601549_det.jpg
48696,Little Children,2006,little_children,7.4,154,122,32,79,7.7,40,36,4,90,3.7,34155,79,http://content9.flixster.com/movie/10/63/40/10634003_det.jpg
48698,Deliver Us from Evil,2006,deliver_us_from_evil,8.4,69,69,0,100,8.2,25,25,0,100,3.7,8806,77,http://content9.flixster.com/movie/28/45/50/2845507_det.jpg
48711,Facing the Giants,2006,facing_the_giants,4.1,23,2,21,8,3.6,5,0,5,0,3.9,26252,85,http://content9.flixster.com/movie/10/89/96/10899663_det.jpg
48738,The Last King of Scotland,2006,last_king_of_scotland,7.3,177,154,23,87,7.4,40,36,4,90,3.8,58962,87,http://content9.flixster.com/movie/27/22/94/2722943_det.jpg
48741,The U.S. vs. John Lennon,2006,us_vs_john_lennon,6.6,94,72,22,76,6.5,29,20,9,68,3.6,8813,70,http://content6.flixster.com/movie/25/04/33/2504336_det.jpg
48744,Shortbus,2006,shortbus,6.4,119,78,41,65,5.8,37,21,16,56,3.7,15870,75,http://content8.flixster.com/movie/56/76/43/5676430_det.jpg
48774,Children of Men,2006,children_of_men,8,208,193,15,92,7.8,41,37,4,90,3.7,127695,81,http://content6.flixster.com/movie/27/04/67/2704676_det.jpg
48780,The Prestige,2006,prestige,7.1,187,141,46,75,6.2,40,23,17,57,3.9,138467,90,http://content7.flixster.com/movie/42/46/35/4246357_det.jpg
48783,Flags of Our Fathers,2006,flags_of_our_fathers,7,191,139,52,72,7.5,44,34,10,77,3.5,54914,70,http://content6.flixster.com/movie/29/82/53/2982532_det.jpg
48791,Flicka,2006,flicka,5.7,76,41,35,53,5.6,24,12,12,50,3.7,22360,82,http://content8.flixster.com/movie/29/93/87/2993874_det.jpg
48856,A Guide to Recognizing Your Saints,2006,a_guide_to_recognizing_your_saints,6.6,93,70,23,75,6.3,28,19,9,67,3.3,23093,67,http://content8.flixster.com/movie/10/92/97/10929790_det.jpg
48872,13 Tzameti,2005,13_tzameti,7,67,56,11,83,6.3,22,16,6,72,3.9,3433,84,http://content8.flixster.com/movie/10/87/30/10873098_det.jpg
48877,Saw III,2006,saw_3,4.2,83,21,62,25,3.2,18,1,17,5,3.7,159522,79,http://content8.flixster.com/movie/27/09/94/2709946_det.jpg
48879,Catch a Fire,2006,catch_a_fire,6.7,137,104,33,75,6.5,37,28,9,75,3.4,13062,64,http://content9.flixster.com/movie/30/59/83/3059839_det.jpg
48883,Death of a President,2006,death_of_a_president,5.3,99,36,63,36,4.7,33,7,26,21,3.2,5541,54,http://content6.flixster.com/movie/10/92/14/10921484_det.jpg
48899,Der Untertan,1951,,\N,\N,\N,\N,\N,\N,\N,\N,\N,\N,\N,\N,\N,\N
48909,The Beast with Five Fingers,1946,beast_with_five_fingers,6.5,9,7,2,77,0,1,1,0,100,0,0,0,http://content7.flixster.com/movie/11/12/58/11125869_det.jpg
48943,The Butterfly Effect 2,2006,butterfly_effect_2,0,1,1,0,100,0,0,0,0,0,0,0,0,http://content9.flixster.com/movie/11/14/18/11141871_det.jpg
48982,Flushed Away,2006,flushed_away,6.7,128,92,36,71,6.7,33,25,8,75,3.3,58694,68,http://content6.flixster.com/movie/10/88/03/10880388_det.jpg
48997,Perfume: The Story of a Murderer,2006,perfume_the_story_of_a_murderer,6.2,121,70,51,57,5.6,36,16,20,44,3.4,41387,74,http://content8.flixster.com/movie/95/33/09/9533098_det.jpg
49007,Arabesque,1966,arabesque,6.1,7,5,2,71,0,0,0,0,0,0,0,0,http://content6.flixster.com/movie/10/28/35/10283516_det.jpg
49013,The Santa Clause 3: The Escape Clause,2006,santa_clause_3,3.6,64,9,55,14,4.2,16,3,13,18,3.1,31916,59,http://content8.flixster.com/movie/29/42/66/2942662_det.jpg
49110,Mom and Dad Save the World,1992,mom_and_dad_save_the_world,2.2,9,1,8,11,0,0,0,0,0,0,0,0,http://content6.flixster.com/movie/99/45/74/9945744_det.jpg
49130,A Good Year,2006,good_year,4.8,126,30,96,23,4.8,37,11,26,29,3.3,22634,62,http://content7.flixster.com/movie/31/81/78/3181789_det.jpg
49132,Shut Up & Sing,2006,limit-21-realtime,0,0,0,0,0,0,0,0,0,0,0,0,0,http://content8.flixster.com/movie/10/88/37/10883742_det.jpg
49200,A Foreign Affair,1948,foreign_affair,7.6,9,9,0,100,0,2,2,0,100,3.7,504,75,http://content7.flixster.com/movie/10/73/93/10739337_det.jpg
49205,The Return,2006,return,3.9,55,8,47,14,3.9,15,2,13,13,2.9,26258,38,http://content6.flixster.com/movie/29/81/34/2981344_det.jpg
49220,For Your Consideration,2006,1159169-for_your_consideration,5.8,156,78,78,50,6.4,37,23,14,62,3,5643,44,http://content7.flixster.com/movie/11/15/02/11150245_det.jpg
49263,Fuck,2005,fuck,5.8,71,39,32,54,5.3,21,10,11,47,3.5,3961,68,http://content8.flixster.com/movie/32/27/58/3227586_det.jpg
49265,Shooting Dogs,2005,beyond-the-gates,7.2,60,50,10,83,6.5,18,13,5,72,3.9,11089,81,http://content9.flixster.com/movie/10/87/23/10872351_det.jpg
49272,Casino Royale,2006,casino_royale,7.8,214,202,12,94,7.8,43,41,2,95,3.9,155430,87,http://content9.flixster.com/movie/11/12/81/11128111_det.jpg
49274,Happy Feet,2006,happy_feet,6.9,158,117,41,74,6.9,36,30,6,83,3.6,194573,75,http://content9.flixster.com/movie/10/87/74/10877439_det.jpg
49276,Let's Go to Prison,2006,lets_go_to_prison,2.9,40,4,36,10,3.1,13,1,12,7,3.1,24118,51,http://content9.flixster.com/movie/10/91/53/10915383_det.jpg
49278,Deja Vu,2006,new-orleans-exposed-before-and-after-katrina,0,0,0,0,0,0,0,0,0,0,0,0,0,http://content6.flixster.com/movie/10/84/17/10841796_det.jpg
49280,Bobby,2006,1162559-bobby,5.6,167,77,90,46,5.6,39,18,21,46,3.6,13513,74,http://content7.flixster.com/movie/10/87/86/10878665_det.jpg
49282,Deck the Halls,2006,deck_the_halls,2.9,81,5,76,6,3.2,24,2,22,8,2.8,16598,45,http://content8.flixster.com/movie/35/59/47/3559474_det.jpg
49284,10 Items or Less,2006,10_items_or_less,6.1,59,36,23,61,5.7,24,13,11,54,3.3,11471,57,http://content6.flixster.com/movie/10/92/16/10921676_det.jpg
49286,The Holiday,2006,holiday_2006,0,0,0,0,0,0,0,0,0,0,0,0,0,http://content9.flixster.com/movie/10/88/62/10886279_det.jpg
49312,Snow Cake,2006,snow_cake,6.1,61,40,21,65,4.9,18,7,11,38,4,6153,85,http://content9.flixster.com/movie/34/10/56/3410563_det.jpg
49314,Harsh Times,2005,harsh_times,5.5,98,47,51,47,5.1,29,10,19,34,3.2,27914,56,http://content9.flixster.com/movie/22/60/09/2260099_det.jpg
49347,Fast Food Nation,2006,fast_food_nation,5.7,140,71,69,50,5.5,34,13,21,38,3,26331,43,http://content6.flixster.com/movie/10/86/86/10868604_det.jpg
49355,La b√™te humaine,1938,la-bete-humaine-judas-was-a-womanthe-human-beast,8,12,12,0,100,0,2,2,0,100,4,587,86,http://content6.flixster.com/movie/46/70/02/4670028_det.jpg
49396,Tenacious D in The Pick of Destiny,2006,tenacious_d_in_the_pick_of_destiny,5.7,119,64,55,53,5.5,34,16,18,47,3.3,63427,69,http://content8.flixster.com/movie/28/07/61/2807614_det.jpg
49422,"OSS 117: Le Caire, nid d'espions",2006,1197120-oss_117_cairo_nest_of_spies,6.6,56,42,14,75,6.2,14,8,6,57,3.7,2771,74,http://content8.flixster.com/movie/35/65/72/3565726_det.jpg
49524,The Nativity Story,2006,nativity_story,5.3,126,47,79,37,5.8,35,19,16,54,3.5,18145,74,http://content7.flixster.com/movie/25/07/70/2507701_det.jpg
49526,Van Wilder 2: The Rise of Taj,2006,van_wilder_2,2.7,44,3,41,6,2.9,18,1,17,5,3,24260,48,http://content7.flixster.com/movie/10/95/42/10954289_det.jpg
49528,Turistas,2006,turistas,3.8,100,16,84,16,4,28,6,22,21,2.8,21560,36,http://content9.flixster.com/movie/11/14/55/11145595_det.jpg
49530,Blood Diamond,2006,blood_diamond,6.3,209,130,79,62,6.4,43,29,14,67,4,155615,90,http://content7.flixster.com/movie/10/93/34/10933469_det.jpg
49571,Dracula's Daughter,1936,draculas_daughter,5.6,11,5,6,45,0,0,0,0,0,0,0,0,http://content8.flixster.com/movie/31/32/313214_det.jpg
49642,Unaccompanied Minors,2006,unaccompanied_minors,4.5,86,26,60,30,4,26,5,21,19,3.3,18555,62,http://content8.flixster.com/movie/36/52/09/3652090_det.jpg
49644,Off the Black,2006,off_the_black,6.2,40,27,13,67,6.4,17,13,4,76,3.3,1007,57,http://content8.flixster.com/movie/36/98/94/3698946_det.jpg
49647,Charlotte's Web,2006,charlottes_web,7,142,111,31,78,6.9,35,25,10,71,3.3,39179,67,http://content9.flixster.com/movie/31/82/33/3182335_det.jpg
49649,Eragon,2006,more-than-you2006,0,0,0,0,0,0,0,0,0,0,0,0,0,http://content9.flixster.com/movie/10/84/39/10843991_det.jpg
49651,Rocky Balboa,2006,rocky_balboa,6.5,173,131,42,75,6.4,36,27,9,75,3.5,88339,77,http://content6.flixster.com/movie/60/48/84/6048844_det.jpg
49666,Fur: An Imaginary Portrait of Diane Arbus,2006,fur,4.9,108,34,74,31,4.3,37,7,30,18,3.5,6462,64,http://content6.flixster.com/movie/36/73/18/3673180_det.jpg
49688,The Dam Busters,1955,dam_busters,8.6,5,5,0,100,0,0,0,0,0,0,0,0,http://content9.flixster.com/movie/10/88/00/10880023_det.jpg
49772,The Painted Veil,2006,painted_veil,7.1,143,106,37,74,7.3,35,26,9,74,3.9,20954,85,http://content8.flixster.com/movie/10/87/40/10874006_det.jpg
49793,We Are Marshall,2006,we_are_marshall,5.8,124,61,63,49,5.1,29,13,16,44,3.6,38195,81,http://content9.flixster.com/movie/36/05/18/3605183_det.jpg
49817,The Plague Dogs,1982,plague_dogs,0,1,1,0,100,0,0,0,0,0,0,0,0,http://content8.flixster.com/movie/10/88/24/10882422_det.jpg
49822,The Good Shepherd,2006,good_shepherd,6.1,167,90,77,53,6.3,38,21,17,55,3.1,51101,52,http://content8.flixster.com/movie/11/12/80/11128054_det.jpg
49824,Dreamgirls,2006,dreamgirls,7.2,200,156,44,78,7.4,44,38,6,86,3.5,87867,73,http://content6.flixster.com/movie/31/82/36/3182368_det.jpg
49856,La tourneuse de pages,2006,page_turner,6.8,63,49,14,77,6.9,19,13,6,68,3.5,2737,67,http://content8.flixster.com/movie/33/29/68/3329686_det.jpg
49910,Freedom Writers,2007,freedom_writers,6.3,121,84,37,69,6.4,32,22,10,68,3.9,77693,88,http://content6.flixster.com/movie/11/14/76/11147636_det.jpg
49932,Inland Empire,2006,inland_empire,7.1,101,73,28,72,6.4,25,13,12,52,3.8,17370,75,http://content7.flixster.com/movie/10/93/41/10934125_det.jpg
49957,The History Boys,2006,history_boys,6.4,104,66,38,63,6.4,35,21,14,60,3.5,10240,70,http://content9.flixster.com/movie/31/75/25/3175255_det.jpg
49961,Notes on a Scandal,2006,notes_on_a_scandal,7.5,167,145,22,86,8,36,33,3,91,3.7,22200,81,http://content7.flixster.com/movie/11/15/27/11152769_det.jpg
50003,DOA: Dead or Alive,2006,doa_dead_or_alive,4.5,44,15,29,34,4.2,10,2,8,20,2.7,71044,43,http://content7.flixster.com/movie/10/93/50/10935009_det.jpg
50005,Man cheng jin dai huang jin jia,2006,curse_of_the_golden_flower,6.4,120,79,41,65,6.4,34,20,14,58,3.5,17358,67,http://content9.flixster.com/movie/10/88/92/10889211_det.jpg
50011,Den brysomme mannen,2006,bothersome_man,6.6,21,15,6,71,7,6,5,1,83,3.9,2273,83,http://content8.flixster.com/movie/96/45/24/9645242_det.jpg
50064,The Good German,2006,good_german,5,146,47,99,32,5,40,12,28,30,2.9,14972,35,http://content8.flixster.com/movie/29/82/69/2982698_det.jpg
50066,Sweet Land,2005,sweet_land,7.3,70,59,11,84,7.5,23,20,3,86,3.9,2319,81,http://content6.flixster.com/movie/29/72/67/2972672_det.jpg
50068,Letters from Iwo Jima,2006,letters_from_iwo_jima,8.2,196,178,18,90,8.3,40,37,3,92,3.8,73433,85,http://content8.flixster.com/movie/10/88/05/10880558_det.jpg
50147,Black Christmas,2006,black-love,0,0,0,0,0,0,0,0,0,0,0,0,0,http://content9.flixster.com/movie/10/84/31/10843131_det.jpg
50149,Happily N'Ever After,2007,happily_never_after,3,80,3,77,3,3.5,23,0,23,0,2.9,50375,44,http://content7.flixster.com/movie/32/90/16/3290161_det.jpg
50151,Home of the Brave,2006,home_of_the_brave,4.1,56,12,44,21,4.8,17,6,11,35,3.2,13047,51,http://content7.flixster.com/movie/33/45/30/3345305_det.jpg
50153,Code Name: The Cleaner,2007,code_name_the_cleaner,2.9,81,3,78,3,3.5,20,2,18,10,2.8,15990,45,http://content7.flixster.com/movie/40/44/08/4044085_det.jpg
50158,Stomp the Yard,2007,stomp_the_yard,4.5,88,23,65,26,4.7,27,8,19,29,3.8,131307,83,http://content7.flixster.com/movie/10/89/40/10894045_det.jpg
50160,Miss Potter,2006,miss_potter,6.2,123,81,42,65,5.8,38,20,18,52,3.2,35425,67,http://content8.flixster.com/movie/38/32/15/3832150_det.jpg
50162,Arthur et les Minimoys,2006,10004659-arthur,4.5,90,19,71,21,4.2,25,4,21,16,3.2,25956,62,http://content8.flixster.com/movie/10/88/99/10889946_det.jpg
50189,American Pie Presents The Naked Mile,2006,american-pie-5-the-naked-mile,0,3,0,3,0,0,0,0,0,0,0,0,0,http://content9.flixster.com/movie/10/93/68/10936871_det.jpg
50229,Les demoiselles de Rochefort,1967,the-young-girls-of-rochefort,7.9,34,33,1,97,8.6,6,6,0,100,3.9,1140,82,http://content7.flixster.com/movie/25/20/252025_det.jpg
50253,David and Bathsheba,1951,david_and_bathsheba,0,0,0,0,0,0,0,0,0,0,0,0,0,http://content9.flixster.com/movie/86/21/33/8621331_det.jpg
50259,Old Joy,2006,old_joy,7.3,84,71,13,84,7.1,27,23,4,85,3.7,1584,75,http://content9.flixster.com/movie/53/81/15/5381151_det.jpg
50274,Venus,2006,venus,7.3,145,129,16,88,8,35,35,0,100,3.6,3984,73,http://content8.flixster.com/movie/33/33/29/3333294_det.jpg
50347,Rosario Tijeras,2005,rosario-tijeras,0,0,0,0,0,0,0,0,0,0,0,0,0,http://content8.flixster.com/movie/40/88/67/4088678_det.jpg
50354,Le retour de Don Camillo,1953,,\N,\N,\N,\N,\N,\N,\N,\N,\N,\N,\N,\N,\N,\N
50356,Don Camillo,1952,little_world_of_don_camillo,0,0,0,0,0,0,0,0,0,0,0,0,0,http://content6.flixster.com/movie/10/83/93/10839368_det.jpg
50440,Primeval,2007,primeval,3.6,52,10,42,19,3.5,13,2,11,15,2.7,14738,36,http://content8.flixster.com/movie/43/21/98/4321982_det.jpg
50442,Alpha Dog,2006,alpha_dog,5.5,141,78,63,55,5.6,36,20,16,55,3.3,59805,68,http://content9.flixster.com/movie/10/88/36/10883691_det.jpg
50445,The Hitcher,2007,hitcher,3.8,93,19,74,20,3.5,16,2,14,12,3.1,49309,59,http://content6.flixster.com/movie/10/86/94/10869428_det.jpg
50447,The Dead Girl,2006,dead_mary,0,3,1,2,33,0,0,0,0,0,0,0,0,http://content9.flixster.com/movie/54/87/49/5487491_det.jpg
50477,"Le testament d'Orph√©e, ou ne me demandez pas pourquoi!",1960,testament-of-orpheus,7.2,5,4,1,80,0,0,0,0,0,0,0,0,http://content9.flixster.com/movie/97/82/18/9782183_det.jpg
50514,Efter brylluppet,2006,after_the_wedding,7.4,101,88,13,87,7.6,30,27,3,90,3.7,12261,86,http://content6.flixster.com/movie/55/32/40/5532400_det.jpg
50583,Linda Linda Linda,2005,linda_linda_linda,6.9,9,7,2,77,0,4,3,1,75,4,833,86,http://content9.flixster.com/movie/61/72/77/6172779_det.jpg
50601,Bridge to Terabithia,2007,bridge_to_terabithia,7.2,143,122,21,85,7.2,27,23,4,85,3.4,97023,71,http://content8.flixster.com/movie/10/86/33/10863358_det.jpg
50619,Le sang d'un po√®te,1930,blood_of_a_poet,7.3,14,13,1,92,0,1,0,1,0,3.9,760,82,http://content6.flixster.com/movie/31/40/314016_det.jpg
50658,49 Up,2005,49_up,8.2,61,59,2,96,8.2,24,22,2,91,3.2,6671,57,http://content8.flixster.com/movie/28/45/47/2845474_det.jpg
50685,Waitress,2007,waitress,7.3,162,144,18,88,7.6,35,34,1,97,3.4,228321,67,http://content9.flixster.com/movie/62/22/42/6222427_det.jpg
50792,Catch and Release,2006,catch_and_release,4.5,131,28,103,21,4.5,33,9,24,27,3.2,45131,57,http://content7.flixster.com/movie/46/91/33/4691337_det.jpg
50794,Smokin' Aces,2006,smokin_aces,4.3,153,43,110,28,4,34,6,28,17,3.3,94720,64,http://content7.flixster.com/movie/10/88/33/10883345_det.jpg
50796,Blood and Chocolate,2007,blood_and_chocolate,3.6,73,8,65,10,3.3,17,1,16,5,3.1,38058,56,http://content6.flixster.com/movie/10/89/25/10892520_det.jpg
50798,Epic Movie,2007,epic_movie,2.3,62,1,61,1,2.6,15,1,14,6,2.5,152790,38,http://content7.flixster.com/movie/38/48/72/3848725_det.jpg
50800,The Messengers,2007,the_messengers,3.7,83,10,73,12,3.6,19,1,18,5,3.1,129304,48,http://content6.flixster.com/movie/10/89/27/10892764_det.jpg
50802,Because I Said So,2007,because_i_said_so,3.2,155,8,147,5,3.7,37,4,33,10,3.3,96755,68,http://content8.flixster.com/movie/42/14/48/4214486_det.jpg
50804,Hannibal Rising,2007,hannibal_rising,3.9,141,21,120,14,3.7,30,2,28,6,3.3,109979,61,http://content6.flixster.com/movie/10/93/72/10937236_det.jpg
50806,Norbit,2007,norbit,3.2,120,10,110,8,3.3,29,1,28,3,3.1,204857,56,http://content7.flixster.com/movie/10/89/85/10898541_det.gif
50842,Direkt√∏ren for det hele,2006,1174004-boss_of_it_all,6.5,63,46,17,73,7.1,17,14,3,82,3.6,2971,70,http://content7.flixster.com/movie/10/91/35/10913565_det.jpg
50851,Cocaine Cowboys,2006,10007598-cocaine_cowboys,6.4,49,34,15,69,6.1,17,10,7,58,3.3,18459,68,http://content9.flixster.com/movie/10/87/98/10879811_det.jpg
50858,Lonely Hearts,2006,lonely_hearts,5.6,42,20,22,47,5.5,14,7,7,50,3.2,4965,52,http://content6.flixster.com/movie/58/60/13/5860136_det.jpg
50872,Ratatouille,2007,ratatouille,8.4,213,205,8,96,8.3,42,41,1,97,3.9,414956,84,http://content6.flixster.com/movie/41/60/98/4160984_det.jpg
50898,Lola,1981,10002128-lola,8.1,6,6,0,100,0,1,1,0,100,3.9,529,82,http://content7.flixster.com/movie/10/83/83/10838329_det.jpg
50912,"Paris, je t'aime",2006,paris_je_taime,7,109,93,16,85,7,29,24,5,82,3.8,48639,83,http://content8.flixster.com/movie/10/88/65/10886558_det.jpg
50923,The Astronaut Farmer,2006,astronaut_farmer,6,134,77,57,57,5.9,31,18,13,58,3,30327,52,http://content9.flixster.com/movie/89/45/11/8945115_det.jpg
50970,Myra Breckinridge,1970,myra_breckinridge,4.4,21,6,15,28,0,3,0,3,0,2.8,407,39,http://content9.flixster.com/movie/21/88/82/2188827_det.jpg
51007,Indig√®nes,2006,10006917-days_of_glory,7.2,85,70,15,82,7.7,28,26,2,92,3.7,5161,77,http://content9.flixster.com/movie/36/98/94/3698947_det.jpg
51014,The Strange Case of Dr. Jekyll and Mr. Hyde,1968,1020270-1020270-strange_case_of_dr_jekyll_and_mr_hyde,0,0,0,0,0,0,0,0,0,0,0,0,0,http://content6.flixster.com/movie/11/12/32/11123212_det.jpg
51037,Unknown,2006,unknown,5.1,44,17,27,38,4.6,17,4,13,23,3.3,6616,57,http://content7.flixster.com/movie/32/66/88/3266889_det.jpg
51077,Ghost Rider,2007,ghost_rider,4.3,130,34,96,26,4.3,21,6,15,28,3.2,233712,56,http://content9.flixster.com/movie/11/13/32/11133251_det.jpg
51080,Breach,2007,breach,7,174,145,29,83,6.8,44,33,11,75,3.4,84757,65,http://content9.flixster.com/movie/93/67/98/9367983_det.jpg
51082,Daddy's Little Girls,2007,daddys_little_girls,4.8,52,14,38,26,5.4,20,8,12,40,3.9,88879,80,http://content7.flixster.com/movie/10/87/66/10876637_det.jpg
51084,Music and Lyrics,2007,music_and_lyrics,6,163,102,61,62,6.4,33,28,5,84,3.4,109147,70,http://content7.flixster.com/movie/10/90/52/10905277_det.jpg
51086,The Number 23,2007,the_number_23,3.5,186,15,171,8,3.6,37,3,34,8,3.2,101409,61,http://content6.flixster.com/movie/10/86/16/10861632_det.jpg
51088,Reno 911!: Miami,2007,reno_911_miami,5,95,33,62,34,5,24,8,16,33,3,48867,52,http://content9.flixster.com/movie/10/91/75/10917575_det.jpg
51091,Black Snake Moan,2006,black_snake_moan,6.3,152,100,52,65,5.7,39,19,20,48,3.3,48404,70,http://content8.flixster.com/movie/43/15/80/4315802_det.jpg
51094,Gray Matters,2006,gray_matters,3.8,64,5,59,7,3.5,21,1,20,4,3.1,5341,47,http://content8.flixster.com/movie/49/01/36/4901362_det.jpg
51127,loudQUIETloud: A Film About the Pixies,2006,loudquietloud_a_film_about_the_pixies,6.2,21,14,7,66,5.2,7,2,5,28,3.8,484,77,http://content7.flixster.com/movie/99/22/34/9922345_det.jpg
51174,Factory Girl,2006,factory_girl,4.7,112,21,91,18,4.6,36,5,31,13,3.3,24687,60,http://content6.flixster.com/movie/36/59/78/3659788_det.jpg
51255,Hot Fuzz,2007,hot_fuzz,7.7,194,176,18,90,7.2,39,36,3,92,4,177532,88,http://content7.flixster.com/movie/57/50/84/5750845_det.jpg
51277,Shao Lin san shi liu fang,1978,36th-chamber-of-shaolin-shao-lin-san-shi-liu-fang,0,1,0,1,0,0,0,0,0,0,0,0,0,http://content9.flixster.com/movie/11/12/46/11124615_det.jpg
51304,Karla,2006,1168275-karla,3.4,12,0,12,0,0,3,0,3,0,2.9,1042,38,http://content7.flixster.com/movie/15/95/50/1595505_det.jpg
51314,Nuovomondo,2006,golden_door,6.8,86,62,24,72,6.9,27,18,9,66,3.6,2001,68,http://content9.flixster.com/movie/10/92/21/10922135_det.jpg
51372,Cats,1998,cats_the_musical,4.2,5,1,4,20,0,0,0,0,0,0,0,0,http://content9.flixster.com/movie/10/91/11/10911119_det.jpg
51412,Next,2007,next,4.6,128,36,92,28,4.2,21,5,16,23,3.2,60971,59,http://content9.flixster.com/movie/66/03/26/6603263_det.jpg
51418,Breaking and Entering,2006,breaking_and_entering,5.2,124,42,82,33,5.2,37,11,26,29,3.2,28113,52,http://content6.flixster.com/movie/35/11/98/3511988_det.jpg
51471,Amazing Grace,2006,10007415-amazing_grace,6.6,118,83,35,70,6.6,31,20,11,64,4,24835,85,http://content6.flixster.com/movie/49/01/32/4901328_det.jpg
51498,2001 Maniacs,2005,,\N,\N,\N,\N,\N,\N,\N,\N,\N,\N,\N,\N,\N,\N
51540,Zodiac,2007,zodiac,7.6,226,202,24,89,7,48,39,9,81,3.5,90179,73,http://content7.flixster.com/movie/34/10/49/3410497_det.jpg
51562,Babylon 5: The Gathering,1993,babylon-5-the-gathering,0,0,0,0,0,0,0,0,0,0,0,0,0,http://content9.flixster.com/movie/10/91/84/10918499_det.jpg
51575,Wild Hogs,2007,wild_hogs,3.8,139,20,119,14,3.4,34,3,31,8,3.4,86633,72,http://content6.flixster.com/movie/44/00/87/4400876_det.jpg
51638,The Westerner,1940,westerner,0,4,4,0,100,0,0,0,0,0,0,0,0,http://content8.flixster.com/movie/73/51/39/7351390_det.jpg
51660,The Ultimate Gift,2006,ultimate_gift,5.1,58,19,39,32,4.6,14,3,11,21,4.1,16774,85,http://content6.flixster.com/movie/53/29/82/5329820_det.jpg
51662,300,2006,300,6.1,223,133,90,59,5.6,41,19,22,46,4.1,476879,90,http://content7.flixster.com/movie/28/60/90/2860905_det.jpg
51666,Abandon,2002,abandon,4.3,109,18,91,16,4.1,26,6,20,23,2.7,2670,37,http://content7.flixster.com/movie/26/67/266793_det.jpg
51678,Julius Caesar,2002,caesar,0,1,0,1,0,0,0,0,0,0,0,0,0,http://content9.flixster.com/movie/10/88/24/10882463_det.jpg
51694,Starter for 10,2006,starter_for_ten,6.9,74,66,8,89,6.9,23,19,4,82,3.4,6446,64,http://content7.flixster.com/movie/10/87/09/10870929_det.jpg
51698,The Last Mimzy,2007,mimzy,5.8,122,65,57,53,5.8,28,14,14,50,3.1,37595,58,http://content8.flixster.com/movie/55/33/40/5533406_det.jpg
51705,Hors de prix,2006,priceless,6.9,70,57,13,81,6.6,17,13,4,76,3.7,9304,74,http://content8.flixster.com/movie/10/83/92/10839238_det.jpg
51709,Gwoemul,2006,host,7.7,144,133,11,92,7.8,37,35,2,94,3.4,41174,69,http://content6.flixster.com/movie/89/03/27/8903276_det.jpg
51834,Becoming Jane,2007,becoming_jane,6,134,78,56,58,6.2,33,19,14,57,3.7,77694,75,http://content7.flixster.com/movie/89/45/22/8945229_det.jpg
51857,A Taste of Honey,1961,taste_of_honey,7,10,8,2,80,0,3,2,1,66,4,686,86,http://content8.flixster.com/movie/10/87/98/10879842_det.jpg
51884,The Namesake,2006,namesake,7.5,124,106,18,85,7.6,33,28,5,84,3.7,28074,78,http://content9.flixster.com/movie/52/52/97/5252975_det.jpg
51903,I Think I Love My Wife,2007,i-love-this-movie,0,0,0,0,0,0,0,0,0,0,0,0,0,http://content6.flixster.com/movie/10/84/20/10842004_det.jpg
51911,The Fugitive Kind,1960,fugitive_kind,6.4,10,6,4,60,0,0,0,0,0,0,0,0,http://content8.flixster.com/movie/10/43/31/10433130_det.jpg
51925,Premonition,2007,premonition,3.8,161,13,148,8,4.3,37,6,31,16,3.1,84740,55,http://content6.flixster.com/movie/52/52/29/5252296_det.jpg
51927,Dead Silence,2007,dead_silence,3.9,73,15,58,20,4.2,13,4,9,30,3.2,53019,57,http://content6.flixster.com/movie/10/92/35/10923568_det.jpg
51931,Reign Over Me,2007,reign_over_me,6.3,149,94,55,63,6.6,35,22,13,62,3.8,58189,81,http://content8.flixster.com/movie/10/91/88/10918874_det.jpg
51933,Pride,2007,pride,5.5,107,49,58,45,5.5,34,15,19,44,3.6,27617,73,http://content8.flixster.com/movie/10/95/41/10954118_det.jpg
51935,Shooter,2007,shooter,5.6,142,68,74,47,5.6,39,18,21,46,3.8,120688,82,http://content8.flixster.com/movie/10/87/80/10878010_det.jpg
51937,The Hills Have Eyes II,2007,hills_have_eyes_2,3.2,64,7,57,10,3.6,16,2,14,12,2.9,63799,50,http://content6.flixster.com/movie/10/91/33/10913320_det.jpg
51939,TMNT,2007,teenage_mutant_ninja_turtles,5,114,38,76,33,4.4,22,4,18,18,3.2,86247,63,http://content8.flixster.com/movie/10/86/05/10860502_det.jpg
51991,Italianetz,2005,italian,7.2,93,85,8,91,7.3,29,27,2,93,3.3,9946,67,http://content9.flixster.com/movie/10/89/11/10891127_det.jpg
52005,Jindabyne,2006,jindabyne,6.4,94,61,33,64,5.9,27,14,13,51,3.1,3036,50,http://content9.flixster.com/movie/21/52/63/2152639_det.jpg
52037,Fauteuils d'orchestre,2006,avenue_montaigne,6.5,95,71,24,74,7.2,29,27,2,93,3.5,8387,64,http://content6.flixster.com/movie/47/95/51/4795512_det.jpg
52042,Zwartboek,2006,10007417-black_book,7.1,147,112,35,76,7,36,28,8,77,4,14532,87,http://content9.flixster.com/movie/10/92/04/10920443_det.jpg
52101,Shizukanaru kett√¥,1949,quiet_duel,0,1,1,0,100,0,0,0,0,0,0,0,0,http://content9.flixster.com/movie/66/23/08/6623083_det.jpg
52227,The Darwin Awards,2006,darwin_awards,4.9,12,3,9,25,0,3,0,3,0,3.1,2472,48,http://content9.flixster.com/movie/10/93/19/10931943_det.jpg
52241,The Lookout,2007,lookout,7.3,163,142,21,87,7.2,34,29,5,85,3.5,29621,71,http://content7.flixster.com/movie/44/93/14/4493141_det.jpg
52245,Blades of Glory,2007,blades_of_glory,6.2,183,127,56,69,6.4,40,27,13,67,3.4,665973,66,http://content9.flixster.com/movie/53/82/55/5382551_det.jpg
52279,Are We Done Yet?,2007,are_we_done_yet,3.3,93,7,86,7,3.8,24,4,20,16,3.2,59360,61,http://content6.flixster.com/movie/63/32/95/6332952_det.jpg
52281,Grindhouse,2007,grindhouse,7.4,188,155,33,82,7.1,40,31,9,77,3.9,98721,86,http://content6.flixster.com/movie/52/53/62/5253624_det.jpg
52283,The Reaping,2007,reaping,3.5,130,11,119,8,3.8,26,2,24,7,3.2,39427,54,http://content6.flixster.com/movie/32/92/28/3292280_det.jpg
52285,Firehouse Dog,2007,firehouse_dog,4.9,81,31,50,38,5,25,11,14,44,3.4,23925,68,http://content6.flixster.com/movie/49/98/28/4998280_det.jpg
52287,Meet the Robinsons,2007,meet_the_robinsons,6.3,135,89,46,65,6.3,31,19,12,61,3.5,80580,75,http://content9.flixster.com/movie/34/49/54/3449543_det.jpg
52321,Seraphim Falls,2006,seraphim_falls,5.7,81,44,37,54,5.2,19,8,11,42,3.3,4135,55,http://content9.flixster.com/movie/37/48/09/3748095_det.jpg
52328,Sunshine,2007,ignite_2007,0,0,0,0,0,0,0,0,0,0,0,0,0,http://content6.flixster.com/movie/10/84/17/10841740_det.jpg
52352,Judge Priest,1934,judge_priest,0,3,3,0,100,0,0,0,0,0,0,0,0,http://content6.flixster.com/movie/10/83/81/10838164_det.jpg
52356,Copying Beethoven,2006,copying_beethoven,4.7,79,20,59,25,5.3,21,7,14,33,3.4,850,60,http://content7.flixster.com/movie/10/85/74/10857429_det.jpg
52375,The Hoax,2006,the-hoax2006,0,0,0,0,0,0,0,0,0,0,0,0,0,http://content7.flixster.com/movie/10/84/17/10841797_det.jpg
52413,To vlemma tou Odyssea,1995,ulysses-gaze,5.2,15,6,9,40,0,4,2,2,50,4,697,88,http://content8.flixster.com/movie/29/63/296398_det.jpg
52435,How the Grinch Stole Christmas,2000,how_the_grinch_stole_christmas,5.6,127,67,60,52,5.2,31,16,15,51,3.1,34926,57,http://content9.flixster.com/movie/25/55/255591_det.jpg
52448,Goya's Ghosts,2006,goyas_ghosts,4.8,84,24,60,28,4.7,26,8,18,30,3.3,20033,59,http://content6.flixster.com/movie/87/30/61/8730616_det.jpg
52456,Perfect Stranger,2007,1171939-perfect_stranger,3.5,141,15,126,10,3.7,35,4,31,11,3.2,43661,57,http://content7.flixster.com/movie/10/92/11/10921173_det.jpg
52458,Disturbia,2007,disturbia,6.2,168,115,53,68,6,35,23,12,65,3.7,701373,75,http://content7.flixster.com/movie/10/88/67/10886753_det.jpg
52460,Pathfinder,2007,pathfinder,3.6,75,8,67,10,3.5,21,1,20,4,2.9,39732,42,http://content9.flixster.com/movie/68/78/51/6878519_det.jpg
52462,Aqua Teen Hunger Force Colon Movie Film for Theaters,2007,aqua_teen_hunger_force_colon_movie_film_for_theatres,5.1,83,39,44,46,5.2,28,14,14,50,3.5,12293,68,http://content7.flixster.com/movie/61/11/86/6111861_det.jpg
52545,Puccini for Beginners,2006,puccini_for_beginners,5.6,62,31,31,50,5.7,25,13,12,52,3.2,328,47,http://content6.flixster.com/movie/10/89/62/10896236_det.jpg
52561,Yihe yuan,2006,yihe-yuan,6.2,28,19,9,67,6.6,10,8,2,80,3.4,653,59,http://content8.flixster.com/movie/10/83/85/10838562_det.jpg
52579,La m√¥me,2007,stalags,5.8,12,6,6,50,0,4,1,3,25,3.8,33,80,http://content9.flixster.com/movie/10/84/43/10844375_det.jpg
52591,The Contract,2006,1177488-contract,4.3,5,0,5,0,0,0,0,0,0,0,0,0,http://content6.flixster.com/movie/10/88/96/10889636_det.jpg
52604,Fracture,2007,fracture,6.5,163,115,48,70,6.7,39,30,9,76,3.5,129211,71,http://content7.flixster.com/movie/56/99/63/5699633_det.jpg
52606,Big Nothing,2006,big_nothing,0,3,3,0,100,0,0,0,0,0,0,0,0,http://content9.flixster.com/movie/10/86/03/10860311_det.jpg
52644,Vacancy,2007,vacancy,5.5,119,66,53,55,5.5,26,15,11,57,3,51558,46,http://content6.flixster.com/movie/54/29/62/5429620_det.jpg
52666,Benny's Video,1992,bennys_video,5.3,6,2,4,33,0,0,0,0,0,0,0,0,http://content9.flixster.com/movie/85/95/859535_det.jpg
52668,In the Land of Women,2007,in_the_land_of_women,5.4,114,50,64,43,5.2,33,15,18,45,3.2,37584,54,http://content6.flixster.com/movie/54/85/19/5485192_det.jpg
52694,Mr. Bean's Holiday,2007,mr_beans_holiday,5.4,109,55,54,50,5.6,29,15,14,51,2.9,95541,53,http://content9.flixster.com/movie/96/79/30/9679307_det.jpg
52712,The Invisible,2007,1169203-invisible,4.1,57,12,45,21,4.3,14,3,11,21,3.3,49604,61,http://content9.flixster.com/movie/36/25/84/3625847_det.jpg
52715,Kickin It Old Skool,2007,a-history-of-dj-krush,0,0,0,0,0,0,0,0,0,0,0,0,0,http://content9.flixster.com/movie/10/90/66/10906627_det.jpg
52717,The Condemned,2007,condemned,3.5,99,15,84,15,3.3,28,3,25,10,3.4,27981,63,http://content9.flixster.com/movie/52/53/61/5253611_det.jpg
52722,Spider-Man 3,2007,spiderman_3,6.2,239,150,89,62,5.4,45,18,27,40,3.3,1192712,54,http://content8.flixster.com/movie/10/93/21/10932122_det.jpg
52724,Lucky You,2007,lucky_you,5,138,40,98,28,4.9,34,8,26,23,2.8,26515,33,http://content9.flixster.com/movie/10/91/98/10919807_det.jpg
52767,21,1977,21_up,0,1,1,0,100,0,0,0,0,0,0,0,0,http://content8.flixster.com/movie/10/89/43/10894342_det.jpg
52838,Year of the Dog,2007,year_of_the_dog,6.4,141,98,43,69,7.1,37,30,7,81,2.9,6288,43,http://content8.flixster.com/movie/10/87/65/10876578_det.jpg
52867,Fast Track,2006,fast-track-the-ex,4.4,100,19,81,19,4.2,30,4,26,13,2.8,24933,36,http://content6.flixster.com/movie/70/43/07/7043072_det.jpg
52885,Papurika,2006,paprika,7.2,86,71,15,82,7.3,27,22,5,81,4,13141,87,http://content6.flixster.com/movie/37/34/07/3734076_det.jpg
52929,Red Road,2006,red_road,7.3,84,74,10,88,7.7,21,18,3,85,3.6,3304,69,http://content8.flixster.com/movie/10/87/95/10879538_det.jpg
52950,Dnevnoy dozor,2006,day_watch,5.9,95,60,35,63,6.2,23,18,5,78,3.5,13807,69,http://content9.flixster.com/movie/75/28/34/7528347_det.jpg
52952,This Is England,2006,this_is_england,7.7,87,81,6,93,7.6,24,22,2,91,4.1,25557,89,http://content7.flixster.com/movie/92/34/67/9234673_det.jpg
52967,Away from Her,2006,away_from_her,8.1,140,132,8,94,8.2,37,37,0,100,3.6,15253,80,http://content8.flixster.com/movie/10/87/11/10871162_det.jpg
52973,Knocked Up,2007,what_up,0,1,0,1,0,0,0,0,0,0,0,0,0,http://content8.flixster.com/movie/10/88/41/10884170_det.jpg
52975,Hairspray,2007,hairspray,7.7,205,186,19,90,8,41,40,1,97,3.9,382832,84,http://content6.flixster.com/movie/87/30/58/8730580_det.jpg
53000,28 Weeks Later,2007,28_weeks_later,6.6,182,128,54,70,7,39,30,9,76,3.4,266576,66,http://content6.flixster.com/movie/10/86/37/10863760_det.jpg
53002,Georgia Rule,2007,georgia_rule,3.8,116,20,96,17,3.4,30,2,28,6,3,64056,55,http://content8.flixster.com/movie/63/82/23/6382238_det.jpg
53004,Delta Farce,2007,delta_farce,2.6,44,2,42,4,3.1,12,1,11,8,2.8,23589,45,http://content7.flixster.com/movie/10/88/75/10887545_det.jpg
53038,Red Dust,2004,10004812-red_dust,0,4,4,0,100,0,0,0,0,0,0,0,0,http://content9.flixster.com/movie/23/66/77/2366779_det.jpg
53121,Shrek the Third,2007,shrek_3,5.5,203,83,120,40,5.7,39,19,20,48,3.4,1369685,57,http://content9.flixster.com/movie/59/86/40/5986403_det.jpg
53123,Once,2006,once,8.3,152,147,5,96,8.4,37,37,0,100,4.1,49591,90,http://content7.flixster.com/movie/67/94/95/6794957_det.jpg
53125,Pirates of the Caribbean: At World's End,2007,pirates_of_the_caribbean_3,5.4,213,95,118,44,5.2,40,14,26,35,3.8,1768593,74,http://content6.flixster.com/movie/10/95/55/10955508_det.jpg
53127,Bug,2006,bug,6.2,128,76,52,59,6.6,36,24,12,66,2.5,168834,31,http://content6.flixster.com/movie/69/50/07/6950072_det.jpg
53129,Mr. Brooks,2007,mr_brooks,5.7,151,84,67,55,5.3,33,16,17,48,3.6,270348,75,http://content6.flixster.com/movie/62/49/06/6249064_det.jpg
53131,4: Rise of the Silver Surfer,2007,fantastic_four_2_rise_of_the_silver_surfer,4.8,165,60,105,36,4.5,34,11,23,32,3.2,470350,55,http://content9.flixster.com/movie/10/89/16/10891607_det.jpg
53133,Gracie,2007,gracie,5.8,90,53,37,58,5.4,32,16,16,50,3.3,80050,61,http://content7.flixster.com/movie/10/87/43/10874365_det.jpg
53143,Fay Grim,2006,,5.4,86,38,48,44,4.8,26,8,18,30,3.1,8851,57,http://content8.flixster.com/movie/64/94/85/6494850_det.jpg
53161,Saibogujiman kwenchana,2006,im_a_cyborg_but_thats_ok,6.3,7,6,1,85,0,1,1,0,100,3.9,4852,80,http://content6.flixster.com/movie/11/15/06/11150696_det.jpg
53189,Eagle vs Shark,2007,eagle_vs_shark,5.6,104,56,48,53,5.4,26,12,14,46,3.5,24010,67,http://content6.flixster.com/movie/84/26/08/8426084_det.jpg
53207,88 Minutes,2007,88_minutes,2.6,120,6,114,5,2.7,29,1,28,3,3.2,37899,51,http://content9.flixster.com/movie/10/88/61/10886183_det.jpg
53318,Cashback,2006,cashback,5.4,49,23,26,46,5.8,17,10,7,58,3.8,24862,79,http://content7.flixster.com/movie/91/21/03/9121037_det.jpg
53322,Ocean's Thirteen,2007,oceans_thirteen,6.4,195,136,59,69,6,43,25,18,58,3.6,846364,74,http://content6.flixster.com/movie/46/92/23/4692232_det.jpg
53326,Ils,2006,ils,6,50,30,20,60,6,12,6,6,50,3.4,4394,62,http://content8.flixster.com/movie/10/91/34/10913458_det.jpg
53349,Ten Canoes,2006,ten_canoes,7.7,59,58,1,98,7.4,18,18,0,100,3.7,2471,75,http://content8.flixster.com/movie/10/94/57/10945754_det.jpg
53355,Sonnenallee,1999,sun_alley,0,0,0,0,0,0,0,0,0,0,0,0,0,http://content6.flixster.com/movie/89/54/42/8954420_det.jpg
53435,Hostel: Part II,2007,hostel_2,5.1,106,48,58,45,4.6,21,9,12,42,3,282438,45,http://content8.flixster.com/movie/67/36/99/6736994_det.jpg
53447,Paranoid Park,2007,paranoid_park,6.9,112,85,27,75,7.1,25,20,5,80,3.5,9375,66,http://content8.flixster.com/movie/10/09/73/10097322_det.jpg
53450,Sleepy Hollow,1999,sleepy_hollow,6.3,124,84,40,67,6.2,30,20,10,66,3.5,93949,79,http://content9.flixster.com/movie/26/69/266927_det.jpg
53460,Surf's Up,2007,surfs_up,6.6,141,109,32,77,7,31,26,5,83,3.4,372345,64,http://content6.flixster.com/movie/52/53/54/5253548_det.jpg
53464,4: Rise of the Silver Surfer,2007,fantastic_four_2_rise_of_the_silver_surfer,4.8,165,60,105,36,4.5,34,11,23,32,3.2,470350,55,http://content9.flixster.com/movie/10/89/16/10891607_det.jpg
53466,Nancy Drew,2007,nancy_drew,5.5,134,66,68,49,5.7,36,20,16,55,3.4,111522,62,http://content8.flixster.com/movie/42/46/30/4246302_det.jpg
53468,Fido,2006,fido,6.4,69,49,20,71,6.2,16,11,5,68,3.6,27143,70,http://content9.flixster.com/movie/10/22/46/10224643_det.jpg
53476,L'iceberg,2005,l-iceberg,6.5,32,22,10,68,6.2,11,8,3,72,3.6,492,70,http://content8.flixster.com/movie/70/09/25/7009250_det.jpg
53519,Death Proof,2007,death_proof,5.8,35,23,12,65,0,2,2,0,100,3.6,52006,73,http://content8.flixster.com/movie/89/42/19/8942194_det.jpg
53550,Rescue Dawn,2006,rescue_dawn,7.5,156,140,16,89,7.7,37,32,5,86,3.5,46938,73,http://content8.flixster.com/movie/87/30/52/8730522_det.jpg
53574,The TV Set,2006,tv_set,6.3,75,48,27,64,6.5,27,19,8,70,3.3,3053,57,http://content6.flixster.com/movie/61/76/12/6176124_det.jpg
53578,La doublure,2006,valet,6.6,81,56,25,69,6.9,29,22,7,75,3.5,3807,66,http://content8.flixster.com/movie/29/72/65/2972650_det.jpg
53737,The Night of the Generals,1967,night_of_the_generals,0,3,2,1,66,0,0,0,0,0,0,0,0,http://content6.flixster.com/movie/10/86/72/10867248_det.jpg
53769,In Search of a Midnight Kiss,2007,in_search_of_a_midnight_kiss,7,59,50,9,84,7.1,22,19,3,86,3.8,2278,79,http://content9.flixster.com/movie/10/92/40/10924023_det.jpg
53835,Il mio viaggio in Italia,1999,my_voyage_to_italy,8.3,20,20,0,100,0,4,4,0,100,3.9,769,82,http://content8.flixster.com/movie/25/91/259198_det.jpg
53883,The Power of Nightmares: The Rise of the Politics of Fear,2004,power_of_nightmares_the_rise_of_the_politics_of_fear,8.1,7,6,1,85,8,5,4,1,80,4.5,575,96,http://content6.flixster.com/movie/10/89/72/10897244_det.jpg
53887,O Lucky Man!,1973,o_lucky_man,7.6,17,14,3,82,0,2,1,1,50,0,0,0,http://content9.flixster.com/movie/10/89/82/10898279_det.jpg
53894,Sicko,2007,sicko,7.8,199,185,14,92,7.4,43,38,5,88,3.8,93379,87,http://content8.flixster.com/movie/75/30/61/7530614_det.jpg
53921,A Mighty Heart,2007,mighty_heart,7,188,147,41,78,7.2,44,37,7,84,3.5,55538,70,http://content6.flixster.com/movie/70/42/07/7042076_det.jpg
53953,1408,2007,1408,6.7,165,129,36,78,6.7,32,25,7,78,3.4,349462,61,http://content9.flixster.com/movie/85/59/06/8559063_det.jpg
53956,Death at a Funeral,2007,the-funeral2007,0,0,0,0,0,0,0,0,0,0,0,0,0,http://content7.flixster.com/movie/10/84/16/10841681_det.jpg
53972,Live Free or Die Hard,2007,live_free_or_die_hard,6.8,197,161,36,81,6.7,38,30,8,78,3.9,1145097,86,http://content8.flixster.com/movie/10/93/34/10933482_det.jpg
53974,License to Wed,2007,1175072-license_to_wed,3.1,122,9,113,7,3.3,26,2,24,7,3.2,197792,55,http://content8.flixster.com/movie/67/06/61/6706618_det.jpg
53988,Evening,2007,evening,4.9,124,34,90,27,4.8,31,8,23,25,3.1,49054,49,http://content9.flixster.com/movie/65/63/36/6563363_det.jpg
53993,Evan Almighty,2007,evan_almighty,4.5,190,44,146,23,4,39,3,36,7,3.2,369422,56,http://content8.flixster.com/movie/62/22/37/6222374_det.jpg
53996,Transformers,2007,real-the-movie2005,0,0,0,0,0,0,0,0,0,0,0,0,0,http://content8.flixster.com/movie/10/91/83/10918394_det.jpg
53999,Captivity,2007,captivity,2.7,73,5,68,6,2,15,0,15,0,2.8,42072,32,http://content7.flixster.com/movie/10/88/94/10889481_det.jpg
54001,Harry Potter and the Order of the Phoenix,2007,harry_potter_and_the_order_of_the_phoenix,6.8,234,182,52,77,6.7,41,28,13,68,3.9,1449179,82,http://content8.flixster.com/movie/95/11/30/9511306_det.jpg
54004,I Now Pronounce You Chuck & Larry,2007,i_now_pronounce_you_chuck_and_larry,3.6,154,21,133,13,3.8,34,4,30,11,3.6,920014,73,http://content8.flixster.com/movie/91/19/52/9119522_det.jpg
54075,Arn - Tempelriddaren,2007,,\N,\N,\N,\N,\N,\N,\N,\N,\N,\N,\N,\N,\N,\N
54094,Driving Lessons,2006,1167633-driving_lessons,5.2,75,36,39,48,5.3,23,11,12,47,3.2,22883,67,http://content8.flixster.com/movie/10/86/17/10861778_det.jpg
54116,First Snow,2006,first_snow,5.9,72,41,31,56,6.2,20,12,8,60,3,2700,42,http://content9.flixster.com/movie/10/88/66/10886635_det.jpg
54190,Across the Universe,2007,across_the_universe,5.8,151,80,71,52,5.9,30,15,15,50,4,133408,84,http://content6.flixster.com/movie/10/94/44/10944464_det.jpg
54193,Broken English,2007,broken_english,6.3,73,47,26,64,6.2,23,14,9,60,3.4,14630,61,http://content9.flixster.com/movie/10/88/86/10888655_det.jpg
54196,Brand Upon the Brain! A Remembrance in 12 Chapters,2006,brand_upon_the_brain,8,47,43,4,91,7.9,17,16,1,94,4,1698,84,http://content8.flixster.com/movie/10/88/22/10882274_det.jpg
54256,Hot Rod,2007,hot_rod,4.9,101,40,61,39,4.7,25,7,18,28,3.3,69065,64,http://content6.flixster.com/movie/85/17/00/8517008_det.jpg
54259,Stardust,2007,stardust,6.8,182,138,44,75,6.7,36,24,12,66,3.9,192854,86,http://content8.flixster.com/movie/87/30/70/8730702_det.jpg
54268,Who's Your Caddy?,2007,whos_your_caddy,2.3,32,2,30,6,2.9,10,1,9,10,3.4,32708,61,http://content9.flixster.com/movie/92/25/27/9225275_det.jpg
54270,Skinwalkers,2006,skinwalkers,3.5,36,5,31,13,2.8,11,0,11,0,2.7,28787,33,http://content7.flixster.com/movie/10/94/07/10940769_det.jpg
54272,The Simpsons Movie,2007,simpsons_movie,7.5,190,170,20,89,7.3,39,32,7,82,3.7,1305720,78,http://content7.flixster.com/movie/10/84/37/10843725_det.jpg
54274,I Know Who Killed Me,2007,i_know_who_killed_me,2.1,67,5,62,7,2.1,18,1,17,5,2.5,61978,29,http://content9.flixster.com/movie/92/34/63/9234635_det.jpg
54276,No Reservations,2007,no_reservations,5.2,157,63,94,40,5.2,34,12,22,35,3.4,112453,64,http://content7.flixster.com/movie/10/87/90/10879049_det.jpg
54278,Underdog,2007,underdog,4,67,10,57,14,4,15,3,12,20,3.1,58055,48,http://content9.flixster.com/movie/43/13/34/4313347_det.jpg
54281,Charlie Bartlett,2007,charlie_bartlett,5.8,130,73,57,56,6,29,15,14,51,3.5,29271,73,http://content6.flixster.com/movie/87/30/68/8730680_det.jpg
54284,El cantante,2006,el_cantante,4.8,103,25,78,24,4.6,29,7,22,24,3.5,4858,64,http://content8.flixster.com/movie/10/87/41/10874186_det.jpg
54286,The Bourne Ultimatum,2007,bourne_ultimatum,7.9,228,213,15,93,8.1,39,38,1,97,4.1,1312487,91,http://content6.flixster.com/movie/89/15/87/8915876_det.jpg
54290,Bratz,2007,bratz_the_movie,2.9,71,5,66,7,3.2,23,2,21,8,3,27511,51,http://content7.flixster.com/movie/89/45/26/8945261_det.jpg
54328,Mon meilleur ami,2006,1175074-my_best_friend,6.6,85,64,21,75,6.6,29,22,7,75,3.5,5539,65,http://content8.flixster.com/movie/10/89/00/10890062_det.jpg
54331,You Kill Me,2007,1178913-1178913-you_kill_me,6.6,112,87,25,77,6.8,30,24,6,80,3.3,17284,60,http://content7.flixster.com/movie/11/14/85/11148501_det.jpg
54372,Ne le dis √† personne,2006,ne_le_dis_a_personne,7.6,103,96,7,93,7.9,25,24,1,96,3.9,11817,86,http://content8.flixster.com/movie/10/88/11/10881194_det.jpg
54419,Cesk√Ω sen,2004,czech-dream-cesky-sen,6.6,24,19,5,79,6.8,7,6,1,85,3.7,434,74,http://content9.flixster.com/movie/46/02/47/4602479_det.jpg
54503,Superbad,2007,superbad,7.4,198,173,25,87,7.2,41,35,6,85,4.1,315252,87,http://content7.flixster.com/movie/95/64/71/9564717_det.jpg
54505,Arctic Tale,2007,arctic_tale,5.8,94,57,37,60,5.4,25,13,12,52,3.5,16362,63,http://content8.flixster.com/movie/87/30/65/8730658_det.jpg
54510,Joshua,2007,joshua,6.3,97,61,36,62,6.9,31,24,7,77,2.9,13913,40,http://content6.flixster.com/movie/10/85/48/10854820_det.jpg
54513,Talk to Me,2007,talk_to_me,6.9,124,101,23,81,7,32,25,7,78,3.6,16542,77,http://content9.flixster.com/movie/71/57/69/7157699_det.jpg
54612,Resurrecting the Champ,2007,resurrecting_the_champ,6,116,69,47,59,5.5,30,15,15,50,3.4,18572,62,http://content8.flixster.com/movie/10/89/16/10891638_det.jpg
54621,Moli√®re,2007,10008005-moliere,6.5,85,60,25,70,6.1,19,11,8,57,3.7,6884,76,http://content9.flixster.com/movie/67/00/55/6700555_det.jpg
54648,Rush Hour 3,2007,rush_hour_3,4.2,155,30,125,19,4.4,29,6,23,20,3.5,270729,68,http://content9.flixster.com/movie/94/51/35/9451359_det.jpg
54686,The Last Legion,2007,last_legion,4,54,9,45,16,4,14,1,13,7,2.9,36434,39,http://content6.flixster.com/movie/95/64/66/9564664_det.jpg
54691,Lady Chatterley,2006,10008097-lady_chatterley,6.7,83,62,21,74,7.7,22,19,3,86,3.3,1401,59,http://content7.flixster.com/movie/11/12/63/11126329_det.jpg
54732,Balls of Fury,2007,balls_of_fury,4.2,127,29,98,22,4.5,24,8,16,33,2.8,85682,36,http://content6.flixster.com/movie/10/92/34/10923416_det.jpg
54734,Sydney White,2007,sydney_white,5,81,30,51,37,4.7,20,5,15,25,3.5,526699,74,http://content6.flixster.com/movie/99/50/88/9950880_det.jpg
54736,The Kingdom,2007,the_kingdom,5.8,182,93,89,51,5.5,41,19,22,46,3.6,107436,78,http://content9.flixster.com/movie/10/93/39/10933935_det.jpg
54745,Rocket Science,2007,rocket_science,6.9,105,88,17,83,6.9,31,25,6,80,3.6,7963,72,http://content9.flixster.com/movie/87/30/72/8730727_det.jpg
54768,Daddy Day Camp,2007,daddy_day_camp,2.3,74,1,73,1,2.4,21,0,21,0,2.9,44524,49,http://content8.flixster.com/movie/10/91/79/10917946_det.jpg
54771,The Invasion,2007,invasion,4.3,156,30,126,19,4.7,34,9,25,26,3,66767,43,http://content8.flixster.com/movie/11/12/40/11124002_det.jpg
54775,War,2007,the-secret-war,0,0,0,0,0,0,0,0,0,0,0,0,0,http://content7.flixster.com/movie/10/84/31/10843105_det.jpg
54780,The Nanny Diaries,2007,mother-nanny,0,0,0,0,0,0,0,0,0,0,0,0,0,http://content9.flixster.com/movie/10/88/52/10885291_det.jpg
54783,September Dawn,2006,september_dawn,3.4,54,7,47,12,2.8,18,0,18,0,3.1,5910,49,http://content6.flixster.com/movie/10/88/53/10885368_det.jpg
54785,Halloween,2007,1179254-halloween,4.1,101,26,75,25,3.9,19,3,16,15,3.3,79946,64,http://content7.flixster.com/movie/10/92/20/10922093_det.jpg
54787,Death Sentence,2007,death_sentence,4.1,110,21,89,19,3.6,28,2,26,7,3.4,42086,62,http://content6.flixster.com/movie/91/47/09/9147092_det.jpg
54796,2 Days in Paris,2007,two_days_in_paris,6.8,113,96,17,84,6.9,34,30,4,88,3.6,27100,71,http://content6.flixster.com/movie/93/43/00/9343004_det.jpg
54881,King Kong,2005,king_kong,7.7,242,202,40,83,7.6,39,30,9,76,2.8,207337,52,http://content8.flixster.com/movie/10/93/36/10933606_det.jpg
54910,Behind the Mask: The Rise of Leslie Vernon,2006,behind_the_mask_the_rise_of_leslie_vernon,6.9,34,25,9,73,6.5,10,7,3,70,3.6,7455,72,http://content6.flixster.com/movie/33/48/96/3348960_det.jpg
54934,The Brothers Solomon,2007,brothers_solomon,3.3,72,11,61,15,3.8,20,3,17,15,2.6,21959,31,http://content7.flixster.com/movie/10/88/79/10887965_det.jpg
54958,Bordertown,2006,10008510-bordertown,0,3,2,1,66,0,1,1,0,100,3.4,5023,64,http://content8.flixster.com/movie/51/30/71/5130710_det.jpg
54962,The Nines,2007,the_nines,6,60,39,21,65,6.2,10,7,3,70,3.4,19000,61,http://content9.flixster.com/movie/10/92/74/10927471_det.jpg
54978,The Good Night,2007,good_night,4.8,41,12,29,29,5,9,3,6,33,2.8,2801,34,http://content6.flixster.com/movie/84/98/33/8498336_det.jpg
54995,Planet Terror,2007,planet_terror,6.1,23,17,6,73,0,0,0,0,0,0,0,0,http://content6.flixster.com/movie/10/92/41/10924140_det.jpg
54997,3:10 to Yuma,2007,310_to_yuma,7.5,205,182,23,88,7.3,42,36,6,85,3.9,139372,85,http://content7.flixster.com/movie/10/92/16/10921673_det.jpg
54999,Shoot 'Em Up,2007,shoot_em_up,6.2,156,103,53,66,5.5,32,17,15,53,3.4,83976,66,http://content9.flixster.com/movie/10/87/89/10878931_det.jpg
55020,12 Angry Men,1957,1000013-12_angry_men,8.8,36,36,0,100,0,4,4,0,100,4.1,22784,95,http://content8.flixster.com/movie/10/88/47/10884742_det.jpg
55052,Atonement,2007,atonement,7.3,202,167,35,82,7.6,41,36,5,87,3.8,138297,79,http://content7.flixster.com/movie/10/95/18/10951817_det.jpg
55063,My Winnipeg,2007,1195800-my_winnipeg,7.8,79,74,5,93,8.2,25,25,0,100,3.8,1541,77,http://content8.flixster.com/movie/10/84/81/10848126_det.jpg
55069,"4 luni, 3 saptam√¢ni si 2 zile",2007,4_months_3_weeks_and_2_days,8.3,131,125,6,95,8.7,33,33,0,100,4,12151,85,http://content7.flixster.com/movie/10/83/79/10837973_det.jpg
55071,No End in Sight,2007,no_end_in_sight,8.1,91,86,5,94,8.2,25,24,1,96,4.3,4168,93,http://content7.flixster.com/movie/10/88/64/10886413_det.jpg
55080,The Brave One,2007,brave_one,5.5,179,76,103,42,5.6,34,13,21,38,3.4,78908,65,http://content6.flixster.com/movie/96/88/61/9688616_det.jpg
55094,In the Valley of Elah,2007,in_the_valley_of_elah,7,154,112,42,72,7.1,38,27,11,71,3.7,15462,77,http://content8.flixster.com/movie/96/88/59/9688598_det.jpg
55100,I Could Never Be Your Woman,2007,i_could_never_be_your_woman,5.5,10,6,4,60,0,3,2,1,66,3.1,13048,45,http://content8.flixster.com/movie/10/86/98/10869886_det.jpg
55110,December Boys,2007,december_boys,5,67,28,39,41,5.4,16,8,8,50,3.3,14517,55,http://content8.flixster.com/movie/95/16/76/9516766_det.jpg
55116,The Hunting Party,2007,1183674-hunting_party,6,89,47,42,52,5.8,26,12,14,46,3.4,13820,67,http://content7.flixster.com/movie/95/64/82/9564825_det.jpg
55118,Eastern Promises,2007,eastern_promises,7.6,190,169,21,88,7.4,35,30,5,85,3.8,66267,82,http://content6.flixster.com/movie/95/78/52/9578528_det.jpg
55154,Brooklyn Rules,2007,brooklyn_rules,5.4,39,18,21,46,5.4,14,5,9,35,3.2,11794,51,http://content6.flixster.com/movie/61/97/79/6197796_det.jpg
55156,An Unreasonable Man,2006,unreasonable_man,7.4,59,54,5,91,7.5,22,20,2,90,3.9,2169,81,http://content7.flixster.com/movie/49/00/62/4900625_det.jpg
55159,Fukush√ª suru wa ware ni ari,1979,1022531-vengeance_is_mine,7.7,5,5,0,100,0,0,0,0,0,0,0,0,http://content8.flixster.com/movie/49/27/90/4927906_det.jpg
55176,In the Shadow of the Moon,2007,1174399-in_the_shadow_of_the_moon,7.9,108,102,6,94,7.9,35,35,0,100,4.2,2605,90,http://content7.flixster.com/movie/93/53/76/9353765_det.jpg
55178,Stephanie Daley,2006,stephanie_daley,7.3,49,44,5,89,7.8,17,16,1,94,2.9,2917,51,http://content7.flixster.com/movie/64/94/43/6494433_det.jpg
55190,Love and Other Disasters,2006,1194842-love_and_other_disasters,3.5,5,1,4,20,0,2,0,2,0,3.4,3576,59,http://content7.flixster.com/movie/10/21/39/10213905_det.jpg
55205,Interview,2007,10007916_interview,6,121,70,51,57,5.8,31,15,16,48,3.2,14637,53,http://content6.flixster.com/movie/87/30/54/8730548_det.jpg
55232,Resident Evil: Extinction,2007,resident_evil_extinction,4.3,91,20,71,21,3.7,12,2,10,16,3.4,145880,63,http://content9.flixster.com/movie/10/93/47/10934787_det.jpg
55241,Mr. Woodcock,2007,mr_woodcock,4,108,14,94,12,4.6,23,6,17,26,2.8,78350,35,http://content7.flixster.com/movie/10/87/52/10875233_det.jpg
55245,Good Luck Chuck,2007,good_luck_chuck,2.8,110,5,105,4,2.7,22,0,22,0,3.3,118715,61,http://content9.flixster.com/movie/99/46/33/9946331_det.jpg
55247,Into the Wild,2007,into_the_wild,7.5,181,149,32,82,7.2,37,27,10,72,4.2,82515,90,http://content8.flixster.com/movie/93/52/46/9352462_det.jpg
55250,The Game Plan,2007,the_gameplan,4.6,96,26,70,27,4.9,22,9,13,40,3.6,118618,75,http://content7.flixster.com/movie/10/92/05/10920593_det.jpg
55253,"Se, jie",2007,lust_caution,6.6,140,100,40,71,6.1,38,22,16,57,3.9,28527,83,http://content7.flixster.com/movie/10/86/08/10860817_det.jpg
55255,Feast of Love,2007,feast_of_love,5.3,113,45,68,39,5.8,29,16,13,55,3.1,17049,57,http://content7.flixster.com/movie/10/88/45/10884537_det.jpg
55257,Postal,2007,postal,3,39,3,36,7,2.2,10,0,10,0,2.6,11460,34,http://content7.flixster.com/movie/10/86/15/10861581_det.jpg
55259,The Seeker: The Dark Is Rising,2007,dark_rising,0,0,0,0,0,0,0,0,0,0,0,0,0,http://content9.flixster.com/movie/10/46/96/10469607_det.jpg
55261,The Heartbreak Kid,2007,the_heartbreak_kid,4.7,153,47,106,30,4.6,32,9,23,28,2.9,91228,41,http://content7.flixster.com/movie/96/50/75/9650753_det.jpg
55267,Dan in Real Life,2007,dan_in_real_life,6.2,167,107,60,64,6.6,35,22,13,62,3.5,112489,70,http://content6.flixster.com/movie/95/90/60/9590608_det.jpg
55269,The Darjeeling Limited,2007,darjeeling_limited,6.5,166,113,53,68,6.1,35,20,15,57,3.7,57824,79,http://content6.flixster.com/movie/95/78/33/9578332_det.jpg
55272,We Own the Night,2007,we_own_the_night,5.8,144,81,63,56,5.8,32,19,13,59,3.4,84878,63,http://content8.flixster.com/movie/89/16/71/8916710_det.jpg
55274,Elizabeth: The Golden Age,2007,golden_age,5.1,162,56,106,34,5,37,10,27,27,3.3,74366,62,http://content7.flixster.com/movie/10/92/49/10924953_det.jpg
55276,Michael Clayton,2007,michael_clayton,7.6,192,173,19,90,7.9,37,35,2,94,3.6,123924,72,http://content8.flixster.com/movie/99/32/72/9932722_det.jpg
55278,Sleuth,2007,sleuth,5.1,118,42,76,35,5.1,30,10,20,33,3.2,9724,53,http://content8.flixster.com/movie/99/66/35/9966350_det.jpg
55280,Lars and the Real Girl,2007,1175569-lars_and_the_real_girl,7.1,132,107,25,81,7.1,35,28,7,80,3.8,44751,84,http://content8.flixster.com/movie/96/89/85/9689854_det.jpg
55282,30 Days of Night,2007,30_days_of_night,5.5,150,73,77,48,5.1,28,13,15,46,3.3,146766,57,http://content7.flixster.com/movie/10/18/32/10183253_det.jpg
55284,Rendition,2007,rendition,5.4,150,69,81,46,5.2,34,12,22,35,3.3,58911,63,http://content7.flixster.com/movie/99/32/74/9932741_det.jpg
55286,Things We Lost in the Fire,2007,things_we_lost_in_the_fire,6.5,121,78,43,64,6.8,29,20,9,68,3.6,18238,73,http://content7.flixster.com/movie/93/52/34/9352349_det.jpg
55288,Reservation Road,2007,reservation_road,5.2,108,39,69,36,4.8,31,8,23,25,3.3,6196,54,http://content6.flixster.com/movie/95/78/14/9578148_det.jpg
55290,Gone Baby Gone,2007,gone_baby_gone,7.7,164,154,10,93,7.4,36,33,3,91,3.8,95109,84,http://content9.flixster.com/movie/92/42/85/9242855_det.jpg
55292,The Comebacks,2007,comebacks,2.7,33,3,30,9,2.6,11,1,10,9,2.8,27630,38,http://content8.flixster.com/movie/10/18/33/10183342_det.jpg
55363,The Assassination of Jesse James by the Coward Robert Ford,2007,assassination_of_jesse_james_by_the_coward_robert_ford,7.1,162,121,41,74,6.6,36,22,14,61,3.7,57534,73,http://content8.flixster.com/movie/10/93/78/10937894_det.jpg
55391,10th & Wolf,2006,10th_and_wolf,4,27,5,22,18,3.5,10,1,9,10,3.1,9910,44,http://content7.flixster.com/movie/21/37/16/2137169_det.jpg
55402,Beaufort,2007,beaufort,7,48,42,6,87,7.6,14,12,2,85,3.7,1055,71,http://content7.flixster.com/movie/85/25/19/8525197_det.jpg
55417,Irina Palm,2007,1193085-irina_palm,5.9,45,30,15,66,5.7,15,8,7,53,3.7,2412,77,http://content8.flixster.com/movie/91/19/06/9119062_det.jpg
55419,I'm Reed Fish,2006,reed_fish,5.1,20,11,9,55,4.3,7,3,4,42,3.2,2282,45,http://content8.flixster.com/movie/10/91/40/10914054_det.jpg
55440,The Final Season,2007,1178221-final_season,4.6,51,14,37,27,5.1,12,5,7,41,3.7,1192,68,http://content7.flixster.com/movie/10/93/73/10937369_det.jpg
55442,Persepolis,2007,persepolis,8.2,145,140,5,96,8.1,37,36,1,97,4.2,29722,92,http://content6.flixster.com/movie/10/05/60/10056032_det.jpg
55444,Control,2007,control,7.4,107,93,14,86,7.3,26,23,3,88,4.1,22741,88,http://content7.flixster.com/movie/89/36/92/8936921_det.jpg
55451,The Jane Austen Book Club,2007,1175178-jane_austen_book_club,6.1,112,73,39,65,6.8,26,22,4,84,3.5,13572,68,http://content9.flixster.com/movie/10/89/34/10893419_det.jpg
55492,The Last Winter,2006,last_winter,6.6,49,37,12,75,6.9,16,13,3,81,2.7,1701,33,http://content9.flixster.com/movie/96/31/45/9631451_det.jpg
55498,Silk,2007,1174809-silk,3.8,55,4,51,7,4.2,17,2,15,11,2.8,5170,33,http://content9.flixster.com/movie/10/87/11/10871143_det.jpg
55507,Elizabeth: The Golden Age,2007,golden_age,5.1,162,56,106,34,5,37,10,27,27,3.3,74366,62,http://content7.flixster.com/movie/10/92/49/10924953_det.jpg
55517,I Want Someone to Eat Cheese With,2006,i_want_someone_to_eat_cheese_with,6.5,48,35,13,72,6.8,17,14,3,82,2.9,2261,38,http://content6.flixster.com/movie/10/88/65/10886536_det.jpg
55553,Black Sheep,2006,black_sheep,6.4,87,61,26,70,6.3,21,15,6,71,3.2,19454,54,http://content6.flixster.com/movie/58/07/67/5807672_det.jpg
55555,Auf der anderen Seite,2007,1193111-edge_of_heaven,7.7,70,62,8,88,7.7,22,20,2,90,4.1,5659,89,http://content6.flixster.com/movie/10/88/69/10886988_det.jpg
55566,Why Did I Get Married?,2007,,\N,\N,\N,\N,\N,\N,\N,\N,\N,\N,\N,\N,\N,\N
55577,Saw IV,2007,saw_4,3.7,71,12,59,16,2.6,15,0,15,0,3.5,171505,70,http://content6.flixster.com/movie/98/90/53/9890532_det.jpg
55603,My Mom's New Boyfriend,2008,my_moms_new_boyfriend,0,2,0,2,0,0,0,0,0,0,0,0,0,http://content8.flixster.com/movie/10/86/93/10869398_det.jpg
55620,For the Bible Tells Me So,2007,for_the_bible_tells_me_so,7.5,47,46,1,97,7.6,16,16,0,100,4.1,1345,89,http://content9.flixster.com/movie/10/07/33/10073351_det.jpg
55668,Full of It,2007,full_of_it,3,17,1,16,5,3.7,7,1,6,14,3.1,9568,48,http://content7.flixster.com/movie/49/66/50/4966505_det.jpg
55687,My Kid Could Paint That,2007,my_kid_could_paint_that,7.8,79,74,5,93,7.7,22,21,1,95,3.7,2712,78,http://content7.flixster.com/movie/96/22/13/9622137_det.jpg
55721,Tropa de Elite,2007,elite_squad,5.1,34,18,16,52,0,4,2,2,50,4.1,5760,88,http://content8.flixster.com/movie/10/85/97/10859754_det.jpg
55726,O Ano em Que Meus Pais Sa√≠ram de F√©rias,2006,o-ano-em-que-meus-pais-sairam-de-ferias-the-year-my-parents-went-on-vacation,7,50,41,9,82,7.4,12,11,1,91,3.9,1471,80,http://content6.flixster.com/movie/59/15/85/5915852_det.jpg
55729,King of California,2007,king_of_california,6.2,67,42,25,62,6.4,26,17,9,65,3.4,5772,64,http://content6.flixster.com/movie/98/90/89/9890896_det.jpg
55732,Martian Child,2007,martian_child,5,104,34,70,32,4.6,29,6,23,20,3.7,48559,73,http://content7.flixster.com/movie/10/17/78/10177873_det.jpg
55765,American Gangster,2007,american_gangster,7,206,163,43,79,6.9,42,32,10,76,4,673602,87,http://content7.flixster.com/movie/84/42/76/8442765_det.jpg
55768,Bee Movie,2007,bee_movie,5.7,165,84,81,50,5.9,37,19,18,51,3.3,137161,57,http://content6.flixster.com/movie/10/94/33/10943316_det.jpg
55805,Before the Devil Knows You're Dead,2007,before_the_devil_knows_youre_dead,7.7,158,138,20,87,8,39,36,3,92,3.5,22578,69,http://content8.flixster.com/movie/10/87/05/10870510_det.jpg
55814,Le scaphandre et le papillon,2007,diving_bell_and_the_butterfly,8.2,155,144,11,92,8.2,39,37,2,94,4,34371,91,http://content6.flixster.com/movie/10/83/90/10839084_det.jpg
55820,No Country for Old Men,2007,no_country_for_old_men,8.5,223,211,12,94,8.1,44,40,4,90,4,197109,84,http://content6.flixster.com/movie/10/86/81/10868132_det.jpg
55830,Be Kind Rewind,2008,be_kind_rewind,6.2,123,80,43,65,5.9,30,16,14,53,3.2,64435,57,http://content6.flixster.com/movie/10/59/92/10599232_det.jpg
55844,Itty Bitty Titty Committee,2007,1187621-itty_bitty_titty_committee,5,8,3,5,37,0,1,0,1,0,3.3,2011,57,http://content6.flixster.com/movie/54/86/07/5486072_det.jpg
55851,Crazy Love,2007,10007792-crazy_love,7,84,65,19,77,7,32,26,6,81,3.6,2624,70,http://content6.flixster.com/movie/10/53/69/10536956_det.jpg
55854,The Fugitive,1993,1046129-fugitive,7.6,52,49,3,94,8,9,9,0,100,3.6,28862,82,http://content9.flixster.com/movie/11/12/17/11121787_det.jpg
55872,August Rush,2007,august_rush,4.8,120,44,76,36,4.4,27,7,20,25,4,105941,84,http://content6.flixster.com/movie/96/76/16/9676160_det.jpg
55895,The Desperate Hours,1955,1005724-desperate_hours,7,5,4,1,80,0,0,0,0,0,0,0,0,http://content8.flixster.com/movie/29/75/297594_det.jpg
55901,Du levande,2007,du_levande,7.8,36,36,0,100,8,8,8,0,100,3.9,2317,81,http://content6.flixster.com/movie/10/30/90/10309076_det.jpg
55908,The Man from Earth,2007,man_from_earth,0,3,3,0,100,0,0,0,0,0,0,0,0,http://content8.flixster.com/movie/10/92/40/10924054_det.jpg
55926,Hellfighters,1968,hellfighters,3.9,7,1,6,14,0,2,0,2,0,3.6,1128,77,http://content8.flixster.com/movie/25/11/251122_det.jpg
55946,Lions for Lambs,2007,lions_for_lambs,4.8,177,47,130,26,4.6,38,7,31,18,3.1,54996,49,http://content7.flixster.com/movie/95/20/68/9520681_det.jpg
55955,Fred Claus,2007,1175076-fred_claus,4.2,135,28,107,20,4.3,32,6,26,18,3,100236,49,http://content7.flixster.com/movie/10/86/17/10861789_det.jpg
55995,Beowulf,2007,beowulf,6.5,189,133,56,70,6.5,36,25,11,69,3.1,101491,52,http://content6.flixster.com/movie/10/03/86/10038656_det.jpg
55999,Mr. Magorium's Wonder Emporium,2007,mr_magoriums_wonder_emporium,4.9,120,44,76,36,4.6,27,7,20,25,3.1,57793,56,http://content9.flixster.com/movie/10/87/52/10875231_det.jpg
56001,Love in the Time of Cholera,2007,love_in_the_time_of_cholera,4.8,107,29,78,27,4.6,29,7,22,24,3.2,20459,48,http://content8.flixster.com/movie/10/88/25/10882590_det.jpg
56003,Southland Tales,2006,southland_tales,4.5,92,33,59,35,4.5,23,9,14,39,2.8,13816,43,http://content9.flixster.com/movie/10/86/73/10867371_det.jpg
56015,Kansas City Confidential,1952,kansas_city_confidential,5.9,7,6,1,85,0,0,0,0,0,0,0,0,http://content8.flixster.com/movie/56/27/74/5627746_det.jpg
56028,Rails & Ties,2007,10008703-rails_and_ties,4.6,45,15,30,33,4.3,19,4,15,21,3.2,1200,61,http://content6.flixster.com/movie/10/48/20/10482040_det.jpg
56030,Darfur Now,2007,10008700-darfur_now,6.6,57,39,18,68,6.6,24,17,7,70,3.7,1145,74,http://content7.flixster.com/movie/10/10/61/10106177_det.jpg
56060,Obsluhoval jsem anglick√©ho kr√°le,2006,i_served_the_king_of_england,7.2,81,65,16,80,7.1,27,23,4,85,3.7,1497,80,http://content8.flixster.com/movie/10/90/86/10908690_det.jpg
56067,Texas Terror,1935,texas_terror,0,1,0,1,0,0,0,0,0,0,0,0,0,http://content7.flixster.com/movie/10/85/61/10856149_det.jpg
56141,La faute √† Fidel!,2006,blame_it_on_fidel,7.4,43,40,3,93,7.8,12,11,1,91,4.1,2344,90,http://content9.flixster.com/movie/10/88/27/10882787_det.jpg
56145,The Mist,2007,mist,6.6,138,101,37,73,5.8,30,17,13,56,3.3,71785,64,http://content7.flixster.com/movie/10/93/48/10934809_det.jpg
56152,Enchanted,2007,enchanted,7.3,157,145,12,92,7.4,34,31,3,91,3.8,188655,80,http://content6.flixster.com/movie/10/87/94/10879424_det.jpg
56156,Hitman,2007,last_hit_man,0,0,0,0,0,0,0,0,0,0,0,0,0,http://content7.flixster.com/movie/10/85/08/10850877_det.jpg
56158,This Christmas,2007,this_christmas,5.9,80,44,36,55,6.1,23,14,9,60,4.1,54791,82,http://content8.flixster.com/movie/10/86/75/10867510_det.jpg
56165,P2,2007,p2,4.3,68,23,45,33,4,15,4,11,26,2.9,29255,39,http://content8.flixster.com/movie/10/18/32/10183294_det.jpg
56167,Om Shanti Om,2007,om_shanti_om,6.9,7,6,1,85,0,1,1,0,100,4,9245,78,http://content6.flixster.com/movie/10/26/11/10261196_det.jpg
56169,Awake,2007,awake,4.3,54,13,41,24,4.4,12,3,9,25,3.2,58950,58,http://content6.flixster.com/movie/10/83/92/10839224_det.jpg
56171,The Golden Compass,2007,his_dark_materials_the_golden_compass,5.6,186,79,107,42,5.6,35,17,18,48,3.2,145319,55,http://content9.flixster.com/movie/10/64/18/10641835_det.jpg
56174,I Am Legend,2007,i_am_legend,6.3,206,142,64,68,6.1,43,25,18,58,3.6,597704,69,http://content6.flixster.com/movie/85/21/20/8521200_det.jpg
56176,Alvin and the Chipmunks,2007,1184827-alvin_and_the_chipmunks,4.4,104,28,76,26,4.3,25,6,19,24,3.6,165304,73,http://content9.flixster.com/movie/97/66/56/9766563_det.jpg
56251,Futurama: Bender's Big Score,2007,futurama_the_movie_benders_big_score,7.6,7,7,0,100,0,0,0,0,0,0,0,0,http://content6.flixster.com/movie/11/15/31/11153120_det.jpg
56274,Margot at the Wedding,2007,margot_at_the_wedding,5.6,162,84,78,51,5.9,34,21,13,61,2.8,9682,39,http://content8.flixster.com/movie/93/38/83/9338834_det.jpg
56286,I'm Not There.,2007,im_not_there_suppositions_on_a_film_concerning_dylan,7,152,116,36,76,7,37,27,10,72,3.5,26869,69,http://content6.flixster.com/movie/95/87/44/9587440_det.jpg
56333,The Savages,2007,savages,7.4,165,147,18,89,7.8,37,36,1,97,3.4,26746,72,http://content7.flixster.com/movie/10/88/71/10887193_det.jpg
56339,El orfanato,2007,orfanato,7.3,154,132,22,85,7.3,28,25,3,89,4,38413,85,http://content8.flixster.com/movie/87/57/20/8757202_det.jpg
56367,Juno,2007,juno,8.1,197,184,13,93,8.4,35,35,0,100,4.1,335812,89,http://content7.flixster.com/movie/10/60/54/10605441_det.jpg
56389,My Blueberry Nights,2007,my_blueberry_nights,5.4,120,57,63,47,5,30,9,21,30,3.4,19153,62,http://content9.flixster.com/movie/10/84/94/10849415_det.jpg
56508,Starting Out in the Evening,2007,starting_out_in_the_evening,7.3,97,84,13,86,7.6,33,27,6,81,3.6,1511,68,http://content8.flixster.com/movie/10/50/13/10501326_det.jpg
56511,Redacted,2007,10008755-redacted,5.3,103,45,58,43,5.2,30,13,17,43,2.9,3154,46,http://content6.flixster.com/movie/10/20/46/10204692_det.jpg
56563,Helvetica,2007,helvetica,7.1,16,14,2,87,8.1,6,6,0,100,3.9,2857,81,http://content6.flixster.com/movie/99/24/77/9924772_det.jpg
56587,The Bucket List,2007,bucket_list,5.1,163,66,97,40,4.6,35,9,26,25,3.8,126324,81,http://content6.flixster.com/movie/10/30/89/10308980_det.jpg
56607,The Kite Runner,2007,kite_runner,6.4,169,111,58,65,6.7,36,26,10,72,3.7,45797,85,http://content6.flixster.com/movie/10/88/95/10889536_det.jpg
56633,Butterfly on a Wheel,2007,shattered,0,3,1,2,33,0,0,0,0,0,0,0,0,http://content8.flixster.com/movie/97/00/89/9700898_det.jpg
56671,The Go-Getter,2007,1196345-go_getter,5.6,23,10,13,43,6.2,11,6,5,54,3.5,1556,66,http://content8.flixster.com/movie/11/14/85/11148550_det.jpg
56700,The Flock,2007,the-flock,0,2,1,1,50,0,0,0,0,0,0,0,0,http://content7.flixster.com/movie/65/85/76/6585761_det.jpg
56715,Wristcutters: A Love Story,2006,10008424-love_story,0,1,1,0,100,0,0,0,0,0,0,0,0,http://content9.flixster.com/movie/10/89/55/10895511_det.jpg
56719,Vitus,2006,1174085-vitus,6.6,59,38,21,64,6.3,19,10,9,52,3.8,10168,77,http://content9.flixster.com/movie/87/30/46/8730467_det.jpg
56744,Longford,2006,1175778-longford,0,4,4,0,100,0,1,1,0,100,0,0,0,http://content6.flixster.com/movie/10/88/36/10883676_det.jpg
56748,The Big Bad Swim,2006,big_bad_swim,0,3,2,1,66,0,1,1,0,100,3.6,407,73,http://content7.flixster.com/movie/34/10/73/3410737_det.jpg
56757,Sweeney Todd: The Demon Barber of Fleet Street,2007,1183955-1183955-sweeney_todd_the_demon_barber_of_fleet_street,7.6,215,184,31,85,7.5,38,32,6,84,3.9,1391688,81,http://content7.flixster.com/movie/11/12/52/11125277_det.jpg
56775,National Treasure: Book of Secrets,2007,national-treasure-2-book-of-secrets,4.7,118,39,79,33,4.6,25,8,17,32,3.6,1237906,72,http://content7.flixster.com/movie/10/10/43/10104317_det.jpg
56782,There Will Be Blood,2007,there_will_be_blood,8.4,202,184,18,91,8.2,39,37,2,94,4,110828,84,http://content6.flixster.com/movie/10/88/49/10884912_det.jpg
56788,Charlie Wilson's War,2007,charlie_wilsons_war,7,192,156,36,81,6.9,40,32,8,80,3.5,85573,73,http://content8.flixster.com/movie/10/61/60/10616034_det.jpg
56801,AVPR: Aliens vs Predator - Requiem,2007,avp2,3.1,66,8,58,12,4,8,3,5,37,2.7,63530,37,http://content9.flixster.com/movie/99/92/66/9992663_det.jpg
56805,Walk Hard: The Dewey Cox Story,2007,walk_hard,6.6,137,102,35,74,6.1,34,25,9,73,3.1,58871,55,http://content8.flixster.com/movie/10/89/74/10897410_det.jpg
56885,The Great Debaters,2007,jesus-the-great-debate,0,0,0,0,0,0,0,0,0,0,0,0,0,http://content6.flixster.com/movie/10/91/11/10911188_det.jpg
56908,Dedication,2007,dedication,5.2,45,18,27,40,4.9,17,5,12,29,3.5,5028,64,http://content6.flixster.com/movie/96/45/04/9645040_det.jpg
56915,The Water Horse,2007,the-deep2007,0,0,0,0,0,0,0,0,0,0,0,0,0,http://content7.flixster.com/movie/10/84/16/10841689_det.jpg
56921,Battlestar Galactica: Razor,2007,battlestar_galactica_razor,0,2,2,0,100,0,0,0,0,0,0,0,0,http://content7.flixster.com/movie/10/54/45/10544505_det.jpg
56941,P.S. I Love You,2007,only-love-knows,0,0,0,0,0,0,0,0,0,0,0,0,0,http://content6.flixster.com/movie/10/88/53/10885380_det.jpg
56945,The Perfect Holiday,2007,10009063-perfect_holiday,3.8,56,9,47,16,3.6,20,2,18,10,3,24817,57,http://content8.flixster.com/movie/10/60/63/10606322_det.jpg
56949,27 Dresses,2008,27_dresses,5,146,59,87,40,4.9,31,8,23,25,3.6,168630,71,http://content9.flixster.com/movie/10/70/11/10701195_det.jpg
57147,Cassandra's Dream,2007,cassandras_dream,5.7,115,53,62,46,5.6,30,12,18,40,3.1,18073,51,http://content6.flixster.com/movie/10/06/15/10061520_det.jpg
57223,D-War,2007,d_war,3.6,33,9,24,27,3.3,7,1,6,14,2.3,34779,23,http://content7.flixster.com/movie/10/89/21/10892161_det.jpg
57243,Bikur Ha-Tizmoret,2007,bands_visit,7.9,110,108,2,98,8.1,27,27,0,100,3.9,6276,85,http://content9.flixster.com/movie/10/17/94/10179459_det.jpg
57274,[Rec],2007,10009132-rec,7.8,23,22,1,95,0,1,0,1,0,3.8,30174,77,http://content6.flixster.com/movie/10/52/28/10522876_det.jpg
57326,In the Name of the King: A Dungeon Siege Tale,2007,,2.5,44,2,42,4,2.9,8,0,8,0,2.6,26869,29,http://content6.flixster.com/movie/10/88/45/10884548_det.jpg
57353,Flawless,2007,10008754-flawless,5.7,90,50,40,55,6,17,12,5,70,3.3,5982,56,http://content6.flixster.com/movie/10/87/72/10877212_det.jpg
57368,Cloverfield,2008,cloverfield,6.7,190,145,45,76,6.3,35,25,10,71,3.4,188811,67,http://content9.flixster.com/movie/10/83/79/10837935_det.jpg
57370,Mad Money,2008,1188347-mad_money,4.4,103,23,80,22,4.6,30,8,22,26,3.2,45502,52,http://content7.flixster.com/movie/10/60/55/10605553_det.jpg
57401,Cleaner,2007,cleaner,4.4,12,2,10,16,0,3,1,2,33,3.1,6226,45,http://content6.flixster.com/movie/10/89/17/10891720_det.jpg
57464,He Was a Quiet Man,2007,10009156-he_was_a_quiet_man,6.2,19,15,4,78,0,1,0,1,0,3.3,5213,61,http://content8.flixster.com/movie/75/30/73/7530734_det.jpg
57476,The Cheyenne Social Club,1970,cheyenne_social_club,0,2,2,0,100,0,0,0,0,0,0,0,0,http://content9.flixster.com/movie/10/93/13/10931355_det.jpg
57480,The Iron Horse,1924,1188234-iron_horse,7.2,7,6,1,85,0,0,0,0,0,0,0,0,http://content6.flixster.com/movie/10/89/23/10892348_det.jpg
57484,3 Bad Men,1926,three-bad-men,0,0,0,0,0,0,0,0,0,0,0,0,0,http://content6.flixster.com/movie/10/87/83/10878380_det.jpg
57504,Toki o kakeru sh√¥jo,2006,1202495-girl_who_leapt_through_time,6.7,15,13,2,86,0,2,2,0,100,4.2,3403,90,http://content8.flixster.com/movie/10/89/80/10898078_det.jpg
57509,Sex and Breakfast,2007,sex_and_breakfast,3.4,11,1,10,9,0,3,0,3,0,2.5,1772,24,http://content8.flixster.com/movie/10/64/07/10640746_det.jpg
57520,One Missed Call,2008,one_missed_call,2.5,76,0,76,0,2.4,15,0,15,0,2.7,44868,37,http://content8.flixster.com/movie/10/89/16/10891634_det.jpg
57522,First Sunday,2008,sunday-school,0,0,0,0,0,0,0,0,0,0,0,0,0,http://content6.flixster.com/movie/10/84/37/10843756_det.jpg
57526,Untraceable,2008,10008954-untraceable,4.1,143,21,122,14,4.2,31,6,25,19,3.3,68370,56,http://content8.flixster.com/movie/10/80/00/10800030_det.jpg
57528,Rambo,2008,john_rambo,4.8,138,50,88,36,4,26,6,20,23,3.4,107524,70,http://content9.flixster.com/movie/10/84/05/10840523_det.jpg
57530,How She Move,2007,how_she_move,6,77,52,25,67,6.1,22,14,8,63,3.3,16237,56,http://content7.flixster.com/movie/10/86/53/10865389_det.jpg
57532,Meet the Spartans,2008,meet_the_spartans,1.9,46,1,45,2,2.4,9,0,9,0,2.4,69166,31,http://content7.flixster.com/movie/10/79/98/10799893_det.jpg
57534,The Eye,2008,10008606-eye,4.3,74,16,58,21,4.5,10,2,8,20,3.1,57166,51,http://content7.flixster.com/movie/10/84/47/10844773_det.jpg
57536,Strange Wilderness,2008,strange_wilderness,2.3,41,0,41,0,2.2,7,0,7,0,2.7,25360,35,http://content6.flixster.com/movie/10/58/58/10585876_det.jpg
57538,Over Her Dead Body,2008,1190660-over_my_dead_body,3.7,103,16,87,15,3.8,30,3,27,10,3.1,34429,47,http://content9.flixster.com/movie/10/88/79/10887935_det.jpg
57550,Im Lauf der Zeit,1976,im-lauf-der-zeit-kings-of-the-road,0,3,3,0,100,0,0,0,0,0,0,0,0,http://content7.flixster.com/movie/10/87/23/10872301_det.jpg
57640,Hellboy II: The Golden Army,2008,hellboy_2_the_golden_army,7.2,197,171,26,86,7.2,33,29,4,87,3.6,94282,70,http://content6.flixster.com/movie/10/86/25/10862512_det.jpg
57655,Ira & Abby,2006,ira_and_abby,6,41,28,13,68,6.5,12,9,3,75,3.5,1069,62,http://content9.flixster.com/movie/98/90/83/9890831_det.jpg
57669,In Bruges,2008,in_bruges,7,154,124,30,80,6.7,34,23,11,67,3.9,53258,84,http://content8.flixster.com/movie/10/85/68/10856882_det.jpg
57690,The Shoes of the Fisherman,1968,shoes_of_the_fisherman,6.1,6,3,3,50,0,0,0,0,0,0,0,0,http://content9.flixster.com/movie/65/07/650799_det.jpg
57792,Sukkar banat,2007,caramel,7.1,73,67,6,91,7.2,25,23,2,92,3.9,5165,80,http://content8.flixster.com/movie/10/04/22/10042278_det.jpg
57845,Joe Strummer: The Future Is Unwritten,2007,joe_strummer_the_future_is_unwritten,7.3,59,52,7,88,7.7,21,21,0,100,4,3950,85,http://content9.flixster.com/movie/98/44/15/9844155_det.jpg
57865,The Pleasure of Your Company,2006,pleasure_of_your_company,4.3,11,4,7,36,0,1,0,1,0,2.9,7325,40,http://content7.flixster.com/movie/85/18/88/8518881_det.jpg
57910,Teeth,2007,teeth,6.6,61,50,11,81,6.4,18,15,3,83,3,14996,46,http://content6.flixster.com/movie/10/60/54/10605468_det.jpg
57949,"Welcome Home, Roscoe Jenkins",2008,welcome_home_roscoe_jenkins,4.4,77,18,59,23,4.8,27,9,18,33,3.3,34393,65,http://content7.flixster.com/movie/10/91/73/10917381_det.jpg
57951,Fool's Gold,2008,10009167-fools_gold,3.6,140,14,126,10,3.2,30,0,30,0,3.2,76286,53,http://content8.flixster.com/movie/10/88/53/10885330_det.jpg
57964,Blue State,2007,blue_state,0,4,1,3,25,0,0,0,0,0,0,0,0,http://content6.flixster.com/movie/10/88/62/10886268_det.jpg
58025,Jumper,2008,jumper,4,158,26,132,16,3.7,36,1,35,2,3.2,131920,50,http://content7.flixster.com/movie/10/86/81/10868113_det.jpg
58029,It's a Free World...,2007,its_a_free_world,6.6,18,15,3,83,6.2,6,4,2,66,3.6,1788,70,http://content7.flixster.com/movie/10/49/04/10490497_det.jpg
58047,"Definitely, Maybe",2008,1174278-definitely_maybe,6.5,142,101,41,71,6,32,21,11,65,3.5,71521,72,http://content8.flixster.com/movie/10/83/81/10838102_det.jpg
58059,Ikimono no kiroku,1955,i_live_in_fear,6.4,10,7,3,70,0,2,1,1,50,3.6,357,75,http://content6.flixster.com/movie/10/83/97/10839780_det.jpg
58078,The Air I Breathe,2007,the_air_i_breahe,3.9,23,3,20,13,3.6,7,0,7,0,3.4,12498,64,http://content7.flixster.com/movie/10/84/03/10840357_det.jpg
58084,Street Thief,2006,street-thief,0,0,0,0,0,0,0,0,0,0,0,0,0,http://content8.flixster.com/movie/10/89/05/10890526_det.jpg
58103,Vantage Point,2008,vantage_point,5,149,51,98,34,4.9,29,8,21,27,3.4,88206,61,http://content6.flixster.com/movie/10/89/54/10895460_det.jpg
58105,The Spiderwick Chronicles,2008,spiderwick_chronicles,6.6,142,113,29,79,6.4,31,22,9,70,3.4,73683,67,http://content6.flixster.com/movie/93/69/42/9369420_det.jpg
58107,Step Up 2: The Streets,2008,step_up_2_the_streets,4.8,56,14,42,25,5.1,18,5,13,27,4,92053,81,http://content6.flixster.com/movie/10/87/81/10878176_det.jpg
58146,Witless Protection,2008,witless_protection,2.1,28,1,27,3,0,4,0,4,0,3.1,9071,51,http://content6.flixster.com/movie/10/87/09/10870968_det.jpg
58154,The Other Boleyn Girl,2008,other_boleyn_girl,5.3,136,56,80,41,5.2,34,12,22,35,3.4,73595,65,http://content9.flixster.com/movie/10/88/69/10886983_det.jpg
58156,Semi-Pro,2008,semi_pro,4.5,154,32,122,20,4.8,31,8,23,25,2.9,58206,41,http://content6.flixster.com/movie/97/00/66/9700660_det.jpg
58162,Run Fatboy Run,2007,10008621-run_fat_boy_run,5.5,143,69,74,48,5.5,31,17,14,54,3.5,43462,66,http://content7.flixster.com/movie/10/86/16/10861685_det.jpg
58191,Taxi to the Dark Side,2007,taxi_to_the_dark_side,8.3,85,85,0,100,8.2,23,23,0,100,4,2599,88,http://content6.flixster.com/movie/11/12/77/11127704_det.jpg
58246,Grace Is Gone,2007,grace_is_gone,5.9,71,44,27,61,5.9,21,13,8,61,3.1,10636,59,http://content7.flixster.com/movie/10/83/80/10838065_det.jpg
58291,College Road Trip,2008,college_road_trip,3.3,70,9,61,12,3.2,18,1,17,5,3.3,41096,56,http://content7.flixster.com/movie/10/83/94/10839445_det.jpg
58293,"10,000 BC",2008,10000_bc,3.2,139,12,127,8,3.1,29,3,26,10,3,91145,44,http://content6.flixster.com/movie/10/67/38/10673888_det.jpg
58295,The Bank Job,2008,1189844-the_bank_job,6.7,137,108,29,78,7.1,31,28,3,90,3.5,60915,74,http://content7.flixster.com/movie/10/88/80/10888073_det.jpg
58297,Doomsday,2008,doomsday,5,65,31,34,47,4.7,10,3,7,30,3.1,35296,47,http://content6.flixster.com/movie/10/84/16/10841620_det.jpg
58299,Horton Hears a Who!,2008,horton-hears-a-who2008,7,130,102,28,78,7,33,27,6,81,3.7,97604,75,http://content9.flixster.com/movie/10/86/39/10863903_det.jpg
58301,Funny Games U.S.,2007,1175174-funny_games,5.6,138,71,67,51,4.7,34,13,21,38,3.2,16153,54,http://content8.flixster.com/movie/10/88/03/10880338_det.jpg
58303,Die F√§lscher,2007,,\N,\N,\N,\N,\N,\N,\N,\N,\N,\N,\N,\N,\N,\N
58306,Mongol,2007,mongol,7.1,98,85,13,86,7.4,27,25,2,92,3.7,11134,75,http://content7.flixster.com/movie/10/86/89/10868965_det.jpg
58309,War Dance,2007,wardance,7.1,47,40,7,85,7.4,17,15,2,88,4.3,1246,91,http://content7.flixster.com/movie/10/92/15/10921501_det.jpg
58315,The Love Guru,2008,love_guru,3.4,161,24,137,14,3.4,35,4,31,11,2.8,42392,39,http://content9.flixster.com/movie/10/93/40/10934095_det.jpg
58332,Diary of the Dead,2007,diary-of-the-dead2007,6.1,125,76,49,60,6.1,26,17,9,65,2.9,13143,43,http://content9.flixster.com/movie/10/02/11/10021155_det.jpg
58334,Hallam Foe,2007,mister_foe,6.5,60,43,17,71,6.9,13,10,3,76,3.5,5333,72,http://content6.flixster.com/movie/78/84/47/7884476_det.jpg
58347,Penelope,2006,penelope2008,5.6,125,65,60,52,5.4,28,14,14,50,3.6,48472,74,http://content7.flixster.com/movie/10/86/26/10862633_det.jpg
58351,Cidade dos Homens,2007,city_of_men,6.7,76,57,19,75,7.1,24,21,3,87,3.8,3953,77,http://content8.flixster.com/movie/10/83/85/10838542_det.jpg
58367,"Romulus, My Father",2007,romulus_my_father,6.1,11,6,5,54,5.6,5,2,3,40,3.6,1466,67,http://content6.flixster.com/movie/10/91/44/10914416_det.jpg
58376,Zeitgeist,2007,zeitgeist,0,0,0,0,0,0,0,0,0,0,0,0,0,http://content7.flixster.com/movie/10/92/94/10929461_det.jpg
58381,Meduzot,2007,meduzot,7.2,56,48,8,85,7.7,17,16,1,94,3.8,942,77,http://content9.flixster.com/movie/10/46/99/10469975_det.jpg
58418,Then She Found Me,2007,then_she_found_me,5.5,115,59,56,51,5.5,28,16,12,57,3.1,4911,46,http://content7.flixster.com/movie/10/88/87/10888781_det.jpg
58439,Downhill Racer,1969,downhill_racer,7.2,14,11,3,78,0,2,2,0,100,3.3,385,54,http://content6.flixster.com/movie/50/38/69/5038696_det.jpg
58490,Miss Pettigrew Lives for a Day,2008,miss_pettigrew_lives_for_a_day,6.6,138,107,31,77,6.7,29,21,8,72,3.5,21923,70,http://content8.flixster.com/movie/10/83/87/10838710_det.jpg
58492,Snow Angels,2007,snow_angels,6.8,107,71,36,66,7,30,20,10,66,3.5,4241,66,http://content7.flixster.com/movie/10/89/39/10893941_det.jpg
58494,Married Life,2007,10008849-married_life,5.9,114,63,51,55,6.2,28,15,13,53,3,3205,36,http://content7.flixster.com/movie/10/83/93/10839309_det.jpg
58559,The Dark Knight,2008,the_dark_knight,8.4,275,257,18,93,8,44,40,4,90,4.5,399618,96,http://content8.flixster.com/movie/10/83/86/10838658_det.jpg
58595,Quiet City,2007,quiet_city,7,16,14,2,87,6.8,6,5,1,83,3.4,995,61,http://content7.flixster.com/movie/96/99/24/9699245_det.jpg
58622,The Hammer,2007,10009253-the_hammer,6.1,32,22,10,68,6.3,13,10,3,76,3.9,1768,82,http://content9.flixster.com/movie/10/88/46/10884647_det.jpg
58627,Never Back Down,2008,never_back_down,4.4,83,19,64,22,4.4,20,4,16,20,2.9,405469,37,http://content7.flixster.com/movie/10/92/24/10922497_det.jpg
58652,Cheung Gong 7 hou,2008,cj7,5.3,76,37,39,48,5.3,20,10,10,50,3.3,6905,55,http://content7.flixster.com/movie/10/86/83/10868373_det.jpg
58655,Drillbit Taylor,2008,drillbit_taylor,4.5,138,36,102,26,4.4,30,7,23,23,3.2,45456,49,http://content9.flixster.com/movie/10/84/11/10841187_det.jpg
58706,La misma luna,2007,same_moon,6.5,91,66,25,72,6.6,26,20,6,76,3.8,11693,80,http://content7.flixster.com/movie/10/92/39/10923945_det.jpg
58783,Youth Without Youth,2007,youth_without_youth,4.7,99,30,69,30,4.7,29,8,21,27,3,5756,45,http://content9.flixster.com/movie/99/22/71/9922715_det.jpg
58803,21,2008,10009192-21,5.2,161,57,104,35,4.9,31,8,23,25,3.7,112101,73,http://content6.flixster.com/movie/10/88/67/10886752_det.jpg
58806,Smart People,2008,1192938-smart_people,5.6,141,70,71,49,5.8,34,16,18,47,3,26733,41,http://content6.flixster.com/movie/10/86/83/10868356_det.jpg
58839,Leatherheads,2008,leatherheads,5.8,160,83,77,51,5.2,32,11,21,34,3,36074,41,http://content7.flixster.com/movie/10/84/03/10840345_det.jpg
58876,Stop-Loss,2008,stop_loss,6.3,138,89,49,64,6.3,33,22,11,66,2.5,254181,27,http://content8.flixster.com/movie/10/84/63/10846366_det.jpg
58879,Shine a Light,2008,shine_a_light,7.4,120,103,17,85,7.3,34,30,4,88,3.6,11885,74,http://content9.flixster.com/movie/10/84/03/10840343_det.jpg
58898,La antena,2007,10009318-the_aerial,5.8,10,6,4,60,0,0,0,0,0,0,0,0,http://content9.flixster.com/movie/10/46/96/10469627_det.jpg
58964,√Ä l'int√©rieur,2007,a_le_interieur,7.4,12,10,2,83,0,1,1,0,100,3.8,3333,77,http://content9.flixster.com/movie/10/46/44/10464439_det.jpg
58972,Nim's Island,2008,nims_island,5.7,96,48,48,50,5.9,24,13,11,54,3.1,45465,50,http://content9.flixster.com/movie/10/79/99/10799967_det.jpg
58975,The Ruins,2008,the_ruins,5.4,85,40,45,47,4.4,12,3,9,25,2.4,29652,32,http://content7.flixster.com/movie/10/92/26/10922657_det.jpg
58998,Forgetting Sarah Marshall,2008,forgetting_sarah_marshall,7,175,148,27,84,7,37,33,4,89,3.2,102537,75,http://content7.flixster.com/movie/10/83/99/10839917_det.jpg
59000,Sex and Death 101,2007,sex_and_death_101,4.3,39,10,29,25,3.7,13,3,10,23,3,2241,44,http://content8.flixster.com/movie/10/45/28/10452830_det.jpg
59014,Superhero Movie,2008,1159618-superhero,3.7,48,7,41,14,3.2,12,0,12,0,2.9,45683,37,http://content6.flixster.com/movie/10/83/93/10839344_det.jpg
59016,Street Kings,2008,street_kings,5.1,149,54,95,36,5,30,8,22,26,3.4,41234,63,http://content9.flixster.com/movie/10/88/20/10882007_det.jpg
59018,The Visitor,2007,10008820-visitor,7.7,111,100,11,90,7.9,25,24,1,96,3.6,29598,82,http://content8.flixster.com/movie/10/88/59/10885902_det.jpg
59022,Harold & Kumar Escape from Guantanamo Bay,2008,harold_and_kumar_2,5.6,128,69,59,53,5.8,26,15,11,57,3.5,76122,65,http://content9.flixster.com/movie/10/82/71/10827119_det.jpg
59026,99 francs,2007,99_francs,0,0,0,0,0,0,0,0,0,0,0,0,0,http://content7.flixster.com/movie/10/86/87/10868721_det.jpg
59037,Speed Racer,2008,speed_racer,5.1,202,76,126,37,4.6,41,13,28,31,3.2,70251,61,http://content7.flixster.com/movie/10/88/09/10880985_det.jpg
59044,Diminished Capacity,2008,diminished_capacity,5.3,30,10,20,33,4.9,11,3,8,27,2.6,4729,37,http://content6.flixster.com/movie/10/84/96/10849656_det.jpg
59065,Chapter 27,2007,1193377-chapter_27,3.9,47,9,38,19,4.8,16,8,8,50,3,5596,43,http://content8.flixster.com/movie/40/53/41/4053410_det.jpg
59103,The Forbidden Kingdom,2008,forbidden_kingdom,6.1,123,79,44,64,5.7,27,18,9,66,3.5,74799,65,http://content8.flixster.com/movie/10/70/83/10708386_det.jpg
59105,Where in the World Is Osama Bin Laden?,2008,where_in_the_world_is_osama_bin_laden,4.9,102,38,64,37,4.6,29,9,20,31,3.3,2558,55,http://content9.flixster.com/movie/10/85/36/10853683_det.jpg
59107,The Life Before Her Eyes,2007,life_before_her_eyes,4.4,91,22,69,24,4.8,21,7,14,33,3.3,6082,55,http://content9.flixster.com/movie/10/91/33/10913323_det.jpg
59118,Happy-Go-Lucky,2008,1195103-happy_go_lucky,7.7,149,138,11,92,8,33,32,1,96,3.4,13094,65,http://content8.flixster.com/movie/10/91/98/10919802_det.jpg
59126,Religulous,2008,religulous,6.4,149,104,45,69,6,33,21,12,63,3.8,16867,79,http://content9.flixster.com/movie/10/88/79/10887975_det.jpg
59129,Outpost,2008,outpost_2007,0,2,1,1,50,0,0,0,0,0,0,0,0,http://content7.flixster.com/movie/91/71/22/9171229_det.jpg
59141,Son of Rambow,2007,son_of_rambow,6.8,114,84,30,73,6.8,27,20,7,74,3.7,17821,79,http://content6.flixster.com/movie/99/65/82/9965828_det.jpg
59143,Super High Me,2007,super-high-me,5.3,7,4,3,57,0,1,0,1,0,3.4,2525,56,http://content6.flixster.com/movie/10/88/36/10883608_det.jpg
59157,The Invisible Ray,1936,invisible_ray,6.2,5,4,1,80,0,0,0,0,0,0,0,0,http://content6.flixster.com/movie/10/87/49/10874972_det.jpg
59173,The Killer Elite,1975,1011558-killer_elite,6,8,5,3,62,0,2,0,2,0,3,599,35,http://content6.flixster.com/movie/10/86/83/10868348_det.jpg
59256,Deception,2008,10009724-deception,3.8,94,12,82,12,3.5,27,2,25,7,3,23525,37,http://content7.flixster.com/movie/10/87/62/10876257_det.jpg
59258,Baby Mama,2008,baby_mama,6.2,157,99,58,63,6,37,23,14,62,3.4,80435,59,http://content8.flixster.com/movie/10/87/33/10873378_det.jpg
59290,Klimt,2006,10006828-klimt,5,24,7,17,29,5.6,8,4,4,50,2.7,1898,32,http://content7.flixster.com/movie/98/44/23/9844237_det.jpg
59295,Expelled: No Intelligence Allowed,2008,expelled_no_intelligence_allowed,2.9,41,4,37,9,2.5,17,0,17,0,3.5,8732,70,http://content9.flixster.com/movie/10/86/32/10863271_det.jpg
59306,Prom Night,2008,prom_night,2.8,60,5,55,8,2.4,9,1,8,11,3,51435,46,http://content9.flixster.com/movie/10/66/75/10667503_det.jpg
59313,Die weisse Massai,2005,die-weisse-massai-the-white-massai,6.3,7,5,2,71,0,2,2,0,100,3.7,628,72,http://content7.flixster.com/movie/46/71/92/4671929_det.jpg
59315,Iron Man,2008,,\N,\N,\N,\N,\N,\N,\N,\N,\N,\N,\N,\N,\N,\N
59333,Made of Honor,2008,made_of_honor,4,111,15,96,13,4.4,27,5,22,18,3.4,79802,61,http://content7.flixster.com/movie/10/79/99/10799937_det.jpg
59336,Redbelt,2008,redbelt,6.3,137,93,44,67,6.5,31,22,9,70,3.4,9293,64,http://content7.flixster.com/movie/10/84/03/10840365_det.jpg
59339,Mister Lonely,2007,1192616-mister_lonely,5.2,68,30,38,44,5.1,19,8,11,42,3.4,2212,59,http://content7.flixster.com/movie/83/04/13/8304133_det.jpg
59362,Anamorph,2007,anamorph,4.5,26,6,20,23,4.9,8,3,5,37,2.7,1453,26,http://content9.flixster.com/movie/10/90/29/10902939_det.jpg
59369,Taken,2008,taken,5.8,160,92,68,57,5.2,33,14,19,42,4,307912,83,http://content6.flixster.com/movie/10/88/42/10884248_det.jpg
59382,Le voyage du ballon rouge,2007,flight_of_the_red_balloon,6.9,82,65,17,79,7.3,22,19,3,86,3.4,1609,59,http://content6.flixster.com/movie/10/92/48/10924828_det.jpg
59387,The Fall,2006,the-fall-2008,6.2,101,60,41,59,5.8,21,9,12,42,3.8,23397,85,http://content9.flixster.com/movie/10/87/50/10875031_det.jpg
59392,Stargate: The Ark of Truth,2008,stargate_the_ark_of_truth,0,4,3,1,75,0,0,0,0,0,0,0,0,http://content6.flixster.com/movie/99/58/38/9958384_det.jpg
59404,Bill,2007,10008830-bill,3.8,19,4,15,21,2.7,7,0,7,0,3.1,4060,46,http://content6.flixster.com/movie/10/84/77/10847796_det.jpg
59418,An American Crime,2007,american_crime,4.6,11,3,8,27,0,2,0,2,0,3.8,6057,79,http://content9.flixster.com/movie/10/88/33/10883339_det.jpg
59421,What Happens in Vegas,2008,10008760-what_happens_in_vegas,4.5,128,36,92,28,4.5,31,9,22,29,3.7,109183,72,http://content9.flixster.com/movie/10/86/96/10869615_det.jpg
59440,Bella,2006,bella,5.4,62,26,36,41,5.2,24,8,16,33,4,8808,81,http://content7.flixster.com/movie/10/26/04/10260457_det.jpg
59478,Der unbekannte Soldat,2006,1185184-1185184-unknown_soldier,6.1,10,6,4,60,0,3,1,2,33,4.2,59,88,http://content9.flixster.com/movie/10/84/20/10842091_det.jpg
59501,The Chronicles of Narnia: Prince Caspian,2008,chronicles_of_narnia_prince_caspian,6.3,179,120,59,67,6.2,37,23,14,62,3.8,154104,78,http://content6.flixster.com/movie/11/12/92/11129292_det.jpg
59519,Reprise,2006,1196293-reprise,7.4,77,67,10,87,7.7,23,20,3,86,3.9,2013,82,http://content6.flixster.com/movie/92/54/45/9254456_det.jpg
59590,Young @ Heart,2007,youngheart,7.5,97,85,12,87,7.7,23,21,2,91,4.2,3340,91,http://content9.flixster.com/movie/10/87/95/10879511_det.jpg
59594,"War, Inc.",2008,war_inc,4.6,79,24,55,30,3.9,22,4,18,18,2.9,17107,40,http://content9.flixster.com/movie/10/84/06/10840667_det.jpg
59604,The Girl Next Door,2004,1130343-girl_next_door,5.6,156,87,69,55,5,32,17,15,53,3.3,39311,71,http://content9.flixster.com/movie/11/12/56/11125663_det.jpg
59607,King Corn,2007,10008698-king_corn,7.7,20,19,1,95,7.8,9,9,0,100,3.8,1280,78,http://content9.flixster.com/movie/10/84/27/10842779_det.jpg
59615,Indiana Jones and the Kingdom of the Crystal Skull,2008,indiana_jones_and_the_kingdom_of_the_crystal_skull,6.9,246,190,56,77,6.1,41,25,16,60,3.4,252104,59,http://content6.flixster.com/movie/10/86/88/10868884_det.jpg
59655,Patti Smith: Dream of Life,2008,1196178-patti_smith_dream_of_life,6.4,37,24,13,64,6.8,14,11,3,78,3.7,513,76,http://content7.flixster.com/movie/10/92/30/10923017_det.jpg
59684,Lake of Fire,2006,lake_of_fire,7.7,51,48,3,94,7.7,16,16,0,100,4.1,1243,90,http://content8.flixster.com/movie/96/99/41/9699418_det.jpg
59709,The Oxford Murders,2008,10008924-oxford_murders,3.8,10,1,9,10,0,2,0,2,0,2.9,7692,37,http://content6.flixster.com/movie/11/14/87/11148760_det.jpg
59715,Shutter,2004,4bia-phobia,0,0,0,0,0,0,0,0,0,0,0,0,0,http://content8.flixster.com/movie/10/85/25/10852522_det.jpg
59721,The Grand,2007,10009244-the_grand,5.2,42,16,26,38,5.1,15,6,9,40,3.1,1445,45,http://content6.flixster.com/movie/10/84/88/10848808_det.jpg
59725,Sex and the City,2008,sex_and_the_city,5.5,173,85,88,49,5.5,41,21,20,51,3.9,147793,81,http://content9.flixster.com/movie/10/83/84/10838483_det.jpg
59727,The Strangers,2008,the_strangers,5,146,65,81,44,4.8,26,13,13,50,3.1,55773,48,http://content9.flixster.com/movie/11/12/79/11127923_det.jpg
59729,Savage Grace,2007,savage_grace,4.9,89,34,55,38,4.9,25,10,15,40,2.9,3544,40,http://content9.flixster.com/movie/93/86/97/9386971_det.jpg
59731,Bigger Stronger Faster*,2008,bigger_stronger_faster_asterisk,7.7,73,70,3,95,7.8,19,19,0,100,3,9818,73,http://content8.flixster.com/movie/10/84/27/10842758_det.jpg
59738,All the Boys Love Mandy Lane,2006,boys_love,0,1,0,1,0,0,0,0,0,0,0,0,0,http://content6.flixster.com/movie/10/85/08/10850880_det.jpg
59784,Kung Fu Panda,2008,kung_fu_panda,7.2,163,144,19,88,6.8,34,26,8,76,3.9,162469,83,http://content6.flixster.com/movie/10/15/50/10155064_det.jpg
59795,What Would Jesus Buy?,2007,what_would_jesus_buy,6.2,54,32,22,59,6,14,9,5,64,3.4,1220,57,http://content8.flixster.com/movie/10/43/69/10436918_det.jpg
59810,Recount,2008,1198569-recount,6.4,17,13,4,76,6.6,10,8,2,80,3.8,2167,81,http://content6.flixster.com/movie/10/84/86/10848648_det.jpg
59816,Kunsten at gr√¶de i kor,2006,kunsten-at-graede-i-kor-the-art-of-crying,6,6,3,3,50,0,2,2,0,100,3.9,561,84,http://content6.flixster.com/movie/10/83/90/10839028_det.jpg
59832,Where the Sidewalk Ends,1950,where_the_sidewalk_ends,7.6,9,9,0,100,0,3,3,0,100,3.7,424,80,http://content7.flixster.com/movie/31/19/311917_det.jpg
59834,100 Rifles,1969,100_rifles,0,2,0,2,0,0,1,0,1,0,3.3,243,47,http://content8.flixster.com/movie/54/15/47/5415474_det.jpg
59900,You Don't Mess with the Zohan,2008,,4.7,178,65,113,36,5.2,36,13,23,36,3.2,91932,50,http://content6.flixster.com/movie/10/86/19/10861952_det.jpg
59908,The Promotion,2008,10009624-promotion,5.8,76,41,35,53,5.3,21,10,11,47,2.8,7926,29,http://content9.flixster.com/movie/11/15/05/11150595_det.jpg
59910,And When Did You Last See Your Father?,2007,when_did_you_last_see_your_father,6.6,93,68,25,73,6.8,23,18,5,78,3.1,5170,62,http://content8.flixster.com/movie/10/91/44/10914414_det.jpg
59912,Mio fratello √® figlio unico,2007,mio_fratello_e_figlio_unico,7,59,51,8,86,7.1,18,16,2,88,3.8,1781,79,http://content9.flixster.com/movie/10/05/59/10055991_det.jpg
59915,Stuck,2007,stuck,6.3,86,62,24,72,6.3,22,16,6,72,3.2,1652,55,http://content9.flixster.com/movie/10/21/35/10213587_det.jpg
59985,Chaos Theory,2008,chaos_theory,5,56,17,39,30,4.7,20,3,17,15,3.4,4938,61,http://content8.flixster.com/movie/10/88/46/10884666_det.jpg
59995,Boy A,2007,boy-a,7.5,57,51,6,89,7.5,23,20,3,86,3.5,5895,84,http://content8.flixster.com/movie/10/85/07/10850786_det.jpg
60037,The Happening,2008,10007985-happening,4,168,30,138,17,3.8,36,4,32,11,2.7,85481,29,http://content6.flixster.com/movie/10/63/54/10635428_det.jpg
60040,The Incredible Hulk,2008,the_incredible_hulk,6.1,210,138,72,65,5.7,38,21,17,55,3.6,124298,75,http://content6.flixster.com/movie/10/84/92/10849216_det.jpg
60044,Baghead,2008,baghead,6.6,90,69,21,76,6.9,27,22,5,81,3,1311,47,http://content7.flixster.com/movie/10/85/34/10853449_det.jpg
60046,The Children of Huang Shi,2008,,4.6,72,22,50,30,4.6,21,6,15,28,3.2,8648,67,http://content8.flixster.com/movie/10/91/61/10916194_det.jpg
60069,WALL¬∑E,2008,wall_e,8.4,226,217,9,96,8.5,40,39,1,97,4.2,192598,89,http://content7.flixster.com/movie/10/93/09/10930953_det.jpg
60072,Wanted,2008,1174279-wanted,6.5,196,139,57,70,6.8,39,29,10,74,3.7,934918,72,http://content7.flixster.com/movie/10/88/26/10882637_det.jpg
60074,Hancock,2008,hancock,5.4,211,85,126,40,5,39,13,26,33,3.7,184958,67,http://content8.flixster.com/movie/10/78/35/10783530_det.jpg
60126,Get Smart,2008,get_smart,5.5,206,105,101,50,5.5,38,20,18,52,3.6,117099,73,http://content8.flixster.com/movie/10/86/28/10862834_det.jpg
60133,Brick Lane,2007,brick_lane,6.2,94,61,33,64,6.4,22,13,9,59,3,3292,58,http://content6.flixster.com/movie/10/90/33/10903312_det.jpg
60135,Surfwise,2007,surfwise,7.4,42,41,1,97,7,11,10,1,90,2.9,6425,61,http://content8.flixster.com/movie/10/84/10/10841038_det.jpg
60137,The Rape of Europa,2006,deep-crates-2,0,0,0,0,0,0,0,0,0,0,0,0,0,http://content7.flixster.com/movie/10/39/86/10398633_det.jpg
60141,St. Trinian's,2007,st_trinians,4.3,40,13,27,32,4,10,2,8,20,3.4,19189,58,http://content7.flixster.com/movie/10/89/02/10890237_det.jpg
60147,Roman de gare,2007,roman_de_gare,7.1,73,64,9,87,7.2,24,20,4,83,3.7,1112,76,http://content7.flixster.com/movie/10/83/92/10839281_det.jpg
60161,Futurama: The Beast with a Billion Backs,2008,futurama_the_movie_beast_with_a_billion_backs,0,4,4,0,100,0,0,0,0,0,0,0,0,http://content8.flixster.com/movie/10/85/18/10851878_det.jpg
60189,Archangel,2005,1168888-archangel,0,1,1,0,100,0,0,0,0,0,0,0,0,http://content7.flixster.com/movie/34/10/75/3410753_det.jpg
60201,Sayat Nova,1968,sayat-nova-color-of-pomegranates,7.4,6,5,1,83,0,0,0,0,0,0,0,0,http://content9.flixster.com/movie/36/03/17/3603171_det.jpg
60237,Canicule,1984,,\N,\N,\N,\N,\N,\N,\N,\N,\N,\N,\N,\N,\N,\N
60286,Finding Amanda,2008,finding_amanda,5.2,41,17,24,41,5.5,14,5,9,35,2.8,997,30,http://content7.flixster.com/movie/10/86/10/10861037_det.jpg
60289,Kit Kittredge: An American Girl,2008,kit_kittredge_an_american_girl,6.7,96,75,21,78,7,24,22,2,91,3.2,19095,64,http://content8.flixster.com/movie/10/86/70/10867042_det.jpg
60291,Gonzo: The Life and Work of Dr. Hunter S. Thompson,2008,gonzo-the-life-and-work-of-dr-hunter-s-thompson,7.1,91,79,12,86,7.5,22,20,2,90,3.3,7310,79,http://content7.flixster.com/movie/10/89/03/10890357_det.jpg
60293,The Wackness,2008,wackness,6.3,124,85,39,68,6.5,25,19,6,76,3.6,8603,72,http://content8.flixster.com/movie/10/84/37/10843710_det.jpg
60295,Up the Yangtze,2007,up_the_yangtze,7.7,47,45,2,95,8.3,15,15,0,100,3.9,954,83,http://content7.flixster.com/movie/10/87/36/10873613_det.jpg
60309,Along Came Jones,1945,along_came_jones,0,4,1,3,25,0,0,0,0,0,0,0,0,http://content8.flixster.com/movie/30/35/303502_det.jpg
60322,Sleepwalking,2008,sleepwalking,4.2,57,10,47,17,4.3,22,4,18,18,3,8038,45,http://content7.flixster.com/movie/10/84/04/10840437_det.jpg
60333,Encounters at the End of the World,2007,1194818-encounters_at_the_end_of_the_world,7.6,105,98,7,93,8,21,21,0,100,3.4,4183,80,http://content9.flixster.com/movie/10/94/31/10943159_det.jpg
60336,Mauvais sang,1986,mauvais_sang,0,3,2,1,66,0,0,0,0,0,0,0,0,http://content6.flixster.com/movie/10/88/27/10882732_det.jpg
60341,Standard Operating Procedure,2008,,7.1,96,77,19,80,7.2,30,24,6,80,3.8,1257,78,http://content9.flixster.com/movie/10/87/25/10872551_det.jpg
60363,Zombie Strippers!,2008,zombie_strippers,4.6,61,24,37,39,4.3,11,3,8,27,2.6,3970,33,http://content9.flixster.com/movie/10/84/08/10840831_det.jpg
60389,Battle for Haditha,2007,battle_for_haditha,6,29,19,10,65,6.6,11,9,2,81,3.7,1153,73,http://content7.flixster.com/movie/10/83/82/10838213_det.jpg
60391,Aleksandra,2007,10008234-alexandra,7.5,51,47,4,92,8.3,11,11,0,100,3.6,547,69,http://content6.flixster.com/movie/10/84/92/10849204_det.jpg
60393,Transylvania,2006,transylvania,5.6,18,13,5,72,0,2,1,1,50,3.8,788,78,http://content8.flixster.com/movie/34/85/85/3485858_det.jpg
60397,Mamma Mia!,2008,mamma_mia,5.5,173,92,81,53,5.2,38,16,22,42,3.8,126612,76,http://content8.flixster.com/movie/10/84/27/10842754_det.jpg
60405,The Game,1997,1078955-game,7.2,43,30,13,69,7.2,11,7,4,63,3.5,23139,82,http://content9.flixster.com/movie/28/04/280403_det.jpg
60411,Erogotoshi-tachi yori: Jinruigaku ny√ªmon,1966,pornographers,8,8,8,0,100,0,0,0,0,0,0,0,0,http://content8.flixster.com/movie/61/11/83/6111838_det.jpg
60418,Kabluey,2007,kabluey,6.9,36,30,6,83,6.9,11,9,2,81,3.4,1396,65,http://content8.flixster.com/movie/10/84/12/10841298_det.jpg
60421,The Stone Angel,2007,10009890-stone_angel,5.4,21,9,12,42,6.1,8,4,4,50,3.4,966,59,http://content8.flixster.com/movie/10/84/94/10849410_det.jpg
60471,Rogue,2007,1173563-rogue,7.7,11,11,0,100,0,1,1,0,100,3.2,3997,52,http://content8.flixster.com/movie/93/52/22/9352226_det.jpg
60484,Waga seishun ni kuinashi,1946,no_regrets_for_our_youth,0,2,2,0,100,0,0,0,0,0,0,0,0,http://content9.flixster.com/movie/10/84/06/10840639_det.jpg
60487,"It's the Great Pumpkin, Charlie Brown",1966,its_the_great_pumpkin_charlie_brown,7.3,15,14,1,93,0,0,0,0,0,0,0,0,http://content9.flixster.com/movie/29/05/290591_det.jpg
60503,Katyn,2007,1207748-katyn,7.4,59,54,5,91,8.1,15,15,0,100,3.7,3505,75,http://content7.flixster.com/movie/10/87/32/10873261_det.jpg
60514,Journey to the Center of the Earth,2008,10008588-journey_3d,6,148,91,57,61,6.6,31,24,7,77,3.2,38002,55,http://content8.flixster.com/movie/10/88/25/10882502_det.jpg
60516,Meet Dave,2008,meet_dave,4.1,98,19,79,19,4.6,24,7,17,29,3,22234,42,http://content9.flixster.com/movie/10/86/17/10861791_det.jpg
60522,Kataude mashin g√¢ru,2008,machine_girl,6.4,8,5,3,62,0,3,2,1,66,3.5,2727,63,http://content9.flixster.com/movie/10/91/76/10917651_det.jpg
60524,August Rush,2007,august_rush,4.8,120,44,76,36,4.4,27,7,20,25,4,105941,84,http://content6.flixster.com/movie/96/76/16/9676160_det.jpg
60526,Death Defying Acts,2007,death_defying_acts,5,36,16,20,44,5.3,6,2,4,33,2.9,2068,31,http://content7.flixster.com/movie/10/41/06/10410653_det.jpg
60530,Naissance des pieuvres,2007,water_lilies,6.5,42,32,10,76,6.5,11,9,2,81,3.5,1175,65,http://content9.flixster.com/movie/10/87/68/10876899_det.jpg
60566,K√¶rlighed p√• film,2007,just-another-love-story-kaerlighed-pa-film,6.2,42,31,11,73,6.5,10,8,2,80,3.8,956,82,http://content6.flixster.com/movie/10/92/12/10921236_det.jpg
60590,La question humaine,2007,heartbeat_detector,6.5,25,19,6,76,7.2,9,8,1,88,3,290,46,http://content8.flixster.com/movie/10/86/51/10865194_det.jpg
60618,Moving McAllister,2007,moving_mcallister,2.8,10,1,9,10,0,1,1,0,100,2.8,1079,32,http://content6.flixster.com/movie/98/95/05/9895056_det.jpg
60647,Transsiberian,2008,transsiberian,7.2,75,68,7,90,7.3,17,16,1,94,3.4,6508,62,http://content7.flixster.com/movie/10/87/86/10878637_det.jpg
60649,Space Chimps,2008,1195801-space_chimps,4.7,89,32,57,35,4.5,17,8,9,47,2.8,24188,37,http://content9.flixster.com/movie/10/86/17/10861787_det.jpg
60654,Une vieille ma√Ætresse,2007,une_vieille_maitresse,6.7,90,68,22,75,7.6,21,19,2,90,3.4,1490,60,http://content7.flixster.com/movie/10/85/58/10855829_det.jpg
60674,Stargate: Continuum,2008,stargate_continuum,0,1,1,0,100,0,0,0,0,0,0,0,0,http://content7.flixster.com/movie/10/84/43/10844301_det.jpg
60688,Conspiracy,2008,conspiracy,0,2,0,2,0,0,1,0,1,0,2.5,968,22,http://content6.flixster.com/movie/10/84/07/10840768_det.jpg
60728,Steal a Pencil for Me,2007,steal_a_pencil_for_me,7.7,22,21,1,95,8.1,8,8,0,100,3.8,296,80,http://content9.flixster.com/movie/10/70/83/10708367_det.jpg
60735,Shotgun Stories,2007,shotgun_stories,7.3,40,37,3,92,7.1,10,9,1,90,3.8,1261,79,http://content6.flixster.com/movie/10/93/54/10935476_det.jpg
60745,Blast of Silence,1961,1192728-blast_of_silence,7,11,9,2,81,0,2,2,0,100,3.9,432,84,http://content9.flixster.com/movie/10/87/20/10872091_det.jpg
60753,Felon,2008,,6.4,21,13,8,61,6.1,10,5,5,50,3.8,5305,83,http://content8.flixster.com/movie/10/85/14/10851450_det.jpg
60756,Step Brothers,2008,1193743-step_brothers,5.5,176,96,80,54,5.1,34,16,18,47,3.6,77495,68,http://content6.flixster.com/movie/10/88/79/10887960_det.jpg
60758,Brideshead Revisited,2008,brideshead_revisited,6.1,126,79,47,62,6.5,30,21,9,70,3.2,6004,52,http://content7.flixster.com/movie/11/12/50/11125009_det.jpg
60760,The X Files: I Want to Believe,2008,x_files_2,4.8,155,48,107,30,4.5,30,7,23,23,2.8,52241,34,http://content9.flixster.com/movie/10/88/60/10886051_det.jpg
60763,American Teen,2008,american_teen,6.5,145,103,42,71,7,33,25,8,75,3,11887,59,http://content6.flixster.com/movie/10/88/03/10880356_det.jpg
60766,Man on Wire,2008,man_on_wire,8.4,145,145,0,100,8.4,32,32,0,100,4,10237,88,http://content6.flixster.com/movie/11/12/53/11125304_det.jpg
60832,Pathology,2008,10008496-pathology,4.7,19,9,10,47,0,4,2,2,50,3,12698,44,http://content7.flixster.com/movie/10/89/54/10895409_det.jpg
60894,The Edge of Love,2008,edge_of_love,5.1,55,20,35,36,4.5,13,4,9,30,3,18391,45,http://content7.flixster.com/movie/10/88/25/10882585_det.jpg
60937,The Mummy: Tomb of the Dragon Emperor,2008,mummy_tomb_of_the_dragon_emperor,3.7,161,21,140,13,3.7,32,3,29,9,3,79989,40,http://content8.flixster.com/movie/10/87/58/10875846_det.jpg
60939,Swing Vote,2008,swing_vote,5.1,143,53,90,37,5.3,29,15,14,51,3,24529,45,http://content8.flixster.com/movie/10/92/09/10920934_det.jpg
60941,The Midnight Meat Train,2008,10008617-midnight_meat_train,6.2,27,19,8,70,0,2,1,1,50,3.1,24490,49,http://content7.flixster.com/movie/10/84/53/10845365_det.jpg
60943,Frozen River,2008,frozen_river,7.3,125,109,16,87,7.9,26,24,2,92,3.2,9338,71,http://content6.flixster.com/movie/10/93/37/10933756_det.jpg
60946,Sixty Six,2006,sixty-six,5.9,48,31,17,64,5.8,14,9,5,64,3.5,1205,65,http://content9.flixster.com/movie/10/84/94/10849443_det.jpg
60948,Bottle Shock,2008,bottle_shock,5.6,116,56,60,48,6.1,29,16,13,55,3.3,4827,60,http://content9.flixster.com/movie/10/88/94/10889487_det.jpg
60950,Vicky Cristina Barcelona,2008,vicky_cristina_barcelona,6.9,188,154,34,81,7.2,35,29,6,82,3.6,45494,73,http://content7.flixster.com/movie/11/13/43/11134349_det.jpg
60983,Eve and the Fire Horse,2005,eve_and_the_fire_horse,7.1,12,10,2,83,0,4,3,1,75,3.8,936,79,http://content6.flixster.com/movie/10/87/81/10878140_det.jpg
60990,Kohayagawa-ke no aki,1961,10008436-the_end_of_summer,0,4,4,0,100,0,0,0,0,0,0,0,0,http://content6.flixster.com/movie/10/89/13/10891332_det.jpg
61011,The Walker,2007,the_walker,5.3,62,32,30,51,5.8,18,10,8,55,2.8,2117,31,http://content9.flixster.com/movie/10/64/12/10641207_det.jpg
61024,Pineapple Express,2008,pineapple_2008,0,0,0,0,0,0,0,0,0,0,0,0,0,http://content6.flixster.com/movie/10/84/11/10841156_det.jpg
61037,Stellet licht,2007,1217360-silent_light,0,4,4,0,100,0,0,0,0,0,0,0,0,http://content8.flixster.com/movie/10/50/41/10504146_det.jpg
61048,Expired,2007,expired,5.6,22,13,9,59,5.7,7,4,3,57,3,388,45,http://content8.flixster.com/movie/10/84/99/10849902_det.jpg
61071,The Sisterhood of the Traveling Pants 2,2008,sisterhood_of_the_traveling_pants_2,6,92,59,33,64,6.5,29,22,7,75,3.4,36715,68,http://content6.flixster.com/movie/10/88/52/10885212_det.jpg
61073,Hell Ride,2008,1192781-hell_ride,3.5,59,6,53,10,3.5,19,2,17,10,2.7,3570,33,http://content6.flixster.com/movie/10/83/85/10838528_det.jpg
61075,Elegy,2008,1194209-elegy,6.7,112,83,29,74,6.9,28,21,7,75,3.2,10624,60,http://content6.flixster.com/movie/10/91/81/10918124_det.jpg
61123,High School Musical,2006,high_school_musical,5.4,8,5,3,62,0,0,0,0,0,0,0,0,http://content9.flixster.com/movie/10/89/47/10894779_det.jpg
61132,Tropic Thunder,2008,tropic_thunder,7.1,221,183,38,82,6.9,40,33,7,82,3.5,90369,69,http://content9.flixster.com/movie/10/87/05/10870527_det.jpg
61160,Star Wars: The Clone Wars,2008,clone_wars,4.2,152,29,123,19,3.7,26,4,22,15,3.1,40439,46,http://content9.flixster.com/movie/11/13/24/11132487_det.jpg
61167,Henry Poole Is Here,2008,henry_poole_is_here,5,87,32,55,36,5.2,22,8,14,36,3.3,4016,56,http://content8.flixster.com/movie/10/85/59/10855902_det.jpg
61210,Mutant Chronicles,2008,mutant_chronicles,3.6,31,5,26,16,0,2,0,2,0,2.5,18903,27,http://content7.flixster.com/movie/10/84/95/10849585_det.jpg
61236,Vals Im Bashir,2008,waltz_with_bashir,8.4,134,129,5,96,8.4,31,30,1,96,4,15959,89,http://content8.flixster.com/movie/10/87/22/10872286_det.jpg
61240,L√•t den r√§tte komma in,2008,lat_den_ratte_komma_in,8.2,158,154,4,97,7.9,30,29,1,96,4.2,25695,89,http://content9.flixster.com/movie/10/92/37/10923703_det.jpg
61246,Hamlet,1996,1075422-hamlet,8.2,54,51,3,94,7.2,14,11,3,78,3.8,5816,86,http://content7.flixster.com/movie/10/94/26/10942625_det.jpg
61248,Death Race,2008,death_race,4.8,145,60,85,41,5.2,23,10,13,43,3.5,50505,69,http://content9.flixster.com/movie/10/88/81/10888107_det.jpg
61250,The House Bunny,2008,house_bunny,5.1,120,47,73,39,5.2,23,8,15,34,3.2,46575,55,http://content7.flixster.com/movie/10/85/72/10857237_det.jpg
61253,The Longshots,2008,longshots,5.2,68,28,40,41,5,19,7,12,36,3.5,8258,66,http://content7.flixster.com/movie/10/93/95/10939585_det.jpg
61255,The Rocker,2008,10009055-rocker,5.2,119,48,71,40,5.2,30,11,19,36,3.2,13841,52,http://content8.flixster.com/movie/10/85/72/10857242_det.jpg
61257,I.O.U.S.A.,2008,i_o_u_s_a,7.2,59,52,7,88,7.9,14,14,0,100,3.9,762,83,http://content9.flixster.com/movie/10/85/72/10857235_det.jpg
61262,Mirrors,2008,1197016-mirrors,3.9,81,12,69,14,3.5,10,0,10,0,3.2,31437,50,http://content8.flixster.com/movie/10/84/95/10849586_det.jpg
61267,Fly Me to the Moon,2008,fly_me_to_the_moon,3.9,78,14,64,17,4.2,20,4,16,20,2.6,1597,27,http://content9.flixster.com/movie/10/91/63/10916351_det.jpg
61279,Luci del variet√†,1950,variety_lights,8.1,10,10,0,100,0,1,1,0,100,3.6,271,68,http://content8.flixster.com/movie/10/22/15/10221518_det.jpg
61289,Sukiyaki Western Django,2007,sukiyaki_western_django,5.7,49,28,21,57,5.2,10,4,6,40,3.4,5732,59,http://content8.flixster.com/movie/11/12/51/11125186_det.jpg
61312,Noise,2007,noise,0,2,2,0,100,0,0,0,0,0,0,0,0,http://content8.flixster.com/movie/10/83/84/10838442_det.jpg
61323,Burn After Reading,2008,burn_after_reading,6.8,217,169,48,77,6.2,42,26,16,61,3.4,71248,64,http://content9.flixster.com/movie/11/15/10/11151031_det.jpg
61348,Disaster Movie,2008,disaster_movie,1.8,61,1,60,1,2.2,9,0,9,0,2.3,26026,28,http://content7.flixster.com/movie/10/87/73/10877361_det.jpg
61350,Babylon A.D.,2008,babylon_ad,3.2,97,7,90,7,2.8,13,0,13,0,2.8,29288,32,http://content9.flixster.com/movie/10/85/09/10850931_det.jpg
61352,Traitor,2008,traitor,6.1,160,98,62,61,5.7,33,18,15,54,3.4,19383,67,http://content8.flixster.com/movie/10/84/89/10848914_det.jpg
61354,College,2008,1191620-college,2.5,40,2,38,5,2.8,12,1,11,8,2.8,10667,35,http://content9.flixster.com/movie/10/84/13/10841311_det.jpg
61357,Trouble the Water,2008,trouble_the_water,8.1,70,68,2,97,8.1,21,21,0,100,4,896,86,http://content9.flixster.com/movie/10/85/72/10857247_det.jpg
61361,The Women,2008,10009516-women,3.9,142,18,124,12,3.8,34,4,30,11,3,20081,41,http://content6.flixster.com/movie/10/85/30/10853064_det.jpg
61394,The Onion Movie,2008,onion_movie,0,2,0,2,0,0,0,0,0,0,0,0,0,http://content7.flixster.com/movie/10/84/37/10843753_det.jpg
61401,The Spirit,2008,the_spirit,3.6,108,16,92,14,3.4,27,2,25,7,2.6,56971,30,http://content7.flixster.com/movie/10/87/76/10877625_det.jpg
61434,Oh! What a Lovely War,1969,oh_what_a_lovely_war,0,1,1,0,100,0,0,0,0,0,0,0,0,http://content6.flixster.com/movie/10/88/14/10881404_det.jpg
61465,Bangkok Dangerous,2008,bangkok_dangerous,3.4,92,8,84,8,3.3,15,1,14,6,2.8,23793,33,http://content6.flixster.com/movie/10/84/27/10842740_det.jpg
61470,The Boys in Company C,1978,boys_in_company_c,0,0,0,0,0,0,0,0,0,0,0,0,0,http://content7.flixster.com/movie/99/45/16/9945165_det.jpg
61473,Un secret,2007,un_secret,7,43,34,9,79,7.4,15,12,3,80,3.5,1538,62,http://content7.flixster.com/movie/10/87/83/10878333_det.jpg
61475,August Evening,2007,august_evening,7.1,23,21,2,91,6.7,9,7,2,77,3.8,206,68,http://content8.flixster.com/movie/10/90/33/10903318_det.jpg
61560,That's Black Entertainment,1990,,\N,\N,\N,\N,\N,\N,\N,\N,\N,\N,\N,\N,\N,\N
61628,Xiang ri kui,2005,10005901-sunflower,6.1,13,9,4,69,5.3,6,3,3,50,3.8,344,77,http://content8.flixster.com/movie/10/93/24/10932454_det.jpg
61634,Son of Lassie,1945,son_of_lassie,0,3,2,1,66,0,0,0,0,0,0,0,0,http://content9.flixster.com/movie/92/24/67/9224679_det.jpg
61646,Azuloscurocasinegro,2006,darkbluealmostblack,6.4,18,13,5,72,0,4,2,2,50,3.9,1509,83,http://content7.flixster.com/movie/48/61/58/4861581_det.jpg
61678,The Foot Fist Way,2006,the-foot-fist-way,5.5,81,43,38,53,6.5,24,17,7,70,3.1,2433,46,http://content8.flixster.com/movie/10/91/32/10913266_det.jpg
61697,Righteous Kill,2008,righteous_kill,4.1,138,27,111,19,3.8,28,3,25,10,3.1,29471,45,http://content6.flixster.com/movie/10/84/96/10849660_det.jpg
61705,Lakeview Terrace,2008,1196215-lakeview_terrace,5.5,153,70,83,45,5.7,31,17,14,54,3.1,23932,44,http://content9.flixster.com/movie/10/85/92/10859299_det.jpg
61707,Ladr√≥n que roba a ladr√≥n,2007,1184137-ladron_que_roba_a_ladron,5.6,27,17,10,62,6,10,7,3,70,3.7,1644,73,http://content6.flixster.com/movie/94/81/37/9481372_det.jpg
61724,Varjoja paratiisissa,1986,shadows_in_paradise,0,1,1,0,100,0,0,0,0,0,0,0,0,http://content7.flixster.com/movie/10/84/00/10840065_det.jpg
61729,Ghost Town,2008,1190970-ghost_town,6.9,173,147,26,84,6.9,35,30,5,85,3.3,23409,61,http://content9.flixster.com/movie/10/88/24/10882443_det.jpg
61742,Maradona by Kusturica,2008,maradona-by-kusturica,0,0,0,0,0,0,0,0,0,0,0,0,0,http://content7.flixster.com/movie/10/85/22/10852269_det.jpg
61816,Import/Export,2007,importexport,6.9,29,24,5,82,6.8,5,4,1,80,3.8,567,76,http://content8.flixster.com/movie/10/28/81/10288134_det.jpg
61818,The Crow: Wicked Prayer,2005,crow_wicked_prayer,2,5,0,5,0,0,0,0,0,0,0,0,0,http://content8.flixster.com/movie/10/93/21/10932154_det.jpg
61862,En la cama,2005,1190240-en_la_cama,5.4,5,2,3,40,0,1,1,0,100,3.6,471,66,http://content7.flixster.com/movie/10/44/98/10449869_det.jpg
61931,Private Parts,1997,private-parts,0,0,0,0,0,0,0,0,0,0,0,0,0,http://content7.flixster.com/movie/10/92/42/10924221_det.jpg
61934,Freebie and the Bean,1974,freebie_and_the_bean,0,4,2,2,50,0,0,0,0,0,0,0,0,http://content6.flixster.com/movie/19/69/93/1969932_det.jpg
61937,Gycklarnas afton,1953,sawdust_and_tinsel,8,9,9,0,100,0,1,1,0,100,4,575,83,http://content6.flixster.com/movie/93/13/94/9313944_det.jpg
61941,Humboldt County,2008,humboldt_county,5.7,19,11,8,57,5.7,5,3,2,60,3.4,626,60,http://content9.flixster.com/movie/10/90/33/10903323_det.jpg
61950,Boot Camp,2007,boot-camp,0,0,0,0,0,0,0,0,0,0,0,0,0,http://content7.flixster.com/movie/10/91/79/10917945_det.jpg
61961,The Beach,2000,beach,4.4,116,22,94,18,3.9,31,4,27,12,2.9,21479,59,http://content6.flixster.com/movie/10/88/39/10883940_det.jpg
61967,Sanma no aji,1962,sanma-no-aji-an-autumn-afternoon-the-widower,7.8,11,10,1,90,0,3,2,1,66,4.2,448,89,http://content7.flixster.com/movie/54/85/78/5485789_det.jpg
61970,Project Moon Base,1953,project-moonbase,0,1,0,1,0,0,0,0,0,0,0,0,0,http://content9.flixster.com/movie/10/84/81/10848107_det.jpg
61986,Appaloosa,2008,10008785-appaloosa,6.6,156,119,37,76,6.6,34,25,9,73,3.2,19629,55,http://content6.flixster.com/movie/10/85/47/10854708_det.jpg
61991,Miracle at St. Anna,2008,miracle_at_st_anna,5.2,113,38,75,33,4.8,32,8,24,25,3.3,8435,56,http://content7.flixster.com/movie/10/91/95/10919533_det.jpg
62000,Katok i skripka,1961,katok-i-skripka-the-steamroller-and-the-violinthe-skating-rink-and-the-violin,7.6,6,5,1,83,0,1,1,0,100,3.9,347,80,http://content8.flixster.com/movie/97/90/87/9790870_det.jpg
62010,K√§sky,2008,kasky-tears-of-april,0,0,0,0,0,0,0,0,0,0,0,0,0,http://content8.flixster.com/movie/10/92/67/10926718_det.jpg
62049,Nineteen Eighty-Four,1984,1000055-1984,6.4,14,11,3,78,0,1,1,0,100,3.5,17133,70,http://content7.flixster.com/movie/10/88/05/10880581_det.jpg
62081,Eagle Eye,2008,eagle_eye,4.6,172,47,125,27,4.7,31,8,23,25,3.7,73300,72,http://content8.flixster.com/movie/10/85/22/10852222_det.jpg
62113,How to Lose Friends & Alienate People,2008,how_to_lose_friends_and_alienate_people,5,108,40,68,37,4.3,26,6,20,23,3.1,16565,48,http://content7.flixster.com/movie/10/91/74/10917441_det.jpg
62137,Nights in Rodanthe,2008,nights_in_rodanthe,4.8,128,40,88,31,4.4,27,6,21,22,3.3,26775,56,http://content7.flixster.com/movie/10/85/75/10857561_det.jpg
62153,Look Back in Anger,1959,1012672-look_back_in_anger,7.7,8,7,1,87,0,0,0,0,0,0,0,0,http://content6.flixster.com/movie/10/89/06/10890600_det.jpg
62155,Nick and Norah's Infinite Playlist,2008,nick_and_norahs_infinite_playlist,6.5,169,123,46,72,6.9,33,27,6,81,3.5,38982,67,http://content6.flixster.com/movie/10/85/14/10851448_det.jpg
62198,Marjoe,1972,marjoe,7.9,5,5,0,100,0,2,2,0,100,3.9,94,84,http://content9.flixster.com/movie/10/85/25/10852563_det.jpg
62203,Martyrs,2008,martyrs,5.7,24,12,12,50,0,1,0,1,0,3.6,4312,71,http://content9.flixster.com/movie/10/87/72/10877215_det.jpg
62235,Trois couleurs: Rouge,1994,1058966-red,8.5,40,40,0,100,8.2,10,10,0,100,4.2,9569,94,http://content7.flixster.com/movie/10/87/54/10875473_det.jpg
62245,Jalsaghar,1958,jalsaghar,9,9,9,0,100,0,4,4,0,100,4.4,358,95,http://content8.flixster.com/movie/66/22/77/6622778_det.jpg
62250,Gomorra,2008,gomorrah,7.6,136,124,12,91,8.1,34,33,1,97,3.5,21931,67,http://content6.flixster.com/movie/10/92/76/10927660_det.jpg
62254,Ososhiki,1984,,\N,\N,\N,\N,\N,\N,\N,\N,\N,\N,\N,\N,\N,\N
62265,The Accidental Husband,2008,accidental_husband,2.8,16,1,15,6,0,0,0,0,0,0,0,0,http://content6.flixster.com/movie/10/86/05/10860592_det.jpg
62293,The Duchess,2008,10009493-duchess,6.3,161,98,63,60,6.6,35,24,11,68,3.5,22537,69,http://content8.flixster.com/movie/10/85/97/10859746_det.jpg
62299,Alone in the Dark,2005,alone_in_the_dark,1.7,116,1,115,0,1.7,26,0,26,0,2.1,8641,21,http://content6.flixster.com/movie/10/92/96/10929640_det.jpg
62331,Dead Leaves,2004,1135165-dead_leaves,0,0,0,0,0,0,0,0,0,0,0,0,0,http://content8.flixster.com/movie/30/22/302202_det.jpg
62336,FLCL,2000,flcl-fooly-cooly,0,0,0,0,0,0,0,0,0,0,0,0,0,http://content9.flixster.com/movie/88/16/90/8816907_det.jpg
62344,Rachel Getting Married,2008,rachel_getting_married,7.5,187,160,27,85,7.8,41,37,4,90,3.3,19208,61,http://content7.flixster.com/movie/10/92/21/10922197_det.jpg
62374,Body of Lies,2008,10009225-body_of_lies,5.8,194,102,92,52,5.6,40,21,19,52,3.5,38376,66,http://content7.flixster.com/movie/10/88/79/10887933_det.jpg
62376,City of Ember,2008,city_of_ember,5.7,121,63,58,52,5.9,27,16,11,59,3.2,14662,47,http://content8.flixster.com/movie/10/88/95/10889518_det.jpg
62378,Magicians,2007,magicians,4.2,7,2,5,28,0,1,0,1,0,0,0,0,http://content9.flixster.com/movie/10/87/68/10876855_det.jpg
62390,Autism: The Musical,2007,autism_the_musical,0,2,2,0,100,0,1,1,0,100,4.1,335,89,http://content8.flixster.com/movie/10/86/16/10861614_det.jpg
62394,Max Payne,2008,max_payne,3.7,128,21,107,16,3.4,26,2,24,7,2.9,48802,36,http://content7.flixster.com/movie/10/85/38/10853865_det.jpg
62434,Zack and Miri Make a Porno,2008,1190296-zack_and_miri_make_a_porno,6.1,183,119,64,65,5.6,36,17,19,47,3.6,63027,70,http://content7.flixster.com/movie/11/12/64/11126437_det.jpg
62437,W.,2008,w_2008,6,205,123,82,60,5.4,40,17,23,42,3,24739,43,http://content8.flixster.com/movie/10/86/15/10861590_det.jpg
62439,My Best Friend's Girl,2008,10008611-my_best_friends_girl,3.5,56,8,48,14,3.7,12,2,10,16,3.2,22662,52,http://content6.flixster.com/movie/10/92/18/10921856_det.jpg
62511,"Synecdoche, New York",2008,synecdoche_new_york,6.6,172,116,56,67,6.4,35,22,13,62,3.6,14060,69,http://content8.flixster.com/movie/10/83/85/10838598_det.jpg
62526,The Drowning Pool,1975,drowning_pool,5.4,12,7,5,58,0,4,1,3,25,3.3,312,48,http://content8.flixster.com/movie/10/88/91/10889186_det.jpg
62553,The Secret Life of Bees,2008,secret_life_of_bees,5.9,131,75,56,57,6.2,27,17,10,62,3.7,35593,79,http://content7.flixster.com/movie/10/89/03/10890353_det.jpg
62577,Flash of Genius,2008,flash_of_genius,6,102,60,42,58,5.2,28,10,18,35,3.4,3988,56,http://content6.flixster.com/movie/10/88/40/10884080_det.jpg
62586,An American Carol,2008,an_american_carol,2.9,44,5,39,11,3.1,11,0,11,0,2.9,6246,48,http://content7.flixster.com/movie/10/87/72/10877241_det.jpg
62644,Die Welle,2008,1206901-wave,5.8,13,9,4,69,0,1,1,0,100,3.9,4370,83,http://content8.flixster.com/movie/10/84/05/10840550_det.jpg
62660,Les deux mondes,2007,deux_mondes,0,0,0,0,0,0,0,0,0,0,0,0,0,http://content7.flixster.com/movie/10/61/43/10614341_det.jpg
62662,Tokyo-Ga,1985,tokyo_ga_2003,0,0,0,0,0,0,0,0,0,0,0,0,0,http://content8.flixster.com/movie/10/29/65/10296518_det.jpg
62669,Kuroi kawa,1957,kuroi-kawa,0,0,0,0,0,0,0,0,0,0,0,0,0,http://content9.flixster.com/movie/10/84/85/10848507_det.jpg
62671,Fallout,1998,,\N,\N,\N,\N,\N,\N,\N,\N,\N,\N,\N,\N,\N,\N
62718,"Angus, Thongs and Perfect Snogging",2008,angus_thongs_and_perfect_snogging,6,24,17,7,70,0,2,1,1,50,3.9,6295,76,http://content8.flixster.com/movie/10/85/35/10853566_det.jpg
62721,Bad Eggs,2003,bad-eggs,0,0,0,0,0,0,0,0,0,0,0,0,0,http://content9.flixster.com/movie/21/54/91/2154919_det.jpg
62729,Niko - Lent√§j√§n poika,2008,niko-and-the-way-to-the-stars,0,0,0,0,0,0,0,0,0,0,0,0,0,http://images.rottentomatoescdn.com/images/defaults/poster_default.gif
62733,Quarantine,2008,1196221-quarantine,5.7,77,45,32,58,4.8,9,4,5,44,3,32796,47,http://content9.flixster.com/movie/10/84/99/10849955_det.jpg
62764,Black Moon Rising,1986,black_moon_rising,3.9,9,3,6,33,0,2,1,1,50,2.8,1020,32,http://content9.flixster.com/movie/28/05/280515_det.jpg
62788,Lost Boys: The Tribe,2008,boy_a,3.2,7,0,7,0,0,0,0,0,0,0,0,0,http://content9.flixster.com/movie/10/87/11/10871103_det.jpg
62792,Pride and Glory,2008,pride_and_glory,5.1,150,51,99,34,5.3,30,9,21,30,3.3,23470,54,http://content9.flixster.com/movie/10/85/89/10858931_det.jpg
62796,Fifty Pills,2006,fifty_pills,0,1,0,1,0,0,0,0,0,0,0,0,0,http://content9.flixster.com/movie/61/74/96/6174963_det.jpg
62799,The Express,2008,1185801-the_express,6.2,114,70,44,61,6.4,28,19,9,67,3.1,11362,74,http://content6.flixster.com/movie/10/85/78/10857840_det.jpg
62801,Kozure √îkami: Shinikazeni mukau ubaguruma,1972,lone-wolf-and-cub-baby-cart-to-hades,0,1,1,0,100,0,0,0,0,0,0,0,0,http://content7.flixster.com/movie/11/14/96/11149669_det.jpg
62803,Kozure √îkami: Oya no kokoro ko no kokoro,1972,lone-wolf-and-cub-baby-cart-in-peril,0,1,1,0,100,0,0,0,0,0,0,0,0,http://content6.flixster.com/movie/31/38/313816_det.jpg
62834,Babylon 5: The Legend of the Rangers: To Live and Die in Starlight,2002,babylon_5_the_legend_of_the_rangers,0,0,0,0,0,0,0,0,0,0,0,0,0,http://content6.flixster.com/movie/35/68/01/3568016_det.jpg
62836,Babylon 5: The Lost Tales,2007,babylon_5_the_lost_tales,0,0,0,0,0,0,0,0,0,0,0,0,0,http://content7.flixster.com/movie/96/34/50/9634505_det.jpg
62849,RocknRolla,2008,rocknrolla,6,140,84,56,60,6.1,35,22,13,62,3.6,25930,72,http://content8.flixster.com/movie/10/86/18/10861882_det.jpg
62851,Zen Noir,2004,zen_noir,3.4,14,4,10,28,3.9,5,2,3,40,3.9,274,70,http://content6.flixster.com/movie/27/36/50/2736508_det.jpg
62912,High School Musical 3: Senior Year,2008,1194524-high_school_musical_3_senior_year,5.9,127,83,44,65,6,27,18,9,66,3.6,80210,76,http://content9.flixster.com/movie/10/89/47/10894743_det.jpg
62916,The Wicked Lady,1945,1023635-wicked_lady,0,0,0,0,0,0,0,0,0,0,0,0,0,http://content7.flixster.com/movie/37/13/18/3713181_det.jpg
62920,I Can Get It for You Wholesale,1951,,\N,\N,\N,\N,\N,\N,\N,\N,\N,\N,\N,\N,\N,\N
62956,Futurama: Bender's Game,2008,futurama_benders_game,0,1,0,1,0,0,0,0,0,0,0,0,0,http://content8.flixster.com/movie/10/92/05/10920586_det.jpg
62970,Tin Man,2007,,\N,\N,\N,\N,\N,\N,\N,\N,\N,\N,\N,\N,\N,\N
62972,Into the West,1992,1046771-into_the_west,6.4,10,7,3,70,0,2,1,1,50,3.6,744,73,http://content7.flixster.com/movie/11/13/07/11130701_det.jpg
62999,Madagascar: Escape 2 Africa,2008,madagascar_escape_2_africa,5.9,145,93,52,64,6.3,30,18,12,60,3.7,89627,73,http://content7.flixster.com/movie/10/84/92/10849221_det.jpg
63033,Blindness,2008,1188215-blindness,5.2,150,63,87,42,5,30,8,22,26,3.1,17761,49,http://content6.flixster.com/movie/10/85/34/10853428_det.jpg
63062,Changeling,2008,1191742_changeling,6.3,190,117,73,61,5.6,39,17,22,43,3.8,63438,84,http://content7.flixster.com/movie/10/86/09/10860981_det.jpg
63069,Gin√Æ piggu 2: Chiniku no hana,1985,za-ginipiggu-2-chiniku-no-hana-guinea-pig-2-flowers-of-flesh-and-blood,0,0,0,0,0,0,0,0,0,0,0,0,0,http://content9.flixster.com/movie/10/92/51/10925107_det.jpg
63082,Slumdog Millionaire,2008,slumdog_millionaire,8.2,220,206,14,93,8.2,38,36,2,94,4,328969,90,http://content9.flixster.com/movie/10/86/47/10864783_det.jpg
63113,Quantum of Solace,2008,quantum_of_solace,6.1,241,154,87,63,5.6,41,15,26,36,3.5,125850,62,http://content9.flixster.com/movie/10/86/77/10867703_det.jpg
63119,Filth and Wisdom,2008,filth_and_wisdom,3.9,58,15,43,25,4.2,23,7,16,30,3,1070,42,http://content6.flixster.com/movie/10/86/05/10860500_det.jpg
63121,A Tale of Two Cities,1958,1020815-tale_of_two_cities,0,0,0,0,0,0,0,0,0,0,0,0,0,http://content6.flixster.com/movie/10/86/16/10861668_det.jpg
63131,Role Models,2008,role_models,6.5,152,117,35,76,6.4,34,23,11,67,3.7,63260,75,http://content8.flixster.com/movie/10/85/95/10859522_det.jpg
63181,T√¥ky√¥ zankoku keisatsu,2008,tokyo_gore_police,6.8,9,9,0,100,0,3,3,0,100,3.4,1468,61,http://content7.flixster.com/movie/10/88/12/10881249_det.jpg
63187,Kozara,1962,,\N,\N,\N,\N,\N,\N,\N,\N,\N,\N,\N,\N,\N,\N
63189,Sauna,2008,1216162-sauna,0,0,0,0,0,0,0,0,0,0,0,0,0,http://content7.flixster.com/movie/10/85/91/10859153_det.jpg
63194,Ca√≥tica Ana,2007,chaotic_ana,0,2,1,1,50,0,1,1,0,100,3.5,1071,65,http://content8.flixster.com/movie/10/13/72/10137278_det.jpg
63222,JCVD,2008,jcvd,7,98,83,15,84,7.1,25,21,4,84,3.5,8534,71,http://content7.flixster.com/movie/10/86/16/10861693_det.jpg
63237,Ils se mari√®rent et eurent beaucoup d'enfants,2004,1144859-happily_ever_after,6,40,23,17,57,6.3,19,12,7,63,3.6,1061,70,http://content8.flixster.com/movie/46/02/41/4602418_det.jpg
63239,Cinderella,1950,1004186-cinderella,7.3,26,24,2,92,8,5,5,0,100,3.5,63946,76,http://content9.flixster.com/movie/25/06/250619_det.jpg
63276,Kur√¥zu zero,2007,crows_zero,0,0,0,0,0,0,0,0,0,0,0,0,0,http://content6.flixster.com/movie/10/84/87/10848756_det.jpg
63310,Lord of War,2005,lord_of_war,6.2,141,86,55,60,5.6,33,14,19,42,3.6,51125,84,http://content6.flixster.com/movie/25/01/250116_det.jpg
63329,Joulutarina,2007,christmas_story-2009,0,0,0,0,0,0,0,0,0,0,0,0,0,http://content9.flixster.com/movie/10/93/70/10937035_det.jpg
63339,Todas las azafatas van al cielo,2002,todas_las_azafatas_van_al_cielo,0,0,0,0,0,0,0,0,0,0,0,0,0,http://content7.flixster.com/movie/10/87/76/10877633_det.jpg
63393,Camp Rock,2008,camp_rock,5.2,5,1,4,20,0,0,0,0,0,0,0,0,http://content9.flixster.com/movie/10/91/95/10919567_det.jpg
63433,Farscape: The Peacekeeper Wars,2004,farscape_the_peacekeeper_wars,0,0,0,0,0,0,0,0,0,0,0,0,0,http://content6.flixster.com/movie/10/87/33/10873336_det.jpg
63436,Saw V,2008,saw_v,2.9,69,9,60,13,2.7,13,1,12,7,3.5,64670,63,http://content9.flixster.com/movie/10/85/78/10857839_det.jpg
63446,Un conte de No√´l,2008,10009929-a_christmas_tale,7.5,111,97,14,87,7.9,26,24,2,92,3.4,12013,64,http://content6.flixster.com/movie/10/87/03/10870372_det.jpg
63458,Critters 4,1992,critters_4,0,2,0,2,0,0,0,0,0,0,0,0,0,http://content7.flixster.com/movie/26/51/265125_det.jpg
63479,Sex Drive,2008,sex_drive,5.3,107,49,58,45,5.8,25,13,12,52,3.4,18987,61,http://content6.flixster.com/movie/10/87/99/10879900_det.jpg
63481,Soul Men,2008,10009635-soul_men,5,97,44,53,45,5.6,29,17,12,58,3.3,12766,61,http://content6.flixster.com/movie/10/92/10/10921036_det.jpg
63540,Beverly Hills Chihuahua,2008,10008587-beverly_hills_chihuahua,5,93,38,55,40,5.5,19,9,10,47,3.2,35658,56,http://content9.flixster.com/movie/10/87/76/10877623_det.jpg
63617,Christmas on Mars,2008,christmas_on_mars,5.5,6,3,3,50,0,4,2,2,50,3.3,530,56,http://content6.flixster.com/movie/10/88/98/10889800_det.jpg
63647,Goy√¥kiba,1972,goyokiba-hanzo-the-razor-sword-of-justice,0,2,2,0,100,0,0,0,0,0,0,0,0,http://content6.flixster.com/movie/10/83/93/10839376_det.jpg
63662,Joi gin a long,1999,where_a_good_man_goes,0,1,1,0,100,0,0,0,0,0,0,0,0,http://content6.flixster.com/movie/10/85/24/10852472_det.jpg
63676,Tanin no kao,1966,face_of_another,7.4,6,6,0,100,0,1,1,0,100,4.1,598,90,http://content8.flixster.com/movie/93/50/55/9350550_det.jpg
63698,√ú√ß maymun,2008,three_monkeys,6.7,56,43,13,76,7.7,13,12,1,92,3.6,1239,72,http://content8.flixster.com/movie/11/13/29/11132934_det.jpg
63760,Bellissima,1951,1054231-bellissima,0,2,2,0,100,0,1,1,0,100,4,268,88,http://content6.flixster.com/movie/10/51/38/10513844_det.jpg
63768,Irezumi ichidai,1965,tattooed_life,0,0,0,0,0,0,0,0,0,0,0,0,0,http://content6.flixster.com/movie/10/84/30/10843012_det.jpg
63772,Bullfighter and the Lady,1951,bullfighter_and_the_lady,0,1,0,1,0,0,0,0,0,0,0,0,0,http://content6.flixster.com/movie/10/84/02/10840264_det.jpg
63793,Wagon Master,1950,wagon_master,0,4,4,0,100,0,0,0,0,0,0,0,0,http://content6.flixster.com/movie/10/86/72/10867232_det.jpg
63806,Ring of Darkness,2004,ring_of_darkness,0,0,0,0,0,0,0,0,0,0,0,0,0,http://content7.flixster.com/movie/28/02/280297_det.jpg
63808,Entre les murs,2008,the_class,8.1,143,139,4,97,8.3,33,33,0,100,3.8,6106,80,http://content8.flixster.com/movie/10/88/26/10882622_det.jpg
63853,Australia,2008,australia,5.9,199,109,90,54,5.3,38,18,20,47,3.5,75143,69,http://content7.flixster.com/movie/10/87/41/10874173_det.jpg
63859,Bolt,2008,bolt,7.2,174,154,20,88,6.6,31,24,7,77,3.6,68805,76,http://content7.flixster.com/movie/10/87/51/10875137_det.jpg
63876,Milk,2008,milk,8,217,203,14,93,8.3,38,36,2,94,3.9,55245,88,http://content8.flixster.com/movie/10/95/34/10953470_det.jpg
63989,The Devil-Doll,1936,the-devildoll-the-witch-of-timbuctoo,0,0,0,0,0,0,0,0,0,0,0,0,0,http://content6.flixster.com/movie/10/87/02/10870292_det.jpg
63992,Twilight,2008,twilight,5.5,196,98,98,50,5.9,36,20,16,55,4.1,256646,82,http://content9.flixster.com/movie/10/88/60/10886003_det.jpg
64030,Transporter 3,2008,transporter_3,4.8,105,39,66,37,4.7,23,7,16,30,3.4,58914,58,http://content7.flixster.com/movie/10/87/41/10874161_det.jpg
64032,Four Christmases,2008,four_christmases,4.3,139,35,104,25,4,27,5,22,18,3.3,79552,52,http://content7.flixster.com/movie/10/87/64/10876473_det.jpg
64034,The Boy in the Striped Pyjamas,2008,boy_in_the_striped_pajamas,6.2,132,84,48,63,6.3,28,18,10,64,3.9,31826,85,http://content7.flixster.com/movie/10/89/00/10890053_det.jpg
64114,Fireproof,2008,10010214-fireproof,4.4,20,8,12,40,5.2,6,3,3,50,4.2,14600,87,http://content8.flixster.com/movie/10/85/43/10854314_det.jpg
64116,Igor,2008,10009636-igor,4.8,87,31,56,35,4.2,18,3,15,16,3,18397,43,http://content9.flixster.com/movie/10/85/95/10859539_det.jpg
64229,Cadillac Records,2008,cadillac_records,6.1,118,79,39,66,6.5,33,23,10,69,3.3,13310,64,http://content9.flixster.com/movie/10/88/94/10889479_det.jpg
64231,Punisher: War Zone,2008,punisher_war_zone,4.2,96,25,71,26,3.7,21,1,20,4,3,29393,47,http://content6.flixster.com/movie/10/88/11/10881196_det.jpg
64245,The Bellboy,1960,bellboy,6.9,9,6,3,66,0,0,0,0,0,0,0,0,http://content6.flixster.com/movie/29/39/293924_det.jpg
64249,Shrek the Halls,2007,shrek_the_halls,0,2,1,1,50,0,0,0,0,0,0,0,0,http://content6.flixster.com/movie/10/57/78/10577820_det.jpg
64273,Les amants,1958,1037728-lovers,7.3,8,8,0,100,0,0,0,0,0,0,0,0,http://content8.flixster.com/movie/10/61/30/10613082_det.jpg
64278,The Pervert's Guide to Cinema,2006,the-perverts-guide-to-cinema,7.1,20,18,2,90,7.6,9,9,0,100,4,801,84,http://content9.flixster.com/movie/10/92/55/10925507_det.jpg
64280,Britannia Hospital,1982,britannia_hospital,6.8,5,3,2,60,0,0,0,0,0,0,0,0,http://content6.flixster.com/movie/10/88/30/10883016_det.jpg
64283,Yoru no onnatachi,1948,,\N,\N,\N,\N,\N,\N,\N,\N,\N,\N,\N,\N,\N,\N
64285,Wallace and Gromit in 'A Matter of Loaf and Death',2008,wallace_and_gromit_a_matter_of_loaf_and_death_pands,0,1,1,0,100,0,0,0,0,0,0,0,0,http://content8.flixster.com/movie/10/88/27/10882770_det.jpg
64288,Ace of Hearts,2008,,\N,\N,\N,\N,\N,\N,\N,\N,\N,\N,\N,\N,\N,\N
64338,Gypsy,1962,1009076-gypsy,6.4,11,8,3,72,0,0,0,0,0,0,0,0,http://content6.flixster.com/movie/28/63/286316_det.jpg
64368,Ninja III: The Domination,1984,ninja_3_the_domination,0,1,0,1,0,0,0,0,0,0,0,0,0,http://content7.flixster.com/movie/12/31/67/1231673_det.jpg
64418,A Man Named Pearl,2006,a_man_named_pearl,6.8,29,22,7,75,7,9,8,1,88,4,248,86,http://content6.flixster.com/movie/10/85/28/10852816_det.jpg
64427,Much Ado About Something,2001,,\N,\N,\N,\N,\N,\N,\N,\N,\N,\N,\N,\N,\N,\N
64497,The Day the Earth Stood Still,1951,1005371-day_the_earth_stood_still,8,50,47,3,94,7,5,4,1,80,3.8,8999,86,http://content7.flixster.com/movie/10/87/31/10873109_det.jpg
64499,Che: Part One,2008,1221112-che,6.3,128,84,44,65,5.6,24,14,10,58,3.7,10315,76,http://content6.flixster.com/movie/10/88/49/10884940_det.jpg
64501,Che: Part Two,2008,che_part_two,6.5,40,31,9,77,0,3,2,1,66,3.5,6290,65,http://content7.flixster.com/movie/10/88/12/10881201_det.jpg
64508,Starship Troopers 3: Marauder,2008,starship_troopers_3,5.4,5,3,2,60,0,0,0,0,0,0,0,0,http://content9.flixster.com/movie/10/85/24/10852427_det.jpg
64519,Boomerang,1992,1039796-boomerang,4.8,27,10,17,37,5.4,8,4,4,50,2.8,4751,55,http://content6.flixster.com/movie/26/81/268128_det.jpg
64575,Doubt,2008,doubt,6.9,204,159,45,77,6.4,40,28,12,70,3.7,86761,75,http://content9.flixster.com/movie/10/88/40/10884051_det.jpg
64611,The Forgotten,2004,forgotten,5,168,51,117,30,4.7,34,10,24,29,2.9,13766,47,http://content6.flixster.com/movie/25/55/255520_det.jpg
64614,Gran Torino,2008,gran_torino,7.1,211,169,42,80,6.7,39,28,11,71,4.2,193304,90,http://content8.flixster.com/movie/10/88/71/10887170_det.jpg
64620,Frost/Nixon,2008,frostnixon,7.9,216,198,18,91,7.7,41,37,4,90,3.8,38396,86,http://content6.flixster.com/movie/10/87/76/10877620_det.jpg
64622,The Reader,2008,reader,6.3,183,112,71,61,6,35,19,16,54,3.7,89822,78,http://content8.flixster.com/movie/10/87/76/10877626_det.jpg
64701,Il y a longtemps que je t'aime,2008,ive_loved_you_so_long,7.4,119,106,13,89,7.7,32,31,1,96,3.9,6732,85,http://content8.flixster.com/movie/10/91/38/10913818_det.jpg
64716,Seven Pounds,2008,seven_pounds,4.6,180,48,132,26,5,36,13,23,36,3.6,143024,77,http://content6.flixster.com/movie/10/87/76/10877624_det.jpg
64750,Pin,1988,pin,0,0,0,0,0,0,0,0,0,0,0,0,0,http://content8.flixster.com/movie/27/76/277618_det.jpg
64839,The Wrestler,2008,the_wrestler,8.3,207,202,5,97,8.2,37,36,1,97,3.9,57550,86,http://content6.flixster.com/movie/10/87/76/10877628_det.jpg
64900,Sien nui yau wan II yan gaan do,1990,chinese_ghost_story_ii,0,1,1,0,100,0,0,0,0,0,0,0,0,http://content9.flixster.com/movie/10/93/51/10935119_det.jpg
64903,The Nazis Strike,1943,,\N,\N,\N,\N,\N,\N,\N,\N,\N,\N,\N,\N,\N,\N
64906,The Battle of Britain,1943,the-battle-of-britain1943,0,0,0,0,0,0,0,0,0,0,0,0,0,http://content8.flixster.com/movie/10/85/97/10859762_det.jpg
64918,Petites coupures,2003,petites_coupures,0,4,2,2,50,0,0,0,0,0,0,0,0,http://content8.flixster.com/movie/10/85/34/10853430_det.jpg
64921,Arabian Nights,2000,1097260-arabian_nights,0,3,2,1,66,0,0,0,0,0,0,0,0,http://content8.flixster.com/movie/11/15/05/11150538_det.jpg
64926,The Battle of Russia,1943,,\N,\N,\N,\N,\N,\N,\N,\N,\N,\N,\N,\N,\N,\N
64930,The More the Merrier,1943,more_the_merrier,8.2,12,12,0,100,0,2,2,0,100,3.9,428,85,http://content8.flixster.com/movie/29/62/296218_det.jpg
64942,Tuya de hun shi,2006,tuya-de-hun-shi-tuyas-marriage,7.1,31,28,3,90,6.9,11,9,2,81,3.8,595,80,http://content8.flixster.com/movie/10/41/07/10410778_det.jpg
64957,The Curious Case of Benjamin Button,2008,curious_case_of_benjamin_button,7.1,228,165,63,72,6.9,37,28,9,75,3.7,216019,81,http://content9.flixster.com/movie/10/86/44/10864467_det.jpg
64959,Divide and Conquer,1943,,\N,\N,\N,\N,\N,\N,\N,\N,\N,\N,\N,\N,\N,\N
64969,Yes Man,2008,yes_man,5.2,144,62,82,43,4.9,31,12,19,38,3.7,141478,72,http://content8.flixster.com/movie/10/85/26/10852650_det.jpg
64976,Hexed,1993,hexed,2,8,1,7,12,0,2,0,2,0,0,0,0,http://content7.flixster.com/movie/10/92/33/10923349_det.jpg
64983,Valkyrie,2008,valkyrie,6,185,113,72,61,6,37,22,15,59,3.5,113378,66,http://content9.flixster.com/movie/10/86/48/10864803_det.jpg
64986,Birds of America,2008,10008685-birds_of_america,0,4,0,4,0,0,2,0,2,0,3.1,1163,47,http://content8.flixster.com/movie/11/15/01/11150158_det.jpg
64990,Pete Seeger: The Power of Song,2007,pete_seeger_the_power_of_song,8.2,20,19,1,95,8,12,11,1,91,4.3,233,93,http://content8.flixster.com/movie/10/91/53/10915382_det.jpg
64993,By√¥soku 5 senchim√™toru,2007,5_centimeters_per_second,0,2,2,0,100,0,1,1,0,100,4.3,1726,91,http://content7.flixster.com/movie/85/24/71/8524717_det.jpg
64997,War of the Worlds,2005,war_of_the_worlds,7,244,178,66,72,6.7,42,28,14,66,2.9,162092,45,http://content8.flixster.com/movie/10/86/82/10868202_det.jpg
64999,War of the Worlds 2: The Next Wave,2008,war_of_the_worlds_2_the_next_wave,0,0,0,0,0,0,0,0,0,0,0,0,0,http://content6.flixster.com/movie/10/84/11/10841124_det.jpg
65006,Impulse,2008,impulse,0,2,0,2,0,0,0,0,0,0,0,0,0,http://content8.flixster.com/movie/10/87/85/10878514_det.jpg
65011,Zona Zamfirova,2002,zona-zamfirova,0,0,0,0,0,0,0,0,0,0,0,0,0,http://images.rottentomatoescdn.com/images/defaults/poster_default.gif
65037,Ben X,2007,10009212-ben_x,6.3,36,24,12,66,6.1,7,4,3,57,3.9,2886,82,http://content9.flixster.com/movie/10/86/82/10868203_det.jpg
65088,Bedtime Stories,2008,bedtime_stories,4.4,104,26,78,25,4.7,26,6,20,23,3.5,108877,63,http://content6.flixster.com/movie/10/94/33/10943312_det.jpg
65091,Manhattan Melodrama,1934,manhattan_melodrama,7,12,10,2,83,0,4,2,2,50,3.7,344,71,http://content9.flixster.com/movie/66/44/64/6644647_det.jpg
65126,Choke,2008,choke,5.6,135,73,62,54,4.9,26,8,18,30,3.3,13893,55,http://content6.flixster.com/movie/10/85/09/10850932_det.jpg
65130,Revolutionary Road,2008,revolutionary_road,6.7,194,133,61,68,6.9,36,25,11,69,3.5,46044,70,http://content8.flixster.com/movie/10/88/40/10884042_det.jpg
65133,Blackadder Back & Forth,1999,blackadder-back-forth,0,0,0,0,0,0,0,0,0,0,0,0,0,http://content7.flixster.com/movie/34/10/69/3410693_det.jpg