id,title,year,rtAllCriticsRating,rtAllCriticsNumReviews,rtAllCriticsNumFresh,rtAllCriticsNumRotten,rtAllCriticsScore,rtTopCriticsRating,rtTopCriticsNumReviews,rtTopCriticsNumFresh,rtTopCriticsNumRotten,rtTopCriticsScore,rtAudienceRating,rtAudienceNumRatings,rtAudienceScore,rtPictureURL
1,Toy story,1995,9,73,73,0,100,8.5,17,17,0,100,3.7,102338,81,http://content7.flixster.com/movie/10/93/63/10936393_det.jpg
2,Jumanji,1995,5.6,28,13,15,46,5.8,5,2,3,40,3.2,44587,61,http://content8.flixster.com/movie/56/79/73/5679734_det.jpg
3,Grumpy Old Men,1993,5.9,36,24,12,66,7,6,5,1,83,3.2,10489,66,http://content6.flixster.com/movie/25/60/256020_det.jpg
4,Waiting to Exhale,1995,5.6,25,14,11,56,5.5,11,5,6,45,3.3,5666,79,http://content9.flixster.com/movie/10/94/17/10941715_det.jpg
5,Father of the Bride Part II,1995,5.3,19,9,10,47,5.4,5,1,4,20,3,13761,64,http://content8.flixster.com/movie/25/54/255426_det.jpg
6,Heat,1995,7.7,58,50,8,86,7.2,17,14,3,82,3.9,42785,92,http://content9.flixster.com/movie/26/80/268099_det.jpg
7,Sabrina,1954,7.4,31,28,3,90,7.2,5,5,0,100,3.8,12812,87,http://content7.flixster.com/movie/10/93/36/10933669_det.jpg
8,Tom and Huck,1995,4.2,8,2,6,25,0,2,1,1,50,2.7,2649,45,http://content9.flixster.com/movie/26/16/261691_det.jpg
9,Sudden Death,1995,5.2,32,17,15,53,5.6,9,5,4,55,2.6,3626,40,http://content8.flixster.com/movie/27/91/279122_det.jpg
10,GoldenEye,1995,6.8,41,33,8,80,6.2,11,7,4,63,3.4,28260,78,http://content9.flixster.com/movie/26/66/266699_det.jpg
11,The American President,1995,7,49,44,5,89,7.2,18,16,2,88,3.2,8320,71,http://content7.flixster.com/movie/25/42/254205_det.jpg
12,Dracula: Dead and Loving It,1995,3,35,3,32,8,3.7,10,2,8,20,2.8,10078,52,http://content8.flixster.com/movie/10/89/17/10891774_det.jpg
13,Balto,1995,5.8,12,6,6,50,0,4,1,3,25,3.2,9195,66,http://content7.flixster.com/movie/25/16/251605_det.jpg
14,Nixon,1995,6.7,56,42,14,75,6.1,18,12,6,66,3.5,3256,72,http://content6.flixster.com/movie/28/30/283016_det.jpg
15,Cutthroat Island,1995,4.4,31,14,17,45,4.7,6,3,3,50,2.6,3350,42,http://content6.flixster.com/movie/25/69/256908_det.jpg
16,Casino,1995,7.2,58,47,11,81,6.3,16,11,5,68,3.9,66463,91,http://content8.flixster.com/movie/10/87/61/10876102_det.jpg
17,Sense and Sensibility,1995,7.9,49,48,1,97,8.1,14,13,1,92,3.8,32782,88,http://content6.flixster.com/movie/11/12/50/11125040_det.jpg
18,Four Rooms,1995,3.5,42,6,36,14,2.9,11,0,11,0,3.5,14266,72,http://content7.flixster.com/movie/93/49/77/9349773_det.jpg
19,Ace Ventura: When Nature Calls,1995,4.1,25,9,16,36,0,3,1,2,33,3.2,87306,73,http://content7.flixster.com/movie/10/94/18/10941853_det.jpg
20,Money Train,1995,4,24,4,20,16,4.5,5,1,4,20,2.7,5263,38,http://content9.flixster.com/movie/11/12/51/11125103_det.jpg
21,Get Shorty,1995,7.7,49,42,7,85,8.4,14,14,0,100,3.2,10155,63,http://content7.flixster.com/movie/98/65/89/9865893_det.jpg
22,Copycat,1995,6.6,32,24,8,75,7.4,5,4,1,80,3.1,5628,58,http://content9.flixster.com/movie/27/27/272723_det.jpg
23,Ninja Assassin,2009,4.3,106,27,79,25,4.6,20,6,14,30,3.4,107023,58,http://content6.flixster.com/movie/10/89/12/10891232_det.jpg
24,Powder,1995,5.2,19,9,10,47,4.9,5,0,5,0,3.1,6650,67,http://content7.flixster.com/movie/25/59/255901_det.jpg
25,Leaving Las Vegas,1995,7.7,45,40,5,88,8.1,11,11,0,100,3.6,12742,82,http://content7.flixster.com/movie/10/90/25/10902561_det.jpg
26,Othello,1995,6.3,38,26,12,68,6.1,11,7,4,63,3.3,2018,66,http://content6.flixster.com/movie/10/92/98/10929892_det.jpg
27,Now and Then,1995,4.7,16,3,13,18,5.2,5,1,4,20,3.5,17168,78,http://content6.flixster.com/movie/55/36/64/5536644_det.jpg
28,Persuasion,1995,7.7,23,19,4,82,8.5,9,9,0,100,3.9,7968,82,http://content6.flixster.com/movie/11/12/73/11127360_det.jpg
29,La cité des enfants perdus,1995,7,33,27,6,81,7.2,7,5,2,71,4,22420,89,http://content6.flixster.com/movie/26/78/267824_det.jpg
30,Yao a yao yao dao waipo qiao,1995,6.8,21,18,3,85,0,4,3,1,75,3.6,1061,70,http://content8.flixster.com/movie/10/90/31/10903162_det.jpg
31,Dangerous Minds,1995,4.7,37,11,26,29,5,12,5,7,41,3.1,12136,66,http://content7.flixster.com/movie/26/98/269813_det.jpg
32,Twelve Monkeys,1995,0,0,0,0,0,0,0,0,0,0,0,0,0,http://content6.flixster.com/movie/10/93/02/10930244_det.jpg
33,Wings of Courage,1995,0,4,2,2,50,0,2,1,1,50,0,0,0,http://content7.flixster.com/movie/10/97/83/10978341_det.jpg
34,Babe,1995,8.2,54,53,1,98,8.2,11,11,0,100,3,22954,54,http://content7.flixster.com/movie/25/32/253205_det.jpg
35,Carrington,1995,6.2,19,9,10,47,7.4,5,4,1,80,3.5,781,68,http://content7.flixster.com/movie/28/00/280009_det.jpg
36,Dead Man Walking,1995,8.2,53,50,3,94,7.9,20,18,2,90,3.6,15450,81,http://content6.flixster.com/movie/10/88/77/10887764_det.jpg
37,Across the Sea of Time,1995,0,4,2,2,50,0,1,0,1,0,2.9,237,27,http://content6.flixster.com/movie/10/90/58/10905808_det.jpg
38,It Takes Two,1995,3.9,24,2,22,8,4.6,8,2,6,25,2.9,16311,63,http://content7.flixster.com/movie/25/74/257417_det.jpg
39,Clueless,1995,0,0,0,0,0,0,0,0,0,0,0,0,0,http://content8.flixster.com/movie/10/85/01/10850110_det.jpg
40,"Cry, the Beloved Country",1995,7.2,13,10,3,76,0,4,3,1,75,3.5,520,66,http://content6.flixster.com/movie/10/89/59/10895996_det.jpg
41,Richard III,1995,8.1,43,41,2,95,7.6,11,10,1,90,3.7,1552,82,http://content7.flixster.com/movie/26/89/268909_det.jpg
42,Dead Presidents,1995,5.7,31,14,17,45,6.3,12,7,5,58,3.3,4475,75,http://content7.flixster.com/movie/26/95/269521_det.jpg
43,Restoration,1995,6.3,31,21,10,67,6.4,10,6,4,60,3.3,1103,56,http://content6.flixster.com/movie/27/04/270404_det.jpg
44,Mortal Kombat,1995,4.4,26,9,17,34,3.9,6,2,4,33,2.8,18291,55,http://content9.flixster.com/movie/25/63/256395_det.jpg
45,Live Free or Die Hard,2007,6.8,197,161,36,81,6.7,38,30,8,78,3.9,1145097,86,http://content8.flixster.com/movie/10/93/34/10933482_det.jpg
46,How to Make an American Quilt,1995,5.6,22,11,11,50,7.6,6,5,1,83,3.2,2626,58,http://content8.flixster.com/movie/10/86/75/10867514_det.jpg
47,Shichinin no samurai,1954,9.2,49,49,0,100,8.6,10,10,0,100,4.5,29509,97,http://content7.flixster.com/movie/39/91/08/3991085_det.jpg
48,Pocahontas,1995,6,49,27,22,55,6.6,14,10,4,71,3.2,37858,63,http://content6.flixster.com/movie/25/15/251508_det.jpg
49,When Night Is Falling,1995,5.7,16,8,8,50,0,4,1,3,25,3.9,1132,83,http://content6.flixster.com/movie/10/89/77/10897780_det.jpg
50,The Usual Suspects,1995,7.5,47,41,6,87,6.9,14,12,2,85,4.2,109588,95,http://content7.flixster.com/movie/24/63/48/2463485_det.jpg
52,Mighty Aphrodite,1995,6.7,33,25,8,75,7.2,6,4,2,66,3.3,4866,69,http://content7.flixster.com/movie/10/84/18/10841893_det.jpg
53,Lamerica,1994,8,10,9,1,90,0,1,1,0,100,3.9,239,82,http://content6.flixster.com/movie/29/78/297800_det.jpg
54,The Big Green,1995,2.8,5,0,5,0,0,1,0,1,0,2.7,2596,47,http://content7.flixster.com/movie/25/93/259305_det.jpg
55,Georgia Rule,2007,3.8,116,20,96,17,3.4,30,2,28,6,3,64056,55,http://content8.flixster.com/movie/63/82/23/6382238_det.jpg
56,Kids of the Round Table,1997,0,0,0,0,0,0,0,0,0,0,0,0,0,http://content7.flixster.com/movie/10/85/20/10852069_det.jpg
57,Home for the Holidays,1995,6,44,28,16,63,5.7,11,5,6,45,3.4,3045,69,http://content6.flixster.com/movie/25/43/254392_det.jpg
58,Il postino,1994,7.9,25,23,2,92,0,4,4,0,100,4.1,5794,92,http://content8.flixster.com/movie/10/86/74/10867406_det.jpg
59,Le confessionnal,1995,0,1,1,0,100,0,0,0,0,0,0,0,0,http://images.rottentomatoescdn.com/images/defaults/poster_default.gif
60,The Indian in the Cupboard,1995,6.2,19,13,6,68,0,2,1,1,50,2.7,5127,41,http://content9.flixster.com/movie/25/78/257803_det.jpg
61,Eye for an Eye,1996,0,0,0,0,0,0,0,0,0,0,0,0,0,http://content8.flixster.com/movie/10/99/01/10990146_det.jpg
62,Mr. Holland's Opus,1995,6.7,26,19,7,73,7.5,6,5,1,83,3.5,9569,79,http://content8.flixster.com/movie/10/58/42/10584210_det.jpg
63,Don't Be a Menace to South Central While Drinking Your Juice in the Hood,1996,4.5,24,7,17,29,5.6,7,3,4,42,0,0,0,http://content8.flixster.com/movie/28/69/286926_det.jpg
64,Two If by Sea,1996,3.9,27,3,24,11,0,4,0,4,0,2.6,1608,29,http://content6.flixster.com/movie/27/80/278004_det.jpg
65,Bio-Dome,1996,1.9,21,1,20,4,2,7,0,7,0,2.6,8972,51,http://content6.flixster.com/movie/25/94/259420_det.jpg
66,Lawnmower Man 2: Beyond Cyberspace,1996,2.8,9,1,8,11,0,3,1,2,33,2.1,952,18,http://content7.flixster.com/movie/10/86/80/10868017_det.jpg
67,Two Bits,1995,5,10,4,6,40,0,4,1,3,25,3.3,685,54,http://content6.flixster.com/movie/26/66/266612_det.jpg
68,Gazon maudit,1995,6.1,10,5,5,50,0,4,1,3,25,3.4,597,58,http://content7.flixster.com/movie/27/76/277609_det.jpg
69,Friday,1995,0,0,0,0,0,0,0,0,0,0,0,0,0,http://content7.flixster.com/movie/10/88/03/10880345_det.jpg
70,From Dusk Till Dawn,1996,6,43,27,16,62,4.9,10,5,5,50,3.4,36073,75,http://content9.flixster.com/movie/62/82/01/6282011_det.jpg
71,Fair Game,1995,2.4,24,3,21,12,3.1,8,1,7,12,2.1,1761,16,http://content8.flixster.com/movie/27/69/276994_det.jpg
72,Kicking & Screaming,2005,5.1,137,57,80,41,5,31,12,19,38,3,14260,51,http://content9.flixster.com/movie/24/97/249715_det.jpg
73,Les misérables,1998,6.9,41,31,10,75,6.6,11,6,5,54,3.6,7310,81,http://content9.flixster.com/movie/25/51/255107_det.jpg
74,Bed of Roses,1996,5.3,14,3,11,21,5.2,5,1,4,20,3.2,3163,66,http://content9.flixster.com/movie/25/92/259203_det.jpg
75,Big Bully,1996,2.8,7,0,7,0,0,2,0,2,0,2.4,1459,23,http://content9.flixster.com/movie/26/51/265195_det.jpg
76,Screamers,1995,4.7,30,9,21,30,4.9,9,2,7,22,3,2070,45,http://content7.flixster.com/movie/27/23/272301_det.jpg
77,Nico Icon,1995,7.1,13,11,2,84,8,5,4,1,80,4,87,85,http://content9.flixster.com/movie/10/84/77/10847739_det.jpg
78,The Crossing Guard,1995,6.5,27,20,7,74,0,4,2,2,50,3.3,2170,56,http://content7.flixster.com/movie/27/69/276905_det.jpg
79,The Juror,1996,4.4,19,3,16,15,4.3,6,1,5,16,2.8,2266,39,http://content6.flixster.com/movie/27/93/279316_det.jpg
80,Badkonake sefid,1995,6.8,20,16,4,80,6.6,8,6,2,75,4,547,86,http://content9.flixster.com/movie/54/93/06/5493067_det.jpg
81,Things to Do in Denver When You're Dead,1995,4.9,27,9,18,33,5.5,5,1,4,20,3.5,3197,72,http://content8.flixster.com/movie/27/06/270606_det.jpg
82,Antonia,1995,6.5,25,16,9,64,7.8,10,9,1,90,4.2,1707,90,http://content6.flixster.com/movie/28/20/282096_det.jpg
83,Once Upon a Time... When We Were Colored,1995,7.3,14,10,4,71,7.9,5,5,0,100,3.7,414,76,http://content8.flixster.com/movie/10/92/29/10922994_det.jpg
84,Last Summer in the Hamptons,1995,5.6,15,9,6,60,0,2,2,0,100,3.3,89,47,http://content8.flixster.com/movie/92/06/07/9206078_det.jpg
85,Angels and Insects,1995,6.5,20,14,6,70,8.1,5,5,0,100,3.3,635,62,http://content6.flixster.com/movie/10/89/39/10893928_det.jpg
86,White Squall,1996,5.8,30,19,11,63,6.3,10,7,3,70,3.2,3184,62,http://content9.flixster.com/movie/10/90/52/10905259_det.jpg
87,Dunston Checks In,1996,3.8,15,1,14,6,0,4,1,3,25,2.5,2935,39,http://content8.flixster.com/movie/10/85/22/10852206_det.jpg
88,Black Sheep,2006,6.4,87,61,26,70,6.3,21,15,6,71,3.2,19454,54,http://content6.flixster.com/movie/58/07/67/5807672_det.jpg
89,Nick of Time,1995,4.6,28,8,20,28,3.8,5,0,5,0,3.1,10563,54,http://content9.flixster.com/movie/10/84/01/10840163_det.jpg
90,The Journey of August King,1995,6.2,7,4,3,57,0,2,1,1,50,3.1,286,54,http://content8.flixster.com/movie/26/54/265406_det.jpg
92,Mary Reilly,1996,4.4,41,11,30,26,4.6,9,2,7,22,2.8,3733,41,http://content6.flixster.com/movie/27/56/275628_det.jpg
93,Vampire in Brooklyn,1995,3.6,28,3,25,10,3.1,9,0,9,0,2.4,6122,37,http://content7.flixster.com/movie/10/88/64/10886457_det.jpg
94,Beautiful Girls,1996,7,46,36,10,78,6.3,14,9,5,64,3.6,4674,79,http://content7.flixster.com/movie/10/84/53/10845361_det.jpg
95,Broken Arrow,1996,5.8,29,16,13,55,6.1,6,3,3,50,2.9,12489,51,http://content6.flixster.com/movie/27/12/271208_det.jpg
96,In the Bleak Midwinter,1995,7.3,19,17,2,89,0,3,2,1,66,4.1,309,88,http://content6.flixster.com/movie/52/63/38/5263388_det.jpg
97,La haine,1995,8,14,14,0,100,0,4,4,0,100,4.3,11987,95,http://content8.flixster.com/movie/10/84/15/10841502_det.jpg
98,Going Shopping,2005,5,29,12,17,41,5,15,5,10,33,2.8,691,37,http://content8.flixster.com/movie/25/02/250226_det.jpg
99,Heidi Fleiss: Hollywood Madam,1995,7.5,7,5,2,71,8.8,5,4,1,80,3,281,46,http://content7.flixster.com/movie/30/49/304921_det.jpg
100,City Hall,1996,6.1,22,12,10,54,7,6,3,3,50,3,2730,42,http://content8.flixster.com/movie/27/59/275902_det.jpg
101,Bottle Rocket,1996,6.6,42,33,9,78,6.1,9,5,4,55,3.7,16217,80,http://content6.flixster.com/movie/26/73/267324_det.jpg
102,Mr. Wrong,1996,3.1,28,1,27,3,3.1,8,0,8,0,2.4,1544,29,http://content8.flixster.com/movie/10/92/04/10920478_det.jpg
103,Unforgettable,1996,4.4,26,6,20,23,0,4,0,4,0,3,358,36,http://content8.flixster.com/movie/11/13/35/11133586_det.jpg
104,Happy Gilmore,1996,5.5,50,29,21,58,5.1,11,4,7,36,3.7,114875,83,http://content7.flixster.com/movie/25/96/259613_det.jpg
105,The Bridges of Madison County,1995,7.2,40,36,4,90,7.9,9,9,0,100,3.6,11573,83,http://content6.flixster.com/movie/10/92/73/10927328_det.jpg
106,Keiner liebt mich,1994,6,6,4,2,66,0,1,1,0,100,4.2,161,89,http://content6.flixster.com/movie/10/89/61/10896152_det.jpg
107,Muppet Treasure Island,1996,6.1,22,15,7,68,7.4,5,4,1,80,3.2,8588,68,http://content6.flixster.com/movie/10/88/15/10881572_det.jpg
110,Braveheart,1995,7,48,37,11,77,6.7,16,12,4,75,3.8,204275,83,http://content9.flixster.com/movie/16/90/54/1690543_det.jpg
111,Taxi Driver,1976,8.7,50,49,1,98,7.7,9,8,1,88,4.1,58145,93,http://content9.flixster.com/movie/10/91/39/10913987_det.jpg
112,Hung fan kui,1995,6.4,52,41,11,78,6.5,16,13,3,81,3.1,7517,62,http://content6.flixster.com/movie/10/88/62/10886212_det.jpg
113,Before and After,1996,4.8,19,6,13,31,5.7,5,2,3,40,3,1276,39,http://content8.flixster.com/movie/26/53/265310_det.jpg
114,Margaret's Museum,1995,6.9,6,4,2,66,0,1,1,0,100,3.7,500,76,http://content7.flixster.com/movie/10/43/62/10436297_det.jpg
115,Le bonheur est dans le pré,1995,0,0,0,0,0,0,0,0,0,0,0,0,0,http://content8.flixster.com/movie/10/91/13/10911350_det.jpg
116,Anne Frank Remembered,1995,7.8,27,26,1,96,7.6,16,15,1,93,3.7,1076,79,http://content9.flixster.com/movie/10/87/14/10871419_det.jpg
117,The Young Poisoner's Handbook,1995,7.1,13,11,2,84,0,3,3,0,100,3.7,541,79,http://content8.flixster.com/movie/52/63/47/5263478_det.jpg
118,If Lucy Fell,1996,4,26,5,21,19,4.3,9,2,7,22,3.1,1202,49,http://content7.flixster.com/movie/10/36/17/10361777_det.jpg
119,Steal Big Steal Little,1995,4.5,13,2,11,15,0,3,0,3,0,2.9,555,36,http://content9.flixster.com/movie/10/86/77/10867755_det.jpg
120,Race the Sun,1996,4.8,9,2,7,22,0,3,0,3,0,2.9,822,40,http://content7.flixster.com/movie/10/88/81/10888113_det.jpg
121,The Boys of St. Vincent,1992,8.2,6,6,0,100,0,1,1,0,100,3.5,401,77,http://content7.flixster.com/movie/11/12/44/11124449_det.jpg
122,Boomerang,1992,4.8,27,10,17,37,5.4,8,4,4,50,2.8,4751,55,http://content6.flixster.com/movie/26/81/268128_det.jpg
123,Chung Hing sam lam,1994,7.7,27,26,1,96,6.8,7,6,1,85,4.2,11068,93,http://content6.flixster.com/movie/10/85/69/10856936_det.jpg
124,L'uomo delle stelle,1995,6.5,12,9,3,75,7,5,4,1,80,3.7,543,73,http://content9.flixster.com/movie/27/57/275715_det.jpg
125,Flirting with Disaster,1996,7.4,42,36,6,85,8.5,6,6,0,100,3.3,2127,65,http://content9.flixster.com/movie/92/18/93/9218931_det.jpg
126,The Neverending Story III,1994,0,3,1,2,33,0,0,0,0,0,0,0,0,http://content9.flixster.com/movie/10/88/07/10880743_det.jpg
128,Jupiter's Wife,1995,0,4,3,1,75,0,1,0,1,0,0,0,0,http://content7.flixster.com/movie/10/97/52/10975293_det.jpg
129,Pie in the Sky,1996,0,2,1,1,50,0,0,0,0,0,0,0,0,http://content9.flixster.com/movie/28/42/284295_det.jpg
130,Angela's Ashes,1999,5.7,84,44,40,52,5.3,26,10,16,38,3.6,4588,79,http://content6.flixster.com/movie/10/92/31/10923132_det.jpg
131,Frankie Starlight,1995,5.8,6,4,2,66,0,1,1,0,100,3.8,133,61,http://content6.flixster.com/movie/93/50/48/9350484_det.jpg
132,The Curse of the Jade Scorpion,2001,5.2,122,55,67,45,5,36,14,22,38,3.1,4108,52,http://content6.flixster.com/movie/26/26/262600_det.jpg
134,Sonic Outlaws,1995,0,3,2,1,66,0,0,0,0,0,0,0,0,http://content9.flixster.com/movie/10/83/90/10839055_det.jpg
135,Down Periscope,1996,3.8,31,4,27,12,4,8,1,7,12,2.8,3851,60,http://content9.flixster.com/movie/25/41/254115_det.jpg
136,From the Journals of Jean Seberg,1995,7.6,9,9,0,100,0,3,3,0,100,4,30,75,http://content8.flixster.com/movie/10/87/54/10875446_det.jpg
137,Man of the Year,2006,4.4,141,30,111,21,5,35,11,24,31,3,29127,51,http://content9.flixster.com/movie/11/12/89/11128939_det.jpg
139,Hard Target,1993,5.2,29,14,15,48,5.6,7,4,3,57,0,0,0,http://content6.flixster.com/movie/27/33/273300_det.jpg
140,Up Close & Personal,1996,5.1,31,10,21,32,6.5,6,3,3,50,3.2,2932,63,http://content9.flixster.com/movie/25/89/258991_det.jpg
141,The Birdcage,1996,6.7,29,22,7,75,7.5,5,5,0,100,3.3,13502,75,http://content9.flixster.com/movie/26/71/267195_det.jpg
143,Gospa,1995,\N,\N,\N,\N,\N,\N,\N,\N,\N,\N,\N,\N,\N,\N
144,The Brothers McMullen,1995,7.1,34,31,3,91,7.8,6,6,0,100,3.2,1225,55,http://content8.flixster.com/movie/10/87/96/10879638_det.jpg
145,Bad Boys,1995,4.8,41,16,25,39,3.7,9,1,8,11,3.5,67658,79,http://content8.flixster.com/movie/28/27/282798_det.jpg
146,The Amazing Panda Adventure,1995,4.3,9,2,7,22,0,3,1,2,33,3,1335,46,http://content9.flixster.com/movie/11/15/28/11152831_det.jpg
147,The Basketball Diaries,1995,4.9,35,15,20,42,4.7,11,3,8,27,3.5,12119,77,http://content7.flixster.com/movie/10/93/25/10932577_det.jpg
148,An Awfully Big Adventure,1995,5.4,11,4,7,36,0,3,0,3,0,3.2,1433,55,http://content8.flixster.com/movie/10/90/97/10909738_det.jpg
149,The Moguls,2005,3.9,24,4,20,16,0,4,1,3,25,3,8865,46,http://content7.flixster.com/movie/11/13/35/11133545_det.jpg
150,Apollo 13,1995,8,51,49,2,96,7.9,11,10,1,90,3.6,30565,78,http://content7.flixster.com/movie/10/93/70/10937057_det.jpg
151,Rob Roy,1995,6.3,42,30,12,71,5.8,10,5,5,50,3.3,5253,73,http://content9.flixster.com/movie/26/89/268991_det.jpg
152,Basic Instinct 2,2006,3.1,149,10,139,6,3.2,35,1,34,2,2.5,28208,33,http://content8.flixster.com/movie/10/89/83/10898386_det.jpg
153,Batman Forever,1995,5.2,54,23,31,42,5.9,14,10,4,71,2.9,47498,42,http://content7.flixster.com/movie/55/34/97/5534977_det.jpg
154,Belle de jour,1967,8.6,36,34,2,94,7.9,9,8,1,88,4,1378,84,http://content9.flixster.com/movie/10/86/32/10863255_det.jpg
155,Beyond Rangoon,1995,5.1,30,11,19,36,5,10,4,6,40,3.5,3962,64,http://content8.flixster.com/movie/10/86/97/10869758_det.jpg
156,Blue in the Face,1995,5.5,20,9,11,45,0,3,1,2,33,3.5,1323,73,http://content8.flixster.com/movie/27/68/276818_det.jpg
157,Canadian Bacon,1995,3.3,14,2,12,14,0,2,0,2,0,2.9,3460,49,http://content7.flixster.com/movie/26/00/260017_det.jpg
158,Casper,1995,4.7,34,14,20,41,4.5,10,3,7,30,3,20672,54,http://content9.flixster.com/movie/31/28/312827_det.jpg
159,Clockers,1995,6.5,46,31,15,67,6.7,12,9,3,75,3.5,2502,74,http://content8.flixster.com/movie/10/84/06/10840642_det.jpg
160,Congo,1995,3.6,42,9,33,21,3.2,12,1,11,8,2.6,7008,34,http://content7.flixster.com/movie/25/85/258597_det.jpg
161,Crimson Tide,1995,7.4,44,38,6,86,8,10,9,1,90,3.5,11550,77,http://content7.flixster.com/movie/26/84/268417_det.jpg
162,Crumb,1994,8.3,39,37,2,94,0,4,4,0,100,4,2689,88,http://content7.flixster.com/movie/27/41/274197_det.jpg
163,Desperado,1995,6.3,38,23,15,60,5.4,10,3,7,30,3.5,23821,79,http://content6.flixster.com/movie/10/87/27/10872728_det.jpg
164,Devil in a Blue Dress,1995,7.3,50,44,6,88,7,14,11,3,78,3.3,2742,64,http://content9.flixster.com/movie/27/13/271303_det.jpg
165,Die Hard: With a Vengeance,1995,5.7,42,20,22,47,5.8,10,5,5,50,3.6,61394,83,http://content8.flixster.com/movie/10/93/34/10933486_det.jpg
166,The Doom Generation,1995,4.9,29,14,15,48,5.3,12,7,5,58,3.3,2680,64,http://content8.flixster.com/movie/10/92/11/10921130_det.jpg
167,Feast of July,1995,6.2,9,6,3,66,0,4,2,2,50,2.9,226,40,http://content8.flixster.com/movie/10/87/63/10876398_det.jpg
168,First Knight,1995,5.2,42,19,23,45,5.5,14,7,7,50,3,13290,59,http://content9.flixster.com/movie/84/22/90/8422907_det.jpg
169,Free Willy 2: The Adventure Home,1995,4.6,12,3,9,25,0,3,1,2,33,2.8,8336,53,http://content9.flixster.com/movie/26/44/264407_det.jpg
170,Hackers,1995,4.7,19,7,12,36,0,3,2,1,66,3.2,16863,66,http://content7.flixster.com/movie/25/64/256409_det.jpg
171,Jeffrey,1995,6.1,23,14,9,60,5.7,9,4,5,44,3.4,836,68,http://content7.flixster.com/movie/27/11/271117_det.jpg
172,Johnny Mnemonic,1995,3.3,28,4,24,14,4.7,5,1,4,20,2.5,7062,33,http://content7.flixster.com/movie/28/53/285317_det.jpg
173,Judge Dredd,1995,3.6,47,7,40,14,3.7,10,0,10,0,2.5,10571,35,http://content9.flixster.com/movie/27/05/270591_det.jpg
174,Jury Duty,1995,2.1,11,0,11,0,0,2,0,2,0,2.4,1843,33,http://content6.flixster.com/movie/10/50/99/10509940_det.jpg
175,Kids,1995,5,52,26,26,50,6.5,7,4,3,57,3.5,11282,78,http://content6.flixster.com/movie/10/89/38/10893852_det.jpg
176,Living in Oblivion,1995,7.4,24,21,3,87,0,2,2,0,100,3.8,1878,85,http://content6.flixster.com/movie/10/87/12/10871220_det.jpg
177,Lord of Illusions,1995,5.7,19,13,6,68,0,2,1,1,50,3,2344,51,http://content9.flixster.com/movie/28/75/287599_det.jpg
178,Love & Human Remains,1993,6.5,11,7,4,63,0,4,2,2,50,0,0,0,http://content9.flixster.com/movie/84/22/68/8422687_det.jpg
179,Mad Love,1995,0,0,0,0,0,0,0,0,0,0,0,0,0,http://content9.flixster.com/movie/10/97/32/10973279_det.jpg
180,Mallrats,1995,5.4,40,21,19,52,5,9,2,7,22,3.6,40221,83,http://content6.flixster.com/movie/11/15/34/11153460_det.jpg
181,Mighty Morphin Power Rangers: The Movie,1995,4.6,19,8,11,42,5.5,8,5,3,62,2.7,5904,52,http://content8.flixster.com/movie/26/01/260110_det.jpg
182,Moonlight and Valentino,1995,4.6,13,2,11,15,0,3,0,3,0,3.1,978,51,http://content9.flixster.com/movie/10/91/91/10919195_det.jpg
183,Mute Witness,1994,6.9,19,15,4,78,7.3,6,5,1,83,3.2,644,61,http://content6.flixster.com/movie/27/75/277592_det.jpg
184,Nadja,1994,0,0,0,0,0,0,0,0,0,0,0,0,0,http://content8.flixster.com/movie/10/89/08/10890894_det.jpg
185,The Net,1995,5.1,33,11,22,33,6.9,5,3,2,60,2.8,10933,50,http://content9.flixster.com/movie/68/77/57/6877579_det.jpg
186,Nine Months,1995,4.3,24,6,18,25,5,5,1,4,20,2.7,8930,40,http://content7.flixster.com/movie/10/91/49/10914937_det.jpg
187,Party Girl,1995,6.3,31,24,7,77,6,13,8,5,61,3.5,1243,73,http://content8.flixster.com/movie/10/85/91/10859166_det.jpg
188,The Prophecy,1995,5.2,19,8,11,42,0,1,0,1,0,3.3,5062,71,http://content6.flixster.com/movie/26/79/267992_det.jpg
189,The Reckless Moment,1949,0,3,3,0,100,0,0,0,0,0,0,0,0,http://content6.flixster.com/movie/55/32/82/5532828_det.jpg
190,Fail-Safe,1964,7.6,13,12,1,92,0,0,0,0,0,0,0,0,http://content9.flixster.com/movie/29/23/292315_det.jpg
191,The Scarlet Letter,1995,3,33,5,28,15,3.6,11,1,10,9,2.9,3493,48,http://content7.flixster.com/movie/10/86/16/10861633_det.jpg
193,Showgirls,1995,2.9,41,5,36,12,3.4,10,0,10,0,2.3,7443,35,http://content8.flixster.com/movie/28/55/285598_det.jpg
194,Smoke,1995,7.8,27,25,2,92,0,4,3,1,75,3.9,3101,88,http://content7.flixster.com/movie/27/30/273025_det.jpg
195,Something to Talk About,1995,5.3,27,10,17,37,6.5,9,5,4,55,3,6137,55,http://content8.flixster.com/movie/93/24/35/9324358_det.jpg
196,Species,1995,4.9,31,12,19,38,5.1,5,1,4,20,2.7,6716,37,http://content7.flixster.com/movie/66/42/83/6642833_det.jpg
197,The Stars Fell on Henrietta,1995,4.9,7,2,5,28,0,1,0,1,0,3,66,18,http://content7.flixster.com/movie/10/85/18/10851893_det.jpg
198,Strange Days,1995,6,38,23,15,60,5.9,8,4,4,50,3.3,7016,70,http://content8.flixster.com/movie/27/10/271010_det.jpg
199,Les parapluies de Cherbourg,1964,8.6,45,44,1,97,7.9,10,9,1,90,4.1,3199,86,http://content9.flixster.com/movie/30/89/308923_det.jpg
200,The Tie That Binds,1995,2.8,9,1,8,11,0,3,0,3,0,3,286,34,http://content9.flixster.com/movie/10/91/94/10919459_det.jpg
201,Three Wishes,1995,4.4,15,2,13,13,0,4,0,4,0,3,1249,52,http://content7.flixster.com/movie/26/05/260509_det.jpg
202,Total Eclipse,1995,4.9,16,4,12,25,0,4,1,3,25,3.4,2222,63,http://content6.flixster.com/movie/11/14/92/11149252_det.jpg
203,"To Wong Foo Thanks for Everything, Julie Newmar",1995,5,23,8,15,34,5.2,5,0,5,0,3.1,6833,69,http://content9.flixster.com/movie/10/88/06/10880663_det.jpg
204,Under Siege 2: Dark Territory,1995,4.5,29,10,19,34,0,3,2,1,66,2.6,5213,47,http://content6.flixster.com/movie/27/23/272392_det.jpg
205,Unstrung Heroes,1995,6.3,21,16,5,76,0,4,2,2,50,3.2,530,54,http://content8.flixster.com/movie/26/44/264406_det.jpg
206,Unzipped,1995,6.7,13,10,3,76,7.9,5,5,0,100,3.3,64,67,http://content6.flixster.com/movie/10/86/36/10863660_det.jpg
207,A Walk in the Clouds,1995,5.5,22,9,13,40,0,3,1,2,33,3.3,12692,74,http://content7.flixster.com/movie/10/89/20/10892013_det.jpg
208,Waterworld,1995,5.1,48,20,28,41,6.4,9,7,2,77,2.6,18023,46,http://content9.flixster.com/movie/25/75/257591_det.jpg
209,White Man's Burden,1995,4.5,32,8,24,25,4.4,10,1,9,10,2.8,1275,38,http://content7.flixster.com/movie/27/54/275405_det.jpg
210,Wild Bill,1995,\N,\N,\N,\N,\N,\N,\N,\N,\N,\N,\N,\N,\N,\N
211,The Browning Version,1951,7.8,17,15,2,88,0,3,1,2,33,4.3,270,94,http://content7.flixster.com/movie/10/83/88/10838841_det.jpg
212,Bushwhacked,1995,2.1,9,0,9,0,0,2,0,2,0,2.6,1388,38,http://content9.flixster.com/movie/91/58/09/9158095_det.jpg
213,Utomlyonnye solntsem,1994,7,13,10,3,76,0,4,3,1,75,4.3,1533,93,http://content8.flixster.com/movie/27/23/272326_det.jpg
214,Before the Rain,1994,7.5,12,10,2,83,0,2,2,0,100,4.4,1683,93,http://content6.flixster.com/movie/10/89/78/10897876_det.jpg
215,Before Sunrise,1995,8.2,34,34,0,100,9.3,5,5,0,100,4.1,20616,92,http://content7.flixster.com/movie/10/85/60/10856081_det.jpg
216,Billy Madison,1995,4.8,35,15,20,42,0,4,1,3,25,3.5,91595,79,http://content6.flixster.com/movie/26/12/261212_det.jpg
217,The Babysitters,2007,4.4,26,8,18,30,4.6,12,3,9,25,2.9,1237,35,http://content9.flixster.com/movie/10/84/14/10841411_det.jpg
218,Boys on the Side,1995,6,32,23,9,71,6.1,8,5,3,62,3.1,4572,65,http://content6.flixster.com/movie/27/12/271228_det.jpg
219,The Cure,1995,5.5,10,4,6,40,0,4,1,3,25,3.7,2207,79,http://content9.flixster.com/movie/10/86/12/10861271_det.jpg
220,Castle Freak,1995,5.4,7,4,3,57,0,0,0,0,0,0,0,0,http://content9.flixster.com/movie/10/89/86/10898627_det.jpg
222,Circle of Friends,1995,6.5,35,27,8,77,6.5,11,8,3,72,3.3,3292,65,http://content7.flixster.com/movie/10/91/53/10915357_det.jpg
223,Clerks.,1994,7.4,48,42,6,87,7.1,9,8,1,88,3.8,57642,89,http://content8.flixster.com/movie/10/93/69/10936950_det.jpg
224,Don Juan DeMarco,1994,5.8,22,16,6,72,0,2,1,1,50,3.3,14169,70,http://content9.flixster.com/movie/25/52/255207_det.jpg
225,Disclosure,1994,5.7,40,24,16,60,5.8,9,5,4,55,2.8,3648,41,http://content8.flixster.com/movie/27/42/274202_det.jpg
226,Tucker: The Man and His Dream,1988,7.2,35,30,5,85,6.8,7,5,2,71,3.2,1497,58,http://content7.flixster.com/movie/25/57/255709_det.jpg
227,Drop Zone,1994,4.1,19,6,13,31,0,3,1,2,33,2.7,2485,36,http://content9.flixster.com/movie/27/31/273103_det.jpg
228,Destiny Turns on the Radio,1995,2.7,15,2,13,13,0,2,0,2,0,2.6,446,27,http://content8.flixster.com/movie/71/21/48/7121486_det.jpg
229,Death and the Maiden,1994,7,48,40,8,83,6.2,10,7,3,70,3.6,1972,76,http://content9.flixster.com/movie/10/92/35/10923515_det.jpg
230,Dolores Claiborne,1995,6.8,33,28,5,84,0,4,3,1,75,3.4,4632,75,http://content6.flixster.com/movie/26/92/269216_det.jpg
231,Dumb & Dumber,1994,5.8,45,28,17,62,4.8,10,4,6,40,3.3,95871,79,http://content6.flixster.com/movie/25/45/254516_det.jpg
232,Yin shi nan nu,1994,7.4,31,29,2,93,7.9,8,8,0,100,4,3802,91,http://content8.flixster.com/movie/28/62/286218_det.jpg
233,Exotica,1994,8.3,27,26,1,96,0,3,3,0,100,3.7,1837,81,http://content8.flixster.com/movie/27/34/273426_det.jpg
234,Exit to Eden,1994,2.4,15,1,14,6,0,3,0,3,0,2.3,1694,27,http://content8.flixster.com/movie/26/84/268410_det.jpg
235,Ed Wood,1994,7.9,57,52,5,91,7.2,12,9,3,75,3.7,28216,83,http://content9.flixster.com/movie/10/88/97/10889755_det.jpg
236,French Kiss,1995,5.7,21,10,11,47,0,4,1,3,25,3.2,11010,70,http://content6.flixster.com/movie/10/83/82/10838220_det.jpg
237,Forget Paris,1995,5.4,33,17,16,51,4.7,8,2,6,25,3,2108,51,http://content7.flixster.com/movie/25/90/259029_det.jpg
238,Far from Home: The Adventures of Yellow Dog,1995,5.2,6,3,3,50,0,0,0,0,0,0,0,0,http://content8.flixster.com/movie/26/37/263710_det.jpg
239,A Goofy Movie,1995,5.7,14,8,6,57,0,2,1,1,50,3.1,17024,57,http://content6.flixster.com/movie/25/16/251608_det.jpg
240,Hideaway,1995,3.5,12,2,10,16,0,4,1,3,25,2.8,1077,41,http://content6.flixster.com/movie/28/06/280696_det.jpg
241,Fluke,1995,4,9,3,6,33,0,3,0,3,0,3.4,1598,70,http://content9.flixster.com/movie/25/77/257791_det.jpg
242,Farinelli,1994,5.7,21,14,7,66,4.7,6,2,4,33,3.8,1092,81,http://content8.flixster.com/movie/27/15/271518_det.jpg
243,Flash Gordon,1980,6.3,32,26,6,81,0,3,2,1,66,3.1,6492,64,http://content7.flixster.com/movie/25/73/257321_det.jpg
244,Gumby: The Movie,1995,0,4,0,4,0,0,0,0,0,0,0,0,0,http://content9.flixster.com/movie/10/94/41/10944103_det.jpg
245,The Glass Shield,1994,5.6,21,13,8,61,5.2,7,3,4,42,3,263,41,http://content9.flixster.com/movie/26/60/266023_det.jpg
246,Hoop Dreams,1994,8.5,44,43,1,97,8.1,12,12,0,100,4.1,3243,92,http://content6.flixster.com/movie/76/93/769348_det.jpg
247,Heavenly Creatures,1994,8.3,41,39,2,95,7.8,9,9,0,100,3.7,8208,82,http://content9.flixster.com/movie/10/90/75/10907555_det.jpg
248,Houseguest,1995,3.4,20,3,17,15,5.2,5,3,2,60,2.8,1745,51,http://content7.flixster.com/movie/26/06/260693_det.jpg
249,Immortal Beloved,1994,6,30,17,13,56,0,3,2,1,66,3.8,4786,87,http://content7.flixster.com/movie/26/75/267513_det.jpg
250,Heavy Weights,1995,4.1,5,1,4,20,0,0,0,0,0,0,0,0,http://content6.flixster.com/movie/10/93/03/10930316_det.jpg
251,The Hunted,2003,4.7,143,44,99,30,4.5,34,10,24,29,3,5362,51,http://content9.flixster.com/movie/11/13/64/11136427_det.jpg
252,I.Q.,1994,5.1,21,9,12,42,0,3,1,2,33,2.8,3758,46,http://content8.flixster.com/movie/10/91/74/10917466_det.jpg
253,Interview with the Vampire: The Vampire Chronicles,1994,5.8,45,26,19,57,4.6,10,4,6,40,3.7,77706,85,http://content6.flixster.com/movie/28/01/280124_det.jpg
254,Jefferson in Paris,1995,4.9,14,5,9,35,0,3,1,2,33,2.8,404,27,http://content6.flixster.com/movie/26/30/263024_det.jpg
255,The Jerky Boys,1995,1.6,10,1,9,10,0,0,0,0,0,0,0,0,http://content8.flixster.com/movie/62/23/13/6223134_det.jpg
256,Junior,1994,4.7,30,10,20,33,5.8,8,5,3,62,2.4,9754,28,http://content8.flixster.com/movie/10/84/29/10842998_det.jpg
257,Just Cause,1995,4,26,6,20,23,4.2,8,2,6,25,3.1,2888,51,http://content8.flixster.com/movie/10/87/09/10870958_det.jpg
258,A Kid in King Arthur's Court,1995,3.2,6,0,6,0,0,0,0,0,0,0,0,0,http://content9.flixster.com/movie/26/31/263115_det.jpg
259,Kiss of Death,1995,6.4,36,24,12,66,7.2,12,9,3,75,2.9,2125,39,http://content6.flixster.com/movie/27/76/277616_det.jpg
260,Star Wars,1977,8.2,64,60,4,93,7.4,17,15,2,88,4.1,147448,93,http://content9.flixster.com/movie/10/94/47/10944715_det.jpg
261,Little Women,1994,0,0,0,0,0,0,0,0,0,0,0,0,0,http://content7.flixster.com/movie/10/86/52/10865225_det.jpg
262,A Little Princess,1995,8.4,20,19,1,95,0,3,3,0,100,3.4,13643,81,http://content6.flixster.com/movie/29/07/290716_det.jpg
263,Ladybird Ladybird,1994,7.2,6,4,2,66,0,2,2,0,100,4,368,87,http://content9.flixster.com/movie/92/74/35/9274359_det.jpg
264,L'enfer,1994,7.9,8,8,0,100,0,1,1,0,100,3.5,421,67,http://content8.flixster.com/movie/10/88/73/10887306_det.jpg
265,Como agua para chocolate,1992,7.6,28,25,3,89,0,3,3,0,100,3.9,5713,86,http://content9.flixster.com/movie/10/89/25/10892515_det.jpg
266,Legends of the Fall,1994,0,0,0,0,0,0,0,0,0,0,0,0,0,http://content6.flixster.com/movie/10/90/03/10900344_det.jpg
267,Major Payne,1995,4.6,10,3,7,30,0,2,1,1,50,2.9,8555,69,http://content9.flixster.com/movie/25/69/256903_det.jpg
268,Little Odessa,1994,5.8,17,11,6,64,0,3,1,2,33,3.5,985,69,http://content9.flixster.com/movie/28/36/283627_det.jpg
269,Mi vida loca,1993,6.6,15,12,3,80,0,3,2,1,66,3.9,2251,81,http://content8.flixster.com/movie/10/85/41/10854174_det.jpg
270,Love Affair,1994,4.8,26,8,18,30,0,3,1,2,33,3.5,1260,71,http://content8.flixster.com/movie/25/75/257510_det.jpg
271,Losing Isaiah,1995,5.1,28,12,16,42,5,9,4,5,44,3.6,2364,76,http://content7.flixster.com/movie/27/48/274897_det.jpg
272,The Madness of King George,1994,7.8,42,39,3,92,8.1,10,10,0,100,3.6,1886,76,http://content6.flixster.com/movie/10/88/81/10888184_det.jpg
273,Frankenstein,1931,8.5,38,38,0,100,7.8,5,5,0,100,3.6,7211,81,http://content8.flixster.com/movie/28/83/288310_det.jpg
274,Man of the House,2005,3.3,60,5,55,8,3.9,16,4,12,25,3.1,10877,59,http://content9.flixster.com/movie/10/91/27/10912719_det.jpg
275,Mixed Nuts,1994,2.8,28,2,26,7,2.5,6,0,6,0,2.9,2410,46,http://content9.flixster.com/movie/10/93/94/10939467_det.jpg
276,Milk Money,1994,2.6,25,1,24,4,2.5,8,0,8,0,2.7,2126,40,http://content7.flixster.com/movie/25/98/259809_det.jpg
277,Miracle on 34th Street,1947,8,31,29,2,93,0,2,2,0,100,3.5,5409,81,http://content7.flixster.com/movie/29/05/290513_det.jpg
278,Miami Rhapsody,1995,6.1,18,8,10,44,0,3,2,1,66,2.6,766,28,http://content6.flixster.com/movie/26/49/264916_det.jpg
279,My Family,1995,7.2,11,9,2,81,0,3,3,0,100,3.9,1137,85,http://content8.flixster.com/movie/26/95/269594_det.jpg
280,Murder in the First,1995,5.5,34,17,17,50,4.8,10,4,6,40,3.5,3888,78,http://content6.flixster.com/movie/27/53/275304_det.jpg
281,Nobody's Fool,1986,0,4,0,4,0,0,1,0,1,0,3,289,43,http://content6.flixster.com/movie/26/56/265692_det.jpg
282,Nell,1994,5,31,16,15,51,0,3,3,0,100,3.1,5373,63,http://content8.flixster.com/movie/25/69/256906_det.jpg
283,New Jersey Drive,1995,6.5,7,4,3,57,0,3,2,1,66,3.8,814,81,http://content6.flixster.com/movie/28/25/282508_det.jpg
284,Nyû Yôku no koppu,1993,0,0,0,0,0,0,0,0,0,0,0,0,0,http://content6.flixster.com/movie/10/97/24/10972404_det.jpg
285,Beyond Bedlam,1994,0,1,0,1,0,0,0,0,0,0,0,0,0,http://content8.flixster.com/movie/10/80/07/10800750_det.jpg
286,Nemesis 2: Nebula,1995,0,0,0,0,0,0,0,0,0,0,0,0,0,http://content8.flixster.com/movie/10/88/48/10884886_det.jpg
287,Nina Takes a Lover,1994,5.2,6,3,3,50,0,2,0,2,0,3.4,125,52,http://content8.flixster.com/movie/62/32/18/6232186_det.jpg
288,Natural Born Killers,1994,6,29,15,14,51,5.9,7,3,4,42,3.5,39062,80,http://content8.flixster.com/movie/10/88/54/10885402_det.jpg
289,Only You,1994,5.5,22,11,11,50,0,3,1,2,33,3.3,4388,69,http://content9.flixster.com/movie/25/51/255111_det.jpg
290,Once Were Warriors,1994,7.7,31,29,2,93,7.4,8,7,1,87,0,0,0,http://content7.flixster.com/movie/29/03/290325_det.jpg
291,Poison Ivy II,1996,3.8,6,1,5,16,0,0,0,0,0,0,0,0,http://content6.flixster.com/movie/27/08/270820_det.jpg
292,Outbreak,1995,5.6,41,24,17,58,5.1,10,4,6,40,3.1,10732,55,http://content7.flixster.com/movie/55/37/06/5537065_det.jpg
293,Léon,1994,6.8,39,30,9,76,5.8,8,4,4,50,4.1,59011,94,http://content7.flixster.com/movie/28/62/286221_det.jpg
294,The Perez Family,1995,6.3,15,10,5,66,5.9,5,2,3,40,3.2,500,50,http://content9.flixster.com/movie/27/83/278323_det.jpg
295,A Pyromaniac's Love Story,1995,3.4,9,0,9,0,0,2,0,2,0,3.1,773,44,http://content6.flixster.com/movie/26/55/265524_det.jpg
296,Pulp Fiction,1994,8.9,50,47,3,94,8.4,14,13,1,92,4.2,249269,95,http://content9.flixster.com/movie/10/88/65/10886599_det.jpg
297,The Pink Panther 2,2009,3.5,128,16,112,12,3.9,25,4,21,16,3.1,77879,48,http://content7.flixster.com/movie/10/86/24/10862497_det.jpg
298,Tui shou,1992,0,2,2,0,100,0,0,0,0,0,0,0,0,http://content8.flixster.com/movie/10/84/00/10840038_det.jpg
299,Priest,1994,7.2,19,13,6,68,0,4,3,1,75,3.8,1042,81,http://content9.flixster.com/movie/11/12/75/11127515_det.jpg
300,Quiz Show,1994,8.1,50,48,2,96,8.2,12,12,0,100,3.5,5428,79,http://content6.flixster.com/movie/25/87/258704_det.jpg
301,Picture Bride,1994,6.8,10,8,2,80,0,3,3,0,100,3.7,324,77,http://content8.flixster.com/movie/26/07/260722_det.jpg
302,La reine Margot,1994,5.9,22,17,5,77,0,2,1,1,50,4,2511,86,http://content7.flixster.com/movie/10/88/68/10886821_det.jpg
303,The Quick and the Dead,1995,5.9,39,22,17,56,4.2,8,1,7,12,3.1,12178,56,http://content8.flixster.com/movie/27/21/272198_det.jpg
304,Roommates,1995,5.1,13,4,9,30,0,2,0,2,0,3.2,387,51,http://content7.flixster.com/movie/26/08/260809_det.jpg
305,Prêt-à-Porter,1994,4.8,21,6,15,28,4.3,5,0,5,0,2.5,1885,26,http://content6.flixster.com/movie/27/50/275000_det.jpg
306,Trois couleurs: Rouge,1994,8.5,40,40,0,100,8.2,10,10,0,100,4.2,9557,94,http://content7.flixster.com/movie/10/87/54/10875473_det.jpg
307,Trois couleurs: Bleu,1993,8.4,32,32,0,100,8,5,5,0,100,4.2,11731,93,http://content7.flixster.com/movie/11/12/07/11120777_det.jpg
308,Trzy kolory: Bialy,1994,7.5,31,28,3,90,7.6,9,9,0,100,3.9,5105,86,http://content8.flixster.com/movie/10/87/62/10876274_det.jpg
309,Pao Da Shuang Deng,1994,0,4,3,1,75,0,1,0,1,0,4.6,71,100,http://content9.flixster.com/movie/10/89/26/10892695_det.jpg
310,Rent-a-Kid,1995,0,0,0,0,0,0,0,0,0,0,0,0,0,http://content6.flixster.com/movie/96/79/10/9679108_det.jpg
312,Stuart Saves His Family,1995,4.6,25,7,18,28,5.2,10,3,7,30,2.6,531,44,http://content9.flixster.com/movie/10/84/58/10845847_det.jpg
313,The Swan Princess,1994,5.3,9,4,5,44,0,3,2,1,66,3.1,5951,66,http://content9.flixster.com/movie/10/89/44/10894435_det.jpg
314,The Secret of Roan Inish,1994,7.8,40,39,1,97,7.5,12,11,1,91,3.9,1439,86,http://content8.flixster.com/movie/10/88/77/10887722_det.jpg
315,The Specialist,1994,3.1,24,1,23,4,3.8,5,0,5,0,2.5,5147,34,http://content8.flixster.com/movie/27/73/277302_det.jpg
316,Stargate,1994,5.2,37,17,20,45,0,4,1,3,25,3.3,23611,75,http://content6.flixster.com/movie/26/48/264812_det.jpg
317,Santa Claus,1985,4.1,17,3,14,17,0,1,0,1,0,3.1,2513,66,http://content7.flixster.com/movie/25/49/254909_det.jpg
318,The Shawshank Redemption,1994,8,57,50,7,87,7.9,11,10,1,90,4.4,168839,98,http://content9.flixster.com/movie/11/12/45/11124527_det.jpg
319,Shallow Grave,1994,6.4,42,30,12,71,5.4,10,5,5,50,3.6,9041,81,http://content7.flixster.com/movie/28/27/282713_det.jpg
320,Suture,1993,6.2,11,7,4,63,0,3,0,3,0,3.6,236,74,http://content7.flixster.com/movie/10/91/57/10915785_det.jpg
321,Fresa y chocolate,1994,6.6,19,15,4,78,0,2,2,0,100,3.9,848,83,http://content6.flixster.com/movie/10/89/25/10892516_det.jpg
322,Swimming with Sharks,1994,6.3,33,25,8,75,5.4,10,5,5,50,3.6,2888,78,http://content7.flixster.com/movie/27/81/278121_det.jpg
324,The Sum of Us,1994,6.5,13,9,4,69,0,2,1,1,50,3.6,1056,74,http://content6.flixster.com/movie/27/41/274112_det.jpg
325,Senior Trip,1995,2.6,7,0,7,0,0,1,0,1,0,3,1370,53,http://content7.flixster.com/movie/10/86/94/10869433_det.jpg
326,Huozhe,1994,8.1,14,12,2,85,0,3,3,0,100,4.3,1836,95,http://content8.flixster.com/movie/10/97/19/10971966_det.jpg
327,Tank Girl,1995,4.9,33,14,19,42,5.3,9,4,5,44,2.8,7013,61,http://content8.flixster.com/movie/10/91/40/10914042_det.jpg
328,Tales from the Crypt: Demon Knight,1995,4,23,7,16,30,3.4,7,1,6,14,3.2,4989,63,http://content9.flixster.com/movie/10/88/79/10887979_det.jpg
329,Star Trek: Generations,1994,5.5,44,20,24,45,6.4,9,6,3,66,3.3,15342,62,http://content6.flixster.com/movie/10/88/86/10888600_det.jpg
330,Tales from the Hood,1995,4.3,15,5,10,33,0,2,1,1,50,3.1,2119,58,http://content9.flixster.com/movie/27/30/273091_det.jpg
331,Tom & Viv,1994,4.8,11,4,7,36,0,2,1,1,50,3.4,351,59,http://content7.flixster.com/movie/26/43/264309_det.jpg
332,Village of the Damned,1995,4,30,9,21,30,4.2,5,2,3,40,2.7,4194,36,http://content6.flixster.com/movie/11/15/07/11150724_det.jpg
333,Tommy Boy,1995,5.2,38,17,21,44,3.6,6,1,5,16,3.6,34476,89,http://content6.flixster.com/movie/26/58/265820_det.jpg
334,Vanya on 42nd Street,1994,7.6,32,28,4,87,7.7,9,8,1,88,3.7,466,73,http://content8.flixster.com/movie/10/92/26/10922666_det.jpg
335,Underneath,1995,5.7,19,10,9,52,5.8,8,3,5,37,3,405,36,http://content8.flixster.com/movie/28/03/280322_det.jpg
336,Incubo sulla città contaminata,1980,0,4,2,2,50,0,0,0,0,0,0,0,0,http://content6.flixster.com/movie/10/89/70/10897052_det.jpg
337,What's Eating Gilbert Grape,1993,7.3,42,37,5,88,5.8,9,6,3,66,3.7,57512,86,http://content8.flixster.com/movie/25/42/254226_det.jpg
338,Virtuosity,1995,4.3,29,10,19,34,4,8,2,6,25,2.8,4167,37,http://content7.flixster.com/movie/27/58/275825_det.jpg
339,While You Were Sleeping,1995,6.5,41,35,6,85,6.5,13,11,2,84,3.2,25923,75,http://content7.flixster.com/movie/63/59/09/6359097_det.jpg
340,War,2007,0,0,0,0,0,0,0,0,0,0,0,0,0,http://content7.flixster.com/movie/10/84/31/10843105_det.jpg
341,Double Happiness,1994,7,10,7,3,70,0,2,2,0,100,3.4,627,61,http://content9.flixster.com/movie/51/27/62/5127627_det.jpg
342,Muriel's Wedding,1994,7.1,32,29,3,90,0,4,4,0,100,3.4,8356,78,http://content7.flixster.com/movie/26/76/267629_det.jpg
343,The Baby-Sitters Club,1995,6,15,9,6,60,6.1,7,3,4,42,2.9,1930,46,http://content6.flixster.com/movie/26/16/261608_det.jpg
344,Ace Ventura: Pet Detective,1994,4.6,37,18,19,48,0,2,0,2,0,3.1,163811,57,http://content7.flixster.com/movie/11/14/42/11144273_det.jpg
345,"The Adventures of Priscilla, Queen of the Desert",1994,7,29,27,2,93,7,6,5,1,83,3.7,8695,84,http://content8.flixster.com/movie/11/15/32/11153218_det.jpg
346,Backbeat,1994,6.2,34,25,9,73,6.5,9,6,3,66,3.3,926,67,http://content7.flixster.com/movie/28/07/280793_det.jpg
347,Bitter Moon,1992,6.2,29,19,10,65,4.7,8,3,5,37,3.8,3436,79,http://content8.flixster.com/movie/27/35/273518_det.jpg
348,Bullets Over Broadway,1994,7.9,54,52,2,96,8.2,12,12,0,100,3.6,3913,79,http://content8.flixster.com/movie/26/94/269498_det.jpg
349,Clear and Present Danger,1994,6.8,37,29,8,78,7.1,9,7,2,77,3.3,11095,69,http://content6.flixster.com/movie/26/52/265216_det.jpg
350,The Client,1994,6.1,35,28,7,80,6.2,7,5,2,71,3.3,7408,67,http://content8.flixster.com/movie/26/01/260102_det.jpg
351,"Corrina, Corrina",1994,5.2,16,6,10,37,0,3,0,3,0,3.1,4265,65,http://content7.flixster.com/movie/25/88/258897_det.jpg
352,Crooklyn,1994,6.6,24,18,6,75,6.8,7,6,1,85,4.1,3115,87,http://content7.flixster.com/movie/25/71/257101_det.jpg
353,The Crow,1994,7,40,33,7,82,6.9,8,6,2,75,3.8,64467,87,http://content6.flixster.com/movie/10/93/21/10932156_det.jpg
354,Cobb,1994,6.2,32,21,11,65,5.2,8,4,4,50,3.2,875,57,http://content7.flixster.com/movie/27/09/270909_det.jpg
355,The Flintstones,1994,3.7,40,8,32,20,4.5,7,2,5,28,2.5,11823,35,http://content7.flixster.com/movie/10/87/96/10879629_det.jpg
356,Forrest Gump,1994,6.9,53,37,16,69,7,13,9,4,69,4.1,205253,93,http://content7.flixster.com/movie/60/49/71/6049713_det.jpg
357,Four Weddings and a Funeral,1994,7.5,49,47,2,95,7.3,9,8,1,88,3.2,21524,68,http://content7.flixster.com/movie/28/17/281725_det.jpg
358,Higher Learning,1995,5.3,34,17,17,50,4.6,11,4,7,36,3.5,4026,77,http://content7.flixster.com/movie/33/06/29/3306293_det.jpg
359,I Like It Like That,1994,7.4,9,7,2,77,0,3,3,0,100,4,625,85,http://content8.flixster.com/movie/27/50/275006_det.jpg
360,I Love Trouble,1994,\N,\N,\N,\N,\N,\N,\N,\N,\N,\N,\N,\N,\N,\N
361,It Could Happen to You,1994,6.2,34,23,11,67,6.2,8,6,2,75,3,6180,53,http://content9.flixster.com/movie/25/86/258695_det.jpg
362,The Jungle Book,1967,7.3,27,24,3,88,0,2,1,1,50,3.5,35715,70,http://content7.flixster.com/movie/25/07/250701_det.jpg
363,Die Macht der Bilder: Leni Riefenstahl,1993,7.6,22,21,1,95,0,4,3,1,75,3.7,257,81,http://content7.flixster.com/movie/29/44/294405_det.jpg
364,The Lion King,1994,8,61,56,5,91,7.8,13,13,0,100,3.9,127550,89,http://content7.flixster.com/movie/25/07/250709_det.jpg
365,Little Buddha,1993,5.8,22,14,8,63,6.4,7,4,3,57,3.1,2898,50,http://content8.flixster.com/movie/25/64/256422_det.jpg
366,New Nightmare,1994,6.6,31,25,6,80,6.3,9,7,2,77,3.2,11902,65,http://content7.flixster.com/movie/11/13/01/11130129_det.jpg
367,The Mask,1994,6.4,44,33,11,75,6.1,9,5,4,55,3.2,68419,66,http://content6.flixster.com/movie/62/33/43/6233432_det.jpg
368,Maverick,1994,6,37,26,11,70,7.4,6,6,0,100,3.2,11507,68,http://content7.flixster.com/movie/25/61/256125_det.jpg
369,Mrs. Parker and the Vicious Circle,1994,6.3,24,17,7,70,0,3,2,1,66,3.5,634,62,http://content8.flixster.com/movie/10/93/78/10937814_det.jpg
370,Naked Gun 33 1/3: The Final Insult,1994,5.6,32,17,15,53,7,7,6,1,85,2.9,10482,59,http://content6.flixster.com/movie/10/93/73/10937364_det.jpg
371,The Paper,1994,6.7,31,27,4,87,6.9,7,6,1,85,3.1,1357,54,http://content9.flixster.com/movie/10/95/42/10954299_det.jpg
372,Reality Bites,1994,6,42,27,15,64,6.1,9,5,4,55,3.3,10533,74,http://content6.flixster.com/movie/10/87/05/10870532_det.jpg
373,Red Rock West,1993,7.5,37,35,2,94,7.2,8,7,1,87,0,0,0,http://content6.flixster.com/movie/27/59/275920_det.jpg
374,Ri¢hie Ri¢h,1994,4.2,20,5,15,25,4.8,5,2,3,40,2.5,10242,38,http://content6.flixster.com/movie/10/94/80/10948008_det.jpg
375,Safe Passage,1994,5.8,12,6,6,50,0,3,1,2,33,3.4,310,59,http://content8.flixster.com/movie/10/86/70/10867050_det.jpg
376,The River Wild,1994,5.8,27,15,12,55,5.8,6,3,3,50,2.9,5610,50,http://content8.flixster.com/movie/10/92/73/10927394_det.jpg
377,Speed,1994,7.6,41,37,4,90,7.1,9,7,2,77,3.3,51008,72,http://content6.flixster.com/movie/27/61/276116_det.jpg
378,Speechless,1994,3.9,25,3,22,12,3.8,6,0,6,0,2.8,683,34,http://content9.flixster.com/movie/11/12/48/11124819_det.jpg
379,Timecop,1994,5.3,38,18,20,47,5.1,9,4,5,44,2.6,6534,38,http://content6.flixster.com/movie/11/12/53/11125356_det.jpg
380,True Lies,1994,6.4,45,31,14,68,5.4,9,5,4,55,3.2,27905,70,http://content8.flixster.com/movie/31/37/313714_det.jpg
381,When a Man Loves a Woman,1994,6.5,19,13,6,68,0,3,2,1,66,3.3,6791,76,http://content6.flixster.com/movie/26/88/268892_det.jpg
382,Wolf,1994,5.9,48,29,19,60,5.9,8,5,3,62,2.8,6634,43,http://content7.flixster.com/movie/10/26/03/10260341_det.jpg
383,Wyatt Earp,1994,5.3,26,11,15,42,0,3,0,3,0,3.2,8070,63,http://content7.flixster.com/movie/55/06/10/5506105_det.jpg
384,Bad Company,2002,3.9,134,14,120,10,4,31,5,26,16,2.8,6415,42,http://content6.flixster.com/movie/26/66/266604_det.jpg
385,A Man of No Importance,1994,7,12,10,2,83,0,3,2,1,66,3.6,111,62,http://content9.flixster.com/movie/10/88/98/10889863_det.jpg
386,S.F.W.,1994,3.2,16,2,14,12,0,2,0,2,0,3,1184,49,http://content7.flixster.com/movie/27/88/278813_det.jpg
387,A Low Down Dirty Shame,1994,3.6,20,0,20,0,3.5,6,0,6,0,2.9,3460,58,http://content7.flixster.com/movie/27/42/274201_det.jpg
388,This Boy's Life,1993,6.3,34,26,8,76,5,10,4,6,40,3.5,5072,76,http://content7.flixster.com/movie/10/89/12/10891257_det.jpg
389,Le colonel Chabert,1994,7.1,6,5,1,83,0,1,1,0,100,3.6,142,59,http://content6.flixster.com/movie/10/92/93/10929336_det.jpg
390,"Faster, Pussycat! Kill! Kill!",1965,6.9,25,18,7,72,0,3,2,1,66,3.8,3351,77,http://content8.flixster.com/movie/11/69/36/1169362_det.jpg
391,Jason's Lyric,1994,6,14,10,4,71,0,3,2,1,66,4,2470,87,http://content9.flixster.com/movie/52/53/79/5253791_det.jpg
392,The Secret Adventures of Tom Thumb,1993,6.3,5,4,1,80,0,0,0,0,0,0,0,0,http://content8.flixster.com/movie/10/86/72/10867206_det.jpg
393,Street Fighter,1994,2.9,24,3,21,12,0,4,0,4,0,2.2,10305,25,http://content9.flixster.com/movie/10/87/27/10872731_det.jpg
394,In Cold Blood,1967,8.3,25,22,3,88,7.8,5,4,1,80,3.8,2614,83,http://content6.flixster.com/movie/10/87/75/10877588_det.jpg
395,Desert Winds,1995,4.3,9,2,7,22,4.5,6,2,4,33,4,36,100,http://content7.flixster.com/movie/10/85/18/10851869_det.jpg
396,Fall Time,1995,0,3,0,3,0,0,0,0,0,0,0,0,0,http://content9.flixster.com/movie/63/57/62/6357627_det.jpg
397,Cape Fear,1991,6.9,38,29,9,76,8.3,6,6,0,100,3.4,13943,74,http://content9.flixster.com/movie/10/93/72/10937223_det.jpg
398,Frank and Ollie,1995,7.3,8,7,1,87,0,1,1,0,100,3.9,177,83,http://content9.flixster.com/movie/26/14/261491_det.jpg
401,Mirage,1965,0,3,2,1,66,0,0,0,0,0,0,0,0,http://content8.flixster.com/movie/10/85/38/10853846_det.jpg
402,Open Season,2006,5.4,98,46,52,46,5.7,24,13,11,54,3.4,91895,66,http://content8.flixster.com/movie/10/91/66/10916662_det.jpg
404,Brother Minister: The Assassination of Malcolm X,1994,0,1,1,0,100,0,1,1,0,100,4.2,76,90,http://content6.flixster.com/movie/10/88/20/10882016_det.jpg
405,Highlander III: The Sorcerer,1994,0,0,0,0,0,0,0,0,0,0,0,0,0,http://content6.flixster.com/movie/10/94/47/10944768_det.jpg
406,Federal Hill,1994,6.4,15,12,3,80,6.2,9,6,3,66,3,131,41,http://content7.flixster.com/movie/28/10/281025_det.jpg
407,In the Mouth of Madness,1995,5,29,14,15,48,4.6,7,2,5,28,3.5,5731,73,http://content9.flixster.com/movie/10/88/81/10888183_det.jpg
408,8 Seconds,1994,5.2,12,4,8,33,0,2,0,2,0,3.6,7861,89,http://content8.flixster.com/movie/25/61/256194_det.jpg
409,Above the Rim,1994,5.4,18,10,8,55,5,6,3,3,50,3.5,4319,84,http://content9.flixster.com/movie/26/96/269603_det.jpg
410,Addams Family Values,1993,6.3,35,26,9,74,5.5,7,4,3,57,3.1,21548,57,http://content9.flixster.com/movie/26/62/266215_det.jpg
412,The Age of Innocence,1993,\N,\N,\N,\N,\N,\N,\N,\N,\N,\N,\N,\N,\N,\N
413,Airheads,1994,4.2,31,7,24,22,4.6,8,3,5,37,2.9,13551,51,http://content6.flixster.com/movie/26/02/260296_det.jpg
414,The Air Up There,1994,4,26,6,20,23,3,6,0,6,0,2.6,2385,33,http://content8.flixster.com/movie/10/89/39/10893994_det.jpg
415,Another Stakeout,1993,3.9,21,3,18,14,0,3,1,2,33,2.5,1861,31,http://content6.flixster.com/movie/10/88/81/10888176_det.jpg
416,Bad Girls,1994,3.5,21,2,19,9,0,4,0,4,0,2.8,5946,49,http://content6.flixster.com/movie/10/87/26/10872684_det.jpg
417,Vicky Cristina Barcelona,2008,6.9,188,154,34,81,7.2,35,29,6,82,3.6,45494,73,http://content7.flixster.com/movie/11/13/43/11134349_det.jpg
418,Being Human,2008,\N,\N,\N,\N,\N,\N,\N,\N,\N,\N,\N,\N,\N,\N
419,The Beverly Hillbillies,1993,3.6,28,7,21,25,4.2,8,3,5,37,2.5,4897,40,http://content8.flixster.com/movie/37/13/33/3713338_det.jpg
420,Beverly Hills Cop III,1994,3.3,30,3,27,10,2.9,6,0,6,0,2.9,12777,50,http://content8.flixster.com/movie/10/84/44/10844414_det.jpg
421,Black Beauty,1994,0,0,0,0,0,0,0,0,0,0,0,0,0,http://content8.flixster.com/movie/10/93/24/10932426_det.jpg
423,Blown Away,1994,4.8,18,5,13,27,0,3,0,3,0,2.9,3591,46,http://content7.flixster.com/movie/27/66/276629_det.jpg
424,Blue Chips,1994,5.1,26,10,16,38,4.6,8,3,5,37,3,1545,50,http://content8.flixster.com/movie/26/12/261294_det.jpg
425,Blue Sky,1994,6.3,18,13,5,72,0,3,2,1,66,3.2,809,52,http://content8.flixster.com/movie/10/90/79/10907954_det.jpg
426,Invasion of the Body Snatchers,1956,8.9,36,36,0,100,0,2,2,0,100,3.6,3820,81,http://content8.flixster.com/movie/10/95/44/10954478_det.jpg
427,Boxing Helena,1993,3.7,30,6,24,20,3.4,7,1,6,14,2.6,1775,39,http://content8.flixster.com/movie/10/88/01/10880190_det.jpg
428,A Bronx Tale,1993,7.4,26,25,1,96,0,3,3,0,100,3.9,17840,89,http://content7.flixster.com/movie/10/88/62/10886213_det.jpg
429,Cabin Boy,1994,4.9,23,10,13,43,0,2,0,2,0,2.4,1694,36,http://content8.flixster.com/movie/26/13/261398_det.jpg
430,Calendar Girls,2003,6.5,118,87,31,73,6.5,33,23,10,69,3.1,8453,59,http://content6.flixster.com/movie/10/90/15/10901532_det.jpg
431,Carlito's Way,1993,6.8,33,27,6,81,0,4,2,2,50,3.8,32475,88,http://content8.flixster.com/movie/14/81/59/1481590_det.jpg
432,City Slickers II: The Legend of Curly's Gold,1994,3.6,21,4,17,19,0,3,0,3,0,2.7,5885,34,http://content9.flixster.com/movie/10/84/98/10849883_det.jpg
433,Clean Slate,1994,4.1,16,3,13,18,0,2,0,2,0,2.5,630,33,http://content6.flixster.com/movie/26/42/264200_det.jpg
434,Cliffhanger,1993,6.3,33,27,6,81,6.2,7,5,2,71,2.8,9768,47,http://content8.flixster.com/movie/10/88/05/10880598_det.jpg
435,Coneheads,1993,4.5,27,9,18,33,4.7,8,3,5,37,2.6,9202,37,http://content9.flixster.com/movie/25/66/256607_det.jpg
436,Color of Night,1994,3.9,26,8,18,30,0,3,0,3,0,2.7,3955,40,http://content9.flixster.com/movie/27/04/270403_det.jpg
437,Cops and Robbersons,1994,3.5,19,3,16,15,2.6,6,0,6,0,2.5,1201,26,http://content7.flixster.com/movie/10/93/94/10939473_det.jpg
438,The Cowboy Way,1994,4.2,12,2,10,16,0,2,0,2,0,3,2782,61,http://content9.flixster.com/movie/10/88/51/10885187_det.jpg
440,Dave,1993,7.4,37,36,1,97,7.5,9,9,0,100,3.1,4985,63,http://content7.flixster.com/movie/11/12/76/11127633_det.jpg
441,Dazed and Confused,1993,7.9,41,40,1,97,7.6,7,6,1,85,3.8,45956,89,http://content9.flixster.com/movie/10/84/23/10842359_det.jpg
442,Demolition Man,1993,5.6,32,20,12,62,4.2,8,3,5,37,3,16135,60,http://content6.flixster.com/movie/26/97/269712_det.jpg
443,The Endless Summer 2,1994,5.8,14,8,6,57,5,5,2,3,40,4,802,89,http://content6.flixster.com/movie/25/72/257204_det.jpg
444,Even Cowgirls Get the Blues,1993,3.2,17,4,13,23,0,3,0,3,0,2.6,1583,31,http://content7.flixster.com/movie/10/85/48/10854861_det.jpg
445,Fatal Instinct,1993,4.2,20,4,16,20,3.6,8,1,7,12,2.6,808,36,http://content9.flixster.com/movie/10/88/78/10887875_det.jpg
446,Ba wang bie ji,1993,7.4,33,29,4,87,7.2,10,8,2,80,4.1,4321,91,http://content7.flixster.com/movie/10/89/59/10895913_det.jpg
447,The Favor,1994,4.9,10,3,7,30,0,3,0,3,0,2.8,891,23,http://content9.flixster.com/movie/27/86/278691_det.jpg
448,Huo Yuan Jia,2006,0,0,0,0,0,0,0,0,0,0,0,0,0,http://content9.flixster.com/movie/10/85/48/10854871_det.jpg
449,Fear of a Black Hat,1994,7,19,16,3,84,7.2,8,8,0,100,3.8,898,81,http://content9.flixster.com/movie/27/00/270091_det.jpg
450,With Honors,1994,4,21,4,17,19,0,3,0,3,0,3.3,3484,72,http://content8.flixster.com/movie/25/81/258122_det.jpg
451,Flesh and Bone,1993,6.1,23,16,7,69,0,3,1,2,33,3,851,40,http://content9.flixster.com/movie/28/02/280207_det.jpg
452,Widows' Peak,1994,7.1,15,15,0,100,0,3,3,0,100,3.2,348,46,http://content6.flixster.com/movie/11/13/22/11132224_det.jpg
453,For Love or Money,1993,\N,\N,\N,\N,\N,\N,\N,\N,\N,\N,\N,\N,\N,\N
454,The Firm,1993,6.2,50,38,12,76,5,9,4,5,44,3.2,11507,61,http://content8.flixster.com/movie/28/38/283822_det.jpg
455,Free Willy,1993,5.5,21,11,10,52,0,3,2,1,66,2.9,19451,48,http://content8.flixster.com/movie/10/88/31/10883198_det.jpg
456,Fresh,1994,7.5,19,17,2,89,0,3,3,0,100,4,1823,90,http://content7.flixster.com/movie/27/16/271605_det.jpg
457,The Fugitive,1993,7.6,52,49,3,94,8,9,9,0,100,3.6,28862,82,http://content9.flixster.com/movie/11/12/17/11121787_det.jpg
458,Geronimo: An American Legend,1993,6.2,17,9,8,52,0,3,1,2,33,3.2,1686,53,http://content8.flixster.com/movie/25/94/259426_det.jpg
459,A Perfect Getaway,2009,5.8,124,76,48,61,5.9,29,18,11,62,3.2,102622,50,http://content7.flixster.com/movie/10/91/93/10919317_det.jpg
460,Getting Even with Dad,1994,3.3,12,1,11,8,0,3,0,3,0,2.4,2200,29,http://content7.flixster.com/movie/10/92/22/10922209_det.jpg
461,Go Fish,1994,6.6,13,10,3,76,7.4,5,4,1,80,3.2,898,54,http://content9.flixster.com/movie/27/62/276227_det.jpg
462,A Good Man in Africa,1994,4.4,8,1,7,12,0,2,0,2,0,2.9,306,34,http://content9.flixster.com/movie/10/87/38/10873887_det.jpg
463,Guilty as Sin,1993,5.2,13,5,8,38,0,3,2,1,66,2.8,474,30,http://content7.flixster.com/movie/27/69/276993_det.jpg
464,Hard Target,1993,5.2,29,14,15,48,5.6,7,4,3,57,0,0,0,http://content6.flixster.com/movie/27/33/273300_det.jpg
465,Heaven & Earth,1993,5.2,17,8,9,47,5.8,5,2,3,40,3.6,1458,71,http://content8.flixster.com/movie/10/86/70/10867030_det.jpg
466,Hot Shots! Part Deux,1993,5.6,28,17,11,60,5.8,6,3,3,50,3,9890,61,http://content8.flixster.com/movie/25/63/256302_det.jpg
467,Live Nude Girls,1995,4.4,8,3,5,37,0,1,1,0,100,3.2,368,46,http://content8.flixster.com/movie/49/96/89/4996890_det.jpg
468,The Englishman Who Went Up a Hill But Came Down a Mountain,1995,5.8,22,13,9,59,7,5,4,1,80,3,3033,50,http://content9.flixster.com/movie/25/71/257199_det.jpg
469,The House of the Spirits,1993,5.4,14,6,8,42,0,3,1,2,33,3.7,3169,74,http://content6.flixster.com/movie/10/86/83/10868328_det.jpg
470,House Party 3,1994,2.7,6,0,6,0,0,0,0,0,0,0,0,0,http://content6.flixster.com/movie/27/44/274420_det.jpg
471,The Hudsucker Proxy,1994,6.2,38,22,16,57,4.1,9,2,7,22,3.6,10291,80,http://content9.flixster.com/movie/10/87/85/10878555_det.jpg
472,I'll Do Anything,1994,5.2,17,10,7,58,0,3,3,0,100,3,481,40,http://content7.flixster.com/movie/26/50/265009_det.jpg
473,In the Army Now,1994,2.2,21,0,21,0,2.5,5,0,5,0,2.5,3672,47,http://content6.flixster.com/movie/25/72/257292_det.jpg
474,In the Line of Fire,1993,7.6,41,39,2,95,8.3,7,6,1,85,3.4,7831,72,http://content8.flixster.com/movie/10/80/52/10805270_det.jpg
475,In the Name of the Father,1993,7.6,39,37,2,94,7.4,9,8,1,88,4,10715,92,http://content8.flixster.com/movie/27/01/270126_det.jpg
476,The Inkwell,1994,5,7,2,5,28,0,2,1,1,50,3.8,507,78,http://content9.flixster.com/movie/27/42/274219_det.jpg
477,What's Love Got to Do with It,1993,7.5,33,32,1,96,8.2,7,7,0,100,3.6,9612,83,http://content6.flixster.com/movie/10/90/34/10903400_det.gif
478,Jimmy Hollywood,1994,4.1,20,3,17,15,0,3,0,3,0,2.5,544,24,http://content6.flixster.com/movie/28/19/281900_det.jpg
479,Judgment Night,1993,4.2,15,4,11,26,3.2,5,1,4,20,3.1,2059,53,http://content9.flixster.com/movie/27/97/279711_det.jpg
480,Jurassic Park,1993,7.2,38,33,5,86,7.1,10,9,1,90,3.6,91260,81,http://content9.flixster.com/movie/25/84/258423_det.jpg
481,Kalifornia,1993,6.2,24,16,8,66,0,2,1,1,50,3.2,9852,63,http://content9.flixster.com/movie/28/45/284507_det.jpg
482,Killing Zoe,1993,5.1,25,10,15,40,0,2,0,2,0,3.4,3407,65,http://content6.flixster.com/movie/28/49/284992_det.jpg
483,King of the Hill,1993,7.9,25,24,1,96,7.8,7,6,1,85,3.6,963,77,http://content8.flixster.com/movie/85/27/98/8527986_det.jpg
484,Lassie,1994,6.8,8,6,2,75,0,2,2,0,100,2.9,2576,52,http://content8.flixster.com/movie/26/34/263402_det.jpg
485,Last Action Hero,1993,4.9,37,14,23,37,4.6,5,1,4,20,2.6,11445,43,http://content6.flixster.com/movie/55/36/01/5536016_det.jpg
486,Life with Mikey,1993,3.9,9,2,7,22,0,2,0,2,0,2.8,1377,39,http://content9.flixster.com/movie/26/48/264827_det.jpg
487,Lightning Jack,1994,3.4,16,1,15,6,3.9,6,1,5,16,2.8,2199,43,http://content9.flixster.com/movie/10/91/89/10918935_det.jpg
488,M. Butterfly,1993,0,0,0,0,0,0,0,0,0,0,0,0,0,http://images.rottentomatoescdn.com/images/defaults/poster_default.gif
489,Made in America,1993,3.9,28,8,20,28,0,3,1,2,33,2.5,4179,38,http://content7.flixster.com/movie/10/87/20/10872029_det.jpg
490,Malice,1993,5.8,18,10,8,55,0,3,0,3,0,3,2429,42,http://content8.flixster.com/movie/28/45/284522_det.jpg
491,The Man Without a Face,1993,5.7,20,12,8,60,0,3,2,1,66,3.1,5277,63,http://content8.flixster.com/movie/10/88/44/10884478_det.jpg
492,Manhattan Murder Mystery,1993,6.9,21,19,2,90,0,3,3,0,100,3.7,4405,81,http://content8.flixster.com/movie/11/12/42/11124250_det.jpg
493,Menace II Society,1993,7.4,34,29,5,85,8,8,7,1,87,3.8,14420,88,http://content6.flixster.com/movie/10/84/96/10849636_det.jpg
494,Executive Decision,1996,6,37,24,13,64,6.3,10,6,4,60,2.9,5176,51,http://content6.flixster.com/movie/10/89/53/10895300_det.jpg
495,Ai no korîda,1976,7.5,28,23,5,82,0,1,1,0,100,3.5,1565,67,http://content8.flixster.com/movie/12/84/25/1284250_det.jpg
496,What Happened Was...,1994,7,20,18,2,90,0,4,3,1,75,4.1,120,84,http://content6.flixster.com/movie/10/19/72/10197236_det.jpg
497,Much Ado About Nothing,1993,7.1,41,37,4,90,6.8,8,6,2,75,3.6,9764,82,http://content8.flixster.com/movie/26/63/266326_det.jpg
498,Mr. Jones,1993,5.2,13,6,7,46,0,2,1,1,50,3,1067,45,http://content7.flixster.com/movie/10/84/75/10847577_det.jpg
499,Mr. Wonderful,1993,5.9,18,10,8,55,6.1,5,3,2,60,3.1,870,46,http://content6.flixster.com/movie/26/28/262824_det.jpg
500,Mrs. Doubtfire,1993,5.7,42,27,15,64,0,2,1,1,50,3.4,61130,73,http://content6.flixster.com/movie/25/85/258512_det.jpg
501,Naked,1993,8,21,19,2,90,0,2,2,0,100,4.3,3386,92,http://content9.flixster.com/movie/10/84/20/10842067_det.jpg
502,The Next Karate Kid,1994,3.6,17,1,16,5,0,4,0,4,0,0,0,0,http://content8.flixster.com/movie/26/25/262502_det.jpg
503,The New Age,1994,6,11,7,4,63,0,3,2,1,66,3.1,82,40,http://content8.flixster.com/movie/10/85/39/10853990_det.jpg
504,No Escape,1994,5.1,15,8,7,53,0,3,0,3,0,3,2147,43,http://content6.flixster.com/movie/28/52/285208_det.jpg
505,North,1994,3,18,2,16,11,0,3,0,3,0,2.6,2932,32,http://content9.flixster.com/movie/41/65/59/4165591_det.jpg
506,Orlando,1992,6.2,26,21,5,80,0,2,1,1,50,3.9,2705,81,http://content9.flixster.com/movie/11/12/17/11121747_det.jpg
507,A Perfect World,1993,7.2,27,22,5,81,7.4,5,4,1,80,3.5,7814,77,http://content8.flixster.com/movie/10/83/83/10838374_det.jpg
508,Philadelphia,1993,6.5,43,32,11,74,6.7,5,4,1,80,3.7,20896,87,http://content6.flixster.com/movie/10/93/80/10938004_det.jpg
509,The Piano,1993,8,45,40,5,88,9.3,7,7,0,100,3.7,12303,86,http://content7.flixster.com/movie/10/87/64/10876465_det.jpg
510,Poetic Justice,1993,4.6,14,5,9,35,0,3,1,2,33,3.4,5709,83,http://content7.flixster.com/movie/10/85/49/10854961_det.jpg
511,The Program,1993,5,14,5,9,35,0,3,1,2,33,3.6,2842,77,http://content8.flixster.com/movie/46/25/25/4625250_det.jpg
512,The Puppet Masters,1994,4.9,22,6,16,27,4,5,0,5,0,2.8,1068,38,http://content6.flixster.com/movie/10/93/87/10938732_det.jpg
513,Radioland Murders,1994,4,15,3,12,20,0,2,0,2,0,3.1,601,52,http://content6.flixster.com/movie/10/89/14/10891492_det.jpg
514,The Ref,1994,6.6,41,32,9,78,5.6,8,4,4,50,3.3,3390,73,http://content6.flixster.com/movie/26/83/268316_det.jpg
515,The Remains of the Day,1993,8.4,38,37,1,97,8.3,8,7,1,87,3.8,6319,86,http://content8.flixster.com/movie/25/57/255706_det.jpg
516,Renaissance Man,1994,4.4,18,3,15,16,0,3,0,3,0,2.9,2575,54,http://content8.flixster.com/movie/25/80/258018_det.jpg
517,Rising Sun,1993,5.1,35,12,23,34,5.2,11,4,7,36,2.9,4796,47,http://content6.flixster.com/movie/11/12/51/11125172_det.jpg
518,The Road to Wellville,1994,4.9,16,7,9,43,0,2,1,1,50,2.8,1442,39,http://content8.flixster.com/movie/27/26/272698_det.jpg
519,RoboCop 3,1993,3.1,28,1,27,3,3,6,0,6,0,2.3,6600,21,http://content6.flixster.com/movie/26/64/266400_det.jpg
520,Robin Hood: Men in Tights,1993,5.1,22,10,12,45,0,1,0,1,0,3.5,45946,79,http://content9.flixster.com/movie/10/93/73/10937331_det.jpg
521,Romeo Is Bleeding,1993,4.5,34,8,26,23,3.6,9,0,9,0,3.3,1704,62,http://content7.flixster.com/movie/27/18/271821_det.jpg
522,Romper Stomper,1992,6.2,24,19,5,79,0,4,1,3,25,3.5,11581,72,http://content7.flixster.com/movie/10/94/01/10940169_det.jpg
523,Ruby in Paradise,1993,7.8,15,14,1,93,0,2,2,0,100,3.8,186,77,http://content6.flixster.com/movie/10/83/91/10839188_det.jpg
524,Rudy,1993,6.8,34,27,7,79,6.7,8,6,2,75,3.7,21916,88,http://content7.flixster.com/movie/10/84/77/10847749_det.jpg
525,The Saint of Fort Washington,1993,6.5,9,6,3,66,0,3,2,1,66,3.9,305,84,http://content8.flixster.com/movie/10/86/88/10868814_det.jpg
526,Les nuits fauves,1992,0,0,0,0,0,0,0,0,0,0,0,0,0,http://content7.flixster.com/movie/10/89/94/10899445_det.jpg
527,Schindler's List,1993,8.8,59,57,2,96,8.4,10,10,0,100,4.3,83125,96,http://content6.flixster.com/movie/26/71/267112_det.jpg
528,The Last Boy Scout,1991,5.1,30,13,17,43,0,4,2,2,50,3.3,11177,66,http://content9.flixster.com/movie/10/92/20/10922043_det.jpg
529,Searching for Bobby Fischer,1993,8.1,33,33,0,100,8.4,8,8,0,100,3.5,3580,81,http://content6.flixster.com/movie/25/59/255904_det.jpg
530,Second Best,2004,5,16,6,10,37,4.5,8,2,6,25,3,174,37,http://content8.flixster.com/movie/30/99/309926_det.jpg
531,The Secret Garden,1993,8.1,17,16,1,94,0,3,2,1,66,3.3,14794,72,http://content9.flixster.com/movie/11/15/28/11152871_det.jpg
532,Serial Mom,1994,5.8,44,27,17,61,4,8,1,7,12,3,6394,62,http://content6.flixster.com/movie/27/10/271008_det.jpg
533,Kagemusha,1980,7.5,19,16,3,84,0,2,1,1,50,4.2,4005,91,http://content6.flixster.com/movie/10/93/41/10934152_det.jpg
534,Shadowlands,1993,8,28,27,1,96,8.8,6,6,0,100,3.9,3260,85,http://content7.flixster.com/movie/25/57/255701_det.jpg
535,Short Cuts,1993,7.8,51,48,3,94,8.1,8,7,1,87,3.9,5867,87,http://content9.flixster.com/movie/11/12/17/11121735_det.jpg
536,A Simple Twist of Fate,1994,5.5,19,9,10,47,0,2,0,2,0,3.1,1672,52,http://content9.flixster.com/movie/26/22/262291_det.jpg
537,Sairen,2006,0,0,0,0,0,0,0,0,0,0,0,0,0,http://content7.flixster.com/movie/10/82/85/10828537_det.jpg
538,Six Degrees of Separation,1993,7.1,30,27,3,90,0,3,1,2,33,3.3,3720,67,http://content6.flixster.com/movie/10/84/47/10844780_det.jpg
539,Sleepless in Seattle,1993,6.5,43,31,12,72,5.6,10,6,4,60,3.3,36965,75,http://content7.flixster.com/movie/11/12/06/11120641_det.jpg
540,Sliver,1993,3.6,24,3,21,12,0,2,0,2,0,2.5,2511,34,http://content9.flixster.com/movie/19/52/73/1952731_det.jpg
541,Blade Runner,1982,0,0,0,0,0,0,0,0,0,0,0,0,0,http://content8.flixster.com/movie/10/85/39/10853986_det.jpg
542,Son in Law,1993,3.8,17,4,13,23,0,3,0,3,0,2.9,5679,62,http://content8.flixster.com/movie/25/67/256726_det.jpg
543,So I Married an Axe Murderer,1993,5.3,30,15,15,50,5,8,3,5,37,3,11154,66,http://content8.flixster.com/movie/10/86/72/10867222_det.jpg
544,Striking Distance,1993,3.6,19,3,16,15,0,2,0,2,0,2.8,4532,39,http://content8.flixster.com/movie/27/27/272702_det.jpg
545,Harem suaré,1999,0,1,1,0,100,0,0,0,0,0,0,0,0,http://content9.flixster.com/movie/27/77/277707_det.jpg
546,Super Mario Bros.,1993,\N,\N,\N,\N,\N,\N,\N,\N,\N,\N,\N,\N,\N,\N
547,Surviving the Game,1994,4.3,13,3,10,23,0,1,0,1,0,3,1673,48,http://content7.flixster.com/movie/27/64/276405_det.jpg
548,Terminal Velocity,1994,3.6,20,3,17,15,0,3,0,3,0,2.6,1883,25,http://content8.flixster.com/movie/90/84/39/9084394_det.jpg
549,Thirty Two Short Films About Glenn Gould,1993,8,17,15,2,88,0,3,3,0,100,3.8,1129,79,http://content6.flixster.com/movie/11/13/76/11137636_det.jpg
550,Threesome,1994,4.4,23,6,17,26,4.1,6,1,5,16,3,1708,52,http://content8.flixster.com/movie/27/55/275526_det.jpg
551,The Nightmare Before Christmas,1993,8.2,70,68,2,97,8.2,17,17,0,100,3.8,124838,89,http://content7.flixster.com/movie/10/87/87/10878797_det.jpg
552,The Three Musketeers,1993,4.8,24,7,17,29,0,3,0,3,0,3.2,13783,67,http://content7.flixster.com/movie/50/26/53/5026533_det.jpg
553,Tombstone,1993,6.4,39,30,9,76,0,3,0,3,0,3.8,31660,93,http://content7.flixster.com/movie/26/73/267317_det.jpg
554,Law & Order: Trial by Jury,2005,\N,\N,\N,\N,\N,\N,\N,\N,\N,\N,\N,\N,\N,\N
555,True Romance,1993,7.5,44,40,4,90,6.2,9,7,2,77,3.9,43205,90,http://content9.flixster.com/movie/38/28/09/3828095_det.jpg
556,Dr. Strangelove or: How I Learned to Stop Worrying and Love the Bomb,1964,9,58,58,0,100,8.6,8,8,0,100,4.2,33662,94,http://content8.flixster.com/movie/26/51/265102_det.jpg
558,The Pagemaster,1994,4.6,15,3,12,20,5,6,2,4,33,2.8,7531,49,http://content8.flixster.com/movie/10/88/87/10888782_det.jpg
559,2 Days in Paris,2007,6.8,113,96,17,84,6.9,34,30,4,88,3.6,27100,71,http://content6.flixster.com/movie/93/43/00/9343004_det.jpg
560,"The Beans of Egypt, Maine",1994,0,3,1,2,33,0,0,0,0,0,0,0,0,http://content8.flixster.com/movie/10/97/04/10970454_det.jpg
561,Killer Movie,2008,0,1,0,1,0,0,0,0,0,0,0,0,0,http://content7.flixster.com/movie/10/83/93/10839337_det.jpg
562,Welcome to the Dollhouse,1995,7.9,46,41,5,89,8.1,7,6,1,85,3.7,6911,84,http://content9.flixster.com/movie/10/88/33/10883391_det.jpg
563,Germinal,1993,6.9,10,9,1,90,0,2,2,0,100,3.7,511,71,http://content7.flixster.com/movie/39/89/93/3989933_det.jpg
564,Chugyeogja,2008,6.7,27,22,5,81,6.8,5,4,1,80,4,1927,88,http://content8.flixster.com/movie/10/85/52/10855238_det.jpg
565,Cronos,1993,7.3,35,31,4,88,7.8,7,6,1,85,3.5,3398,68,http://content9.flixster.com/movie/27/72/277211_det.jpg
566,Naked in New York,1993,6.1,11,6,5,54,0,3,1,2,33,2.9,444,34,http://content8.flixster.com/movie/28/30/283098_det.jpg
567,Kika,1993,5.7,13,8,5,61,5.1,5,2,3,40,0,0,0,http://content7.flixster.com/movie/10/91/08/10910897_det.jpg
568,Bhaji on the Beach,1993,7.4,8,7,1,87,0,2,2,0,100,3.3,372,60,http://content7.flixster.com/movie/10/90/24/10902481_det.jpg
569,Little Big League,1994,5.2,15,5,10,33,0,3,2,1,66,2.9,2288,50,http://content6.flixster.com/movie/25/93/259304_det.jpg
570,Kådisbellan,1993,6.9,9,8,1,88,0,1,1,0,100,3.5,76,59,http://content8.flixster.com/movie/10/84/06/10840610_det.jpg
571,Wide-Eyed and Legless,1993,6,5,2,3,40,0,2,1,1,50,0,0,0,http://content6.flixster.com/movie/10/91/81/10918184_det.jpg
572,Foreign Student,1994,0,3,1,2,33,0,0,0,0,0,0,0,0,http://content7.flixster.com/movie/10/97/01/10970101_det.jpg
573,Io speriamo che me la cavo,1992,6.2,7,4,3,57,0,2,1,1,50,3.6,412,71,http://content8.flixster.com/movie/10/88/08/10880806_det.jpg
574,Spanking the Monkey,1994,7.2,21,19,2,90,0,2,2,0,100,3.1,824,52,http://content8.flixster.com/movie/31/19/311926_det.jpg
575,The Little Rascals,1994,3.8,10,2,8,20,0,0,0,0,0,0,0,0,http://content6.flixster.com/movie/11/13/24/11132400_det.jpg
577,Andre,1994,5.3,16,7,9,43,0,2,0,2,0,2.7,2286,52,http://content9.flixster.com/movie/25/89/258903_det.jpg
579,La scorta,1993,5.9,7,4,3,57,0,3,0,3,0,3.3,52,59,http://content9.flixster.com/movie/10/91/35/10913527_det.jpg
580,Princess Caraboo,1994,5.7,14,8,6,57,0,3,0,3,0,3,723,43,http://content8.flixster.com/movie/26/16/261614_det.jpg
581,The Celluloid Closet,1995,7.8,24,23,1,95,8.6,5,5,0,100,3.9,1222,87,http://content9.flixster.com/movie/10/87/44/10874435_det.jpg
582,Métisse,1993,5.9,6,4,2,66,0,2,1,1,50,0,0,0,http://content8.flixster.com/movie/10/89/42/10894274_det.jpg
583,Caro diario,1993,6.7,9,6,3,66,0,2,0,2,0,4.1,936,86,http://content6.flixster.com/movie/43/98/42/4398424_det.jpg
585,The Brady Bunch Movie,1995,5.7,38,23,15,60,6.4,11,7,4,63,2.4,3906,38,http://content8.flixster.com/movie/10/70/30/10703022_det.jpg
586,Home Alone,1990,5,30,14,16,46,0,2,0,2,0,3.3,66201,74,http://content6.flixster.com/movie/31/21/312104_det.jpg
587,Ghost,1990,6.8,42,34,8,80,0,4,4,0,100,3.5,62365,79,http://content7.flixster.com/movie/25/44/254497_det.jpg
588,Aladdin,1992,\N,\N,\N,\N,\N,\N,\N,\N,\N,\N,\N,\N,\N,\N
589,Terminator 2: Judgment Day,1991,8.4,42,41,1,97,7.4,11,10,1,90,3.7,77100,88,http://content7.flixster.com/movie/10/94/47/10944701_det.jpg
590,Dances with Wolves,1990,7,46,35,11,76,6.9,10,7,3,70,3.6,28000,84,http://content6.flixster.com/movie/10/87/82/10878268_det.jpg
591,Tough and Deadly,1995,\N,\N,\N,\N,\N,\N,\N,\N,\N,\N,\N,\N,\N,\N
592,Batman,1966,6.2,22,18,4,81,0,1,1,0,100,3,13951,51,http://content8.flixster.com/movie/10/85/60/10856086_det.jpg
593,The Silence of the Lambs,1991,8.5,52,50,2,96,7.8,11,10,1,90,4,98921,93,http://content7.flixster.com/movie/55/12/86/5512865_det.jpg
594,Snow White and the Seven Dwarfs,1937,0,0,0,0,0,0,0,0,0,0,0,0,0,http://content6.flixster.com/movie/10/85/16/10851672_det.jpg
595,Beauty and the Beast,1991,8,57,52,5,91,7.8,18,17,1,94,3.7,81050,85,http://content6.flixster.com/movie/10/92/78/10927816_det.jpg
596,Pinocchio,1940,9,37,37,0,100,8.5,5,5,0,100,3.3,19102,66,http://content8.flixster.com/movie/10/87/27/10872762_det.jpg
597,Pretty Woman,1990,5.7,55,34,21,61,5.9,9,6,3,66,3.5,200724,68,http://content8.flixster.com/movie/16/90/52/1690526_det.jpg
598,Okno v Parizh,1994,5.4,7,3,4,42,0,1,0,1,0,3.9,42,88,http://content6.flixster.com/movie/11/13/77/11137744_det.jpg
599,The Wild Bunch,1969,8.8,38,37,1,97,8.2,7,6,1,85,4,8004,90,http://content7.flixster.com/movie/26/74/267417_det.jpg
600,Love and a .45,1994,6.2,6,5,1,83,0,0,0,0,0,0,0,0,http://content8.flixster.com/movie/10/89/20/10892046_det.jpg
602,A Great Day in Harlem,1994,7.5,18,16,2,88,7.1,7,6,1,85,3.9,85,82,http://content7.flixster.com/movie/10/93/45/10934505_det.jpg
603,Bye Bye Love,1995,4.2,21,4,17,19,0,3,1,2,33,2.9,1015,49,http://content7.flixster.com/movie/26/11/261109_det.jpg
605,One Fine Day,1996,5.7,29,13,16,44,5.8,6,1,5,16,3.1,7990,63,http://content9.flixster.com/movie/26/59/265991_det.jpg
606,Candyman: Farewell to the Flesh,1995,4.9,10,4,6,40,0,1,0,1,0,2.7,4578,44,http://content9.flixster.com/movie/10/89/43/10894315_det.jpg
608,Fargo,1996,8.4,66,62,4,93,7.6,21,18,3,85,3.9,48610,91,http://content6.flixster.com/movie/31/32/313212_det.jpg
609,Homeward Bound II: Lost in San Francisco,1996,5.7,16,9,7,56,6.4,7,5,2,71,2.9,5368,53,http://content6.flixster.com/movie/25/14/251408_det.jpg
610,Heavy Metal,1981,5.7,25,15,10,60,5.4,5,3,2,60,3.3,6386,69,http://content8.flixster.com/movie/26/90/269098_det.jpg
611,Hellraiser: Bloodline,1996,3.5,10,3,7,30,0,1,0,1,0,2.9,4846,52,http://content9.flixster.com/movie/11/14/29/11142947_det.jpg
612,The Pallbearer,1996,5,18,7,11,38,0,4,2,2,50,2.3,1285,14,http://content8.flixster.com/movie/26/35/263502_det.jpg
613,Jane Eyre,2006,\N,\N,\N,\N,\N,\N,\N,\N,\N,\N,\N,\N,\N,\N
614,Loaded,2008,0,0,0,0,0,0,0,0,0,0,0,0,0,http://content9.flixster.com/movie/10/88/27/10882795_det.jpg
615,Pane e cioccolata,1973,0,4,4,0,100,0,0,0,0,0,0,0,0,http://content7.flixster.com/movie/10/89/25/10892525_det.jpg
616,The AristoCats,1970,6.1,26,17,9,65,0,4,3,1,75,3.3,23247,71,http://content7.flixster.com/movie/25/07/250797_det.jpg
617,La flor de mi secreto,1995,7,23,19,4,82,6.6,11,8,3,72,3.7,1997,75,http://content6.flixster.com/movie/49/69/26/4969268_det.jpg
618,Two Much,1995,3.6,7,1,6,14,0,3,0,3,0,2.7,947,33,http://content9.flixster.com/movie/26/48/264899_det.jpg
619,Ed,2000,\N,\N,\N,\N,\N,\N,\N,\N,\N,\N,\N,\N,\N,\N
620,Cerro Torre: Schrei aus Stein,1991,0,0,0,0,0,0,0,0,0,0,0,0,0,http://content7.flixster.com/movie/91/73/48/9173489_det.jpg
621,Ma saison préférée,1993,7.3,12,11,1,91,0,3,3,0,100,0,0,0,http://content7.flixster.com/movie/29/64/296417_det.jpg
623,A Modern Affair,1995,0,2,0,2,0,0,1,0,1,0,3.2,63,38,http://content8.flixster.com/movie/10/86/39/10863938_det.jpg
624,Condition Red,1995,\N,\N,\N,\N,\N,\N,\N,\N,\N,\N,\N,\N,\N,\N
625,Asfour Stah,1990,0,0,0,0,0,0,0,0,0,0,0,0,0,http://content9.flixster.com/movie/28/87/288711_det.jpg
626,A Thin Line Between Love and Hate,1996,3.5,24,3,21,12,3.2,7,0,7,0,3.5,3360,73,http://content6.flixster.com/movie/97/03/07/9703076_det.jpg
627,The Last Supper,1995,0,0,0,0,0,0,0,0,0,0,0,0,0,http://images.rottentomatoescdn.com/images/defaults/poster_default.gif
628,Primal Fear,1996,6.7,41,30,11,73,7.3,6,4,2,66,3.7,15640,85,http://content8.flixster.com/movie/26/88/268822_det.jpg
629,Rude Boy,1980,0,0,0,0,0,0,0,0,0,0,0,0,0,http://content6.flixster.com/movie/10/91/31/10913120_det.jpg
630,Carried Away,1996,6,22,14,8,63,5.4,6,3,3,50,3.3,256,51,http://content9.flixster.com/movie/10/83/80/10838051_det.jpg
631,All Dogs Go to Heaven 2,1996,0,3,0,3,0,0,1,0,1,0,2.8,10564,48,http://content6.flixster.com/movie/10/87/85/10878596_det.jpg
632,Land and Freedom,1995,7.8,10,8,2,80,0,2,2,0,100,4.3,1552,93,http://content7.flixster.com/movie/10/92/30/10923065_det.jpg
633,Denise Calls Up,1995,6.4,22,17,5,77,6.9,9,7,2,77,3.4,47,67,http://content8.flixster.com/movie/10/86/34/10863458_det.jpg
634,Theodore Rex,1995,0,4,0,4,0,0,0,0,0,0,0,0,0,http://content9.flixster.com/movie/10/87/46/10874623_det.jpg
635,A Family Thing,1996,6.3,22,16,6,72,6.8,6,5,1,83,3.4,546,61,http://content6.flixster.com/movie/26/40/264000_det.jpg
636,Nina Frisk,2007,0,0,0,0,0,0,0,0,0,0,0,0,0,http://content7.flixster.com/movie/10/50/90/10509049_det.jpg
637,Sgt. Bilko,1996,4.4,36,12,24,33,5.4,10,6,4,60,2.6,3074,46,http://content8.flixster.com/movie/11/13/42/11134258_det.jpg
638,Jack & Sarah,1995,6,11,9,2,81,0,2,1,1,50,3.6,1366,74,http://content6.flixster.com/movie/10/84/03/10840396_det.jpg
639,Girl 6,1996,4.6,32,11,21,34,4,11,1,10,9,0,0,0,http://content6.flixster.com/movie/23/16/94/2316944_det.jpg
640,Diabolique,1996,3.8,25,3,22,12,4,6,0,6,0,2.7,1450,35,http://content7.flixster.com/movie/27/67/276705_det.jpg
641,Un indien dans la ville,1994,3.2,8,1,7,12,0,4,0,4,0,2.8,552,34,http://content8.flixster.com/movie/10/83/92/10839294_det.jpg
643,Peanuts - Die Bank zahlt alles,1996,\N,\N,\N,\N,\N,\N,\N,\N,\N,\N,\N,\N,\N,\N
645,Nelly & Monsieur Arnaud,1995,7.6,21,20,1,95,7.8,10,9,1,90,3.8,381,78,http://content6.flixster.com/movie/44/35/10/4435104_det.jpg
647,Courage Under Fire,1996,7.3,52,44,8,84,7.8,15,14,1,93,3.2,6918,61,http://content8.flixster.com/movie/10/91/78/10917802_det.jpg
648,Mission: Impossible III,2006,6.6,217,152,65,70,6.2,42,26,16,61,3.3,86328,69,http://content6.flixster.com/movie/10/93/36/10933612_det.jpg
649,Cold Fever,1995,7.3,10,9,1,90,0,3,3,0,100,3.9,284,81,http://content7.flixster.com/movie/39/10/58/3910585_det.jpg
650,Moll Flanders,1996,5.5,20,9,11,45,6.3,6,3,3,50,3.5,855,72,http://content7.flixster.com/movie/36/25/75/3625753_det.jpg
651,Das Superweib,1996,\N,\N,\N,\N,\N,\N,\N,\N,\N,\N,\N,\N,\N,\N
652,"301, 302",1995,5.9,7,5,2,71,0,1,0,1,0,3.7,163,69,http://content7.flixster.com/movie/10/12/38/10123817_det.jpg
653,DragonHeart,1996,5.7,30,15,15,50,6.4,5,3,2,60,3.2,19438,63,http://content6.flixster.com/movie/10/86/38/10863888_det.jpg
655,Mutters Courage,1995,0,0,0,0,0,0,0,0,0,0,0,0,0,http://content9.flixster.com/movie/10/86/25/10862575_det.jpg
656,48 Hrs.,1982,7.4,33,31,2,93,0,4,3,1,75,3.2,10471,61,http://content8.flixster.com/movie/26/94/269494_det.jpg
658,Billy's Holiday,1995,0,1,0,1,0,0,0,0,0,0,0,0,0,http://content7.flixster.com/movie/10/99/00/10990029_det.jpg
659,Plein soleil,1960,8.2,21,21,0,100,0,4,4,0,100,4,670,89,http://content7.flixster.com/movie/26/19/261905_det.jpg
660,August Rush,2007,4.8,120,44,76,36,4.4,27,7,20,25,4,105941,84,http://content6.flixster.com/movie/96/76/16/9676160_det.jpg
661,James and the Giant Peach,1996,7,55,51,4,92,7.5,12,11,1,91,3,18876,55,http://content8.flixster.com/movie/25/48/254806_det.jpg
662,Fear,1996,4.8,28,11,17,39,0,4,1,3,25,3.2,11285,66,http://content8.flixster.com/movie/27/03/270322_det.jpg
663,Kids in the Hall: Brain Candy,1996,4.7,33,13,20,39,4.3,9,3,6,33,3.4,2060,72,http://content6.flixster.com/movie/11/14/71/11147180_det.jpg
664,Faithful,1996,3.8,14,1,13,7,5,5,1,4,20,3.1,397,47,http://content9.flixster.com/movie/10/01/10/10011047_det.jpg
665,Underground,1995,7.5,18,15,3,83,0,4,4,0,100,4.4,6157,96,http://content7.flixster.com/movie/10/89/31/10893197_det.jpg
666,Lust och fägring stor,1995,0,1,1,0,100,0,0,0,0,0,0,0,0,http://content7.flixster.com/movie/11/13/47/11134717_det.jpg
667,Bloodsport 2,1996,0,0,0,0,0,0,0,0,0,0,0,0,0,http://content7.flixster.com/movie/23/38/23/2338233_det.jpg
668,Pather Panchali,1955,8.9,33,32,1,96,8.6,6,6,0,100,4.5,1572,95,http://content8.flixster.com/movie/10/08/39/10083902_det.jpg
670,Apur Sansar,1959,9,16,16,0,100,9.2,6,6,0,100,4.4,1009,94,http://content6.flixster.com/movie/10/83/97/10839708_det.jpg
671,Mystery Science Theater 3000: The Movie,1996,6.4,37,27,10,72,6.3,13,9,4,69,3.8,4508,86,http://content7.flixster.com/movie/11/13/40/11134021_det.jpg
673,Space Jam,1996,5.1,44,16,28,36,5.4,14,6,8,42,2.9,27911,52,http://content9.flixster.com/movie/10/91/96/10919615_det.jpg
674,Barbarella,1968,6,35,26,9,74,4.8,5,2,3,40,3,5461,55,http://content9.flixster.com/movie/25/64/256403_det.jpg
678,Some Folks Call It a Sling Blade,1994,0,0,0,0,0,0,0,0,0,0,0,0,0,http://content8.flixster.com/movie/10/93/85/10938546_det.jpg
679,The Run of the Country,1995,6,7,3,4,42,0,2,1,1,50,3.3,237,60,http://content8.flixster.com/movie/31/34/313418_det.jpg
680,"Alphaville, une étrange aventure de Lemmy Caution",1965,7.9,25,21,4,84,0,2,1,1,50,3.9,4907,82,http://content8.flixster.com/movie/29/56/295614_det.jpg
681,Coup de torchon,1981,7.2,6,5,1,83,0,1,0,1,0,3.8,497,77,http://content7.flixster.com/movie/10/89/65/10896517_det.jpg
682,Tigrero: A Film That Was Never Made,1994,0,2,2,0,100,0,0,0,0,0,0,0,0,http://content8.flixster.com/movie/10/91/28/10912866_det.jpg
683,L'oeil de Vichy,1993,0,2,2,0,100,0,0,0,0,0,0,0,0,http://content8.flixster.com/movie/30/67/306718_det.jpg
685,It's My Party,1996,5.8,14,7,7,50,6.2,6,3,3,50,3.7,843,78,http://content7.flixster.com/movie/27/32/273209_det.jpg
687,Country Life,1994,6.5,6,4,2,66,0,2,2,0,100,3.1,265,44,http://content6.flixster.com/movie/26/40/264012_det.jpg
688,Operation Dumbo Drop,1995,4,24,7,17,29,0,3,2,1,66,2.4,2200,31,http://content9.flixster.com/movie/26/35/263511_det.jpg
690,Das Versprechen,1995,7,6,5,1,83,0,1,1,0,100,3.7,95,74,http://content7.flixster.com/movie/97/48/50/9748505_det.jpg
691,Mrs. Winterbourne,1996,3.8,29,2,27,6,3.3,10,0,10,0,3.1,2892,60,http://content9.flixster.com/movie/25/92/259299_det.jpg
692,Solo,1996,3.2,26,1,25,3,3.8,10,1,9,10,2.3,827,25,http://content9.flixster.com/movie/10/87/64/10876463_det.jpg
693,Etz Hadomim Tafus,1995,0,1,1,0,100,0,0,0,0,0,0,0,0,http://content7.flixster.com/movie/69/02/55/6902553_det.jpg
694,The Substitute,1996,4.6,21,8,13,38,4.2,8,2,6,25,2.9,1815,44,http://content7.flixster.com/movie/27/97/279729_det.jpg
695,True Crime,1999,6,38,20,18,52,6.8,6,5,1,83,3.2,2873,51,http://content6.flixster.com/movie/27/47/274704_det.jpg
696,Butterfly Kiss,1995,6.4,13,10,3,76,0,1,1,0,100,3.2,586,55,http://content8.flixster.com/movie/11/13/63/11136386_det.jpg
697,Feeling Minnesota,1996,3.8,19,3,16,15,0,4,1,3,25,2.7,2783,30,http://content9.flixster.com/movie/27/52/275291_det.jpg
698,Delta of Venus,1995,4.4,5,0,5,0,0,0,0,0,0,0,0,0,http://content8.flixster.com/movie/10/88/75/10887538_det.jpg
700,"Angus, Thongs and Perfect Snogging",2008,6,24,17,7,70,0,2,1,1,50,3.9,6295,76,http://content8.flixster.com/movie/10/85/35/10853566_det.jpg
701,Daens,1992,0,0,0,0,0,0,0,0,0,0,0,0,0,http://content7.flixster.com/movie/34/78/39/3478397_det.jpg
702,Face/Off,1997,7.9,60,56,4,93,8.4,15,15,0,100,3.5,62348,81,http://content8.flixster.com/movie/10/85/08/10850854_det.jpg
703,Boy A,2007,7.5,57,51,6,89,7.5,23,20,3,86,3.5,5895,84,http://content8.flixster.com/movie/10/85/07/10850786_det.jpg
704,Galaxy Quest,1999,7.2,111,99,12,89,6.9,27,22,5,81,3,19804,67,http://content7.flixster.com/movie/10/91/52/10915261_det.jpg
705,Così fan tutte,1992,0,0,0,0,0,0,0,0,0,0,0,0,0,http://content8.flixster.com/movie/10/90/53/10905374_det.jpg
706,Sunset Park,1996,4.6,8,1,7,12,0,3,0,3,0,3.6,636,78,http://content8.flixster.com/movie/27/80/278094_det.jpg
707,Mulholland Falls,1996,5.1,29,9,20,31,5.9,5,2,3,40,2.9,1519,40,http://content6.flixster.com/movie/93/68/00/9368008_det.jpg
708,The Truth About Cats & Dogs,1996,6.7,36,30,6,83,7.6,6,5,1,83,2.9,6120,55,http://content9.flixster.com/movie/10/88/92/10889235_det.jpg
709,Oliver & Company,1988,5.4,33,14,19,42,7.2,5,4,1,80,3.3,9618,65,http://content6.flixster.com/movie/25/15/251504_det.jpg
710,Celtic Pride,1996,3.1,23,2,21,8,4.5,7,2,5,28,2.6,1756,30,http://content8.flixster.com/movie/95/04/97/9504978_det.jpg
711,Flipper,1996,4.8,17,5,12,29,5.4,5,1,4,20,2.6,6086,44,http://content7.flixster.com/movie/25/69/256925_det.jpg
712,La captive,2000,6.7,10,7,3,70,0,1,1,0,100,3,119,47,http://content8.flixster.com/movie/10/84/16/10841618_det.jpg
713,Of Love and Shadows,1994,4.2,5,1,4,20,0,0,0,0,0,0,0,0,http://content8.flixster.com/movie/10/89/11/10891186_det.jpg
714,Dead Man,1995,6.8,33,23,10,69,5.8,6,2,4,33,4,16798,86,http://content7.flixster.com/movie/26/72/267209_det.jpg
715,Le hussard sur le toit,1995,6.6,20,13,7,65,6.4,5,3,2,60,3.7,1134,77,http://content6.flixster.com/movie/10/91/67/10916740_det.jpg
716,The Jezebels,1975,5.4,19,10,9,52,4.4,7,2,5,28,3.5,847,69,http://content7.flixster.com/movie/10/89/70/10897085_det.jpg
717,Boca a boca,1995,5.8,9,3,6,33,0,2,1,1,50,3.3,162,56,http://content9.flixster.com/movie/10/88/66/10886619_det.jpg
718,Les visiteurs,1993,5.4,11,4,7,36,0,3,0,3,0,3.7,3693,74,http://content6.flixster.com/movie/34/10/61/3410616_det.jpg
719,Multiplicity,1996,5.4,43,19,24,44,5.2,14,4,10,28,2.7,4648,43,http://content6.flixster.com/movie/20/48/10/2048108_det.jpg
720,Wallace & Gromit: The Best of Aardman Animation,1996,\N,\N,\N,\N,\N,\N,\N,\N,\N,\N,\N,\N,\N,\N
722,The Haunted World of Edward D. Wood Jr.,1995,0,1,1,0,100,0,0,0,0,0,0,0,0,http://content7.flixster.com/movie/10/88/97/10889749_det.jpg
724,The Craft,1996,5.4,29,13,16,44,5.5,6,2,4,33,3.1,23740,67,http://content6.flixster.com/movie/10/85/08/10850868_det.jpg
725,The Great White Hype,1996,5.1,20,9,11,45,6.6,5,3,2,60,2.7,1488,32,http://content6.flixster.com/movie/27/89/278916_det.jpg
726,Save the Last Dance,2001,0,0,0,0,0,0,0,0,0,0,0,0,0,http://content7.flixster.com/movie/10/87/40/10874033_det.jpg
727,War Stories,2003,0,0,0,0,0,0,0,0,0,0,0,0,0,http://content7.flixster.com/movie/11/13/53/11135357_det.jpg
728,Cold Comfort Farm,1995,7.5,31,26,5,83,8.6,5,5,0,100,3.7,1564,79,http://content7.flixster.com/movie/25/59/255913_det.jpg
729,"Institute Benjamenta, or This Dream People Call Human Life",1995,7.5,6,6,0,100,0,1,1,0,100,4.2,375,87,http://content7.flixster.com/movie/29/72/297297_det.jpg
730,The Riches,2007,\N,\N,\N,\N,\N,\N,\N,\N,\N,\N,\N,\N,\N,\N
731,Heaven's Prisoners,1996,4.1,19,3,16,15,4.9,5,1,4,20,2.7,457,25,http://content6.flixster.com/movie/10/85/99/10859980_det.jpg
733,The Rock,1996,6.5,47,31,16,65,6,15,9,6,60,3.6,45013,85,http://content6.flixster.com/movie/10/87/70/10877064_det.jpg
734,Getting Away with Murder,1996,3,7,0,7,0,0,3,0,3,0,2.8,747,29,http://content8.flixster.com/movie/10/92/22/10922206_det.jpg
735,Dellamorte Dellamore,1994,6,26,16,10,61,0,2,0,2,0,3.8,3149,78,http://content9.flixster.com/movie/10/87/59/10875991_det.jpg
736,Twister,1996,6,49,28,21,57,6.7,10,7,3,70,3.2,45771,62,http://content8.flixster.com/movie/26/63/266302_det.jpg
737,Barb Wire,1996,\N,\N,\N,\N,\N,\N,\N,\N,\N,\N,\N,\N,\N,\N
738,Le garçu,1995,0,0,0,0,0,0,0,0,0,0,0,0,0,http://images.rottentomatoescdn.com/images/defaults/poster_default.gif
741,Kôkaku kidôtai,1995,7.4,31,29,2,93,0,3,3,0,100,3.9,25483,87,http://content7.flixster.com/movie/10/93/13/10931385_det.jpg
742,Thinner,1996,3.8,17,3,14,17,0,3,0,3,0,2.7,3249,40,http://content6.flixster.com/movie/10/87/05/10870524_det.jpg
743,Spy Hard,1996,3.2,30,2,28,6,2.6,8,0,8,0,2.5,4450,37,http://content7.flixster.com/movie/10/37/12/10371241_det.jpg
744,Brothers in Trouble,1995,0,3,3,0,100,0,0,0,0,0,0,0,0,http://content6.flixster.com/movie/10/97/76/10977688_det.jpg
745,Wallace and Gromit in A Close Shave,1995,8.5,19,19,0,100,0,0,0,0,0,0,0,0,http://content6.flixster.com/movie/41/62/60/4162608_det.jpg
746,Force of Evil,1948,8.6,12,12,0,100,0,2,2,0,100,3.7,600,74,http://content6.flixster.com/movie/26/25/262520_det.jpg
747,The Stupids,1996,3.1,14,3,11,21,0,2,1,1,50,2.3,2070,35,http://content7.flixster.com/movie/10/84/55/10845557_det.jpg
748,The Arrival,1996,6.3,27,18,9,66,6.1,5,3,2,60,2.9,2211,41,http://content7.flixster.com/movie/11/14/58/11145801_det.jpg
750,Dr. Strangelove or: How I Learned to Stop Worrying and Love the Bomb,1964,9,58,58,0,100,8.6,8,8,0,100,4.2,33662,94,http://content8.flixster.com/movie/26/51/265102_det.jpg
751,Careful,1992,6.4,11,9,2,81,0,4,3,1,75,4,200,79,http://content8.flixster.com/movie/10/70/70/10707046_det.jpg
753,A Month by the Lake,1995,6.2,17,12,5,70,0,4,2,2,50,3.1,914,44,http://content9.flixster.com/movie/25/76/257691_det.jpg
754,Gold Diggers: The Secret of Bear Mountain,1995,6.2,8,4,4,50,0,4,1,3,25,0,0,0,http://content7.flixster.com/movie/28/52/58/2852585_det.jpg
755,Kim,1950,6.6,5,5,0,100,0,0,0,0,0,0,0,0,http://content7.flixster.com/movie/10/85/81/10858125_det.jpg
756,Carmen Miranda: Bananas Is My Business,1995,6,5,4,1,80,0,0,0,0,0,0,0,0,http://content6.flixster.com/movie/10/90/14/10901436_det.jpg
757,Dung che sai duk,1994,6.6,69,54,15,78,6.7,18,14,4,77,3.6,2166,71,http://content8.flixster.com/movie/10/93/19/10931906_det.jpg
759,Maya Lin: A Strong Clear Vision,1994,7.5,6,6,0,100,0,2,2,0,100,3.8,180,72,http://content8.flixster.com/movie/10/86/99/10869926_det.jpg
760,Stalingrad,1993,7.1,7,5,2,71,0,1,1,0,100,4,2247,87,http://content7.flixster.com/movie/29/21/292121_det.jpg
761,Star Wars: Episode I - The Phantom Menace,1999,0,0,0,0,0,0,0,0,0,0,0,0,0,http://content9.flixster.com/movie/10/80/46/10804663_det.jpg
762,Striptease,1996,3.4,34,4,30,11,4.4,6,0,6,0,2.4,5832,28,http://content7.flixster.com/movie/11/13/78/11137861_det.jpg
763,The Last of the High Kings,1996,0,1,1,0,100,0,0,0,0,0,0,0,0,http://content6.flixster.com/movie/10/89/13/10891324_det.jpg
764,This Is Spinal Tap,1984,8.6,53,51,2,96,7.7,7,6,1,85,3.9,23608,91,http://content9.flixster.com/movie/28/14/281499_det.jpg
765,Jack,1996,4,29,5,24,17,4.8,5,1,4,20,3,11920,57,http://content9.flixster.com/movie/26/14/261407_det.jpg
766,I Shot Andy Warhol,1996,6.7,25,19,6,76,8.3,6,5,1,83,3.4,1521,68,http://content6.flixster.com/movie/27/78/277800_det.jpg
767,The Grass Harp,1995,5.9,14,7,7,50,6.2,5,2,3,40,3.4,297,56,http://content8.flixster.com/movie/11/15/29/11152922_det.jpg
769,Marlene Dietrich: Shadow and Light,1996,\N,\N,\N,\N,\N,\N,\N,\N,\N,\N,\N,\N,\N,\N
771,La môme,2007,5.8,12,6,6,50,0,4,1,3,25,3.8,33,80,http://content9.flixster.com/movie/10/84/43/10844375_det.jpg
774,Wend Kuuni,1982,0,0,0,0,0,0,0,0,0,0,0,0,0,http://content9.flixster.com/movie/10/96/91/10969179_det.jpg
775,Histoires extraordinaires,1968,6.6,18,16,2,88,0,1,1,0,100,3.5,736,65,http://content6.flixster.com/movie/10/86/83/10868324_det.jpg
778,Trainspotting,1996,8.2,55,49,6,89,7.7,14,12,2,85,4,88351,92,http://content7.flixster.com/movie/10/93/17/10931725_det.jpg
779,'Til There Was You,1997,3.9,28,2,26,7,3.7,10,0,10,0,2.7,1660,36,http://content6.flixster.com/movie/10/91/72/10917256_det.jpg
780,Independence Day,1996,6.2,54,33,21,61,6.5,17,11,6,64,3.5,94416,75,http://content9.flixster.com/movie/10/94/47/10944707_det.jpg
781,Stealing Beauty,1996,5.9,47,25,22,53,5.9,11,6,5,54,3.5,5036,73,http://content9.flixster.com/movie/10/85/38/10853863_det.jpg
782,The Fan,1996,4.8,25,10,15,40,5.3,5,2,3,40,2.8,5593,37,http://content9.flixster.com/movie/27/82/278295_det.jpg
783,The Hunchback of Notre Dame,1939,8.3,9,9,0,100,0,0,0,0,0,0,0,0,http://content9.flixster.com/movie/29/39/293991_det.jpg
784,The Cable Guy,1996,5.4,54,28,26,51,4,14,2,12,14,2.8,27061,50,http://content9.flixster.com/movie/10/87/05/10870531_det.jpg
785,Kingpin,1996,5.8,35,18,17,51,5.7,5,3,2,60,3.1,13950,63,http://content6.flixster.com/movie/26/91/269116_det.jpg
786,Eraser,1996,4.9,44,15,29,34,5.2,11,4,7,36,2.8,10891,43,http://content7.flixster.com/movie/27/12/271217_det.jpg
787,The Gate of Heavenly Peace,1995,0,1,1,0,100,0,0,0,0,0,0,0,0,http://images.rottentomatoescdn.com/images/defaults/poster_default.gif
788,The Nutty Professor,1996,6,51,34,17,66,6.7,15,13,2,86,2.9,25286,50,http://content8.flixster.com/movie/25/91/259122_det.jpg
789,"Yo, la peor de todas",1990,\N,\N,\N,\N,\N,\N,\N,\N,\N,\N,\N,\N,\N,\N
791,"The Last Klezmer: Leopold Kozlowski, His Life and Music",1994,0,2,2,0,100,0,0,0,0,0,0,0,0,http://content6.flixster.com/movie/11/13/72/11137256_det.jpg
792,"Hol volt, hol nem volt",1987,0,1,1,0,100,0,0,0,0,0,0,0,0,http://images.rottentomatoescdn.com/images/defaults/poster_default.gif
793,En compagnie d'Antonin Artaud,1993,6.9,6,5,1,83,0,2,1,1,50,0,0,0,http://content9.flixster.com/movie/11/02/74/11027443_det.jpg
795,Somebody to Love,1994,\N,\N,\N,\N,\N,\N,\N,\N,\N,\N,\N,\N,\N,\N
796,A Very Natural Thing,1974,0,1,0,1,0,0,0,0,0,0,0,0,0,http://content9.flixster.com/movie/28/04/280491_det.jpg
798,Daylight,1996,4.7,27,6,21,22,4.9,6,0,6,0,2.8,7912,41,http://content8.flixster.com/movie/26/51/265110_det.jpg
799,The Frighteners,1996,6.3,25,18,7,72,5.1,6,2,4,33,3.3,9928,70,http://content8.flixster.com/movie/10/93/70/10937094_det.jpg
800,Lone Star State of Mind,2002,0,4,0,4,0,0,0,0,0,0,0,0,0,http://content7.flixster.com/movie/10/89/20/10892061_det.jpg
801,Harriet the Spy,1996,5.1,29,13,16,44,4.8,13,4,9,30,2.6,3584,46,http://content6.flixster.com/movie/10/86/90/10869000_det.jpg
802,Phenomenon,1996,5.9,32,16,16,50,5.5,6,1,5,16,3,9166,62,http://content9.flixster.com/movie/25/58/255899_det.jpg
803,Walking and Talking,1996,7.1,21,18,3,85,0,4,3,1,75,3.6,674,67,http://content9.flixster.com/movie/27/92/279207_det.jpg
804,She's the One,1996,5.8,48,29,19,60,5.9,12,7,5,58,2.9,3031,39,http://content9.flixster.com/movie/27/16/271699_det.jpg
805,A Time to Kill,1996,6.1,50,34,16,68,6.6,12,8,4,66,3.6,17074,83,http://content8.flixster.com/movie/10/86/86/10868614_det.jpg
806,American Buffalo,1996,6.6,25,19,6,76,7.4,6,5,1,83,3,598,46,http://content8.flixster.com/movie/10/87/71/10877182_det.jpg
807,Les rendez-vous de Paris,1995,6.8,17,13,4,76,6.5,6,4,2,66,3.6,158,63,http://content8.flixster.com/movie/11/13/71/11137142_det.jpg
808,"Mystery, Alaska",1999,4.9,78,29,49,37,5.1,26,11,15,42,3.2,4196,66,http://content6.flixster.com/movie/26/75/267504_det.jpg
809,Fled,1996,4.3,29,4,25,13,4.5,11,2,9,18,2.6,1281,26,http://content9.flixster.com/movie/28/22/282227_det.jpg
810,Kazaam,1996,2.5,25,1,24,4,3,10,0,10,0,1.8,3161,19,http://content6.flixster.com/movie/26/47/264728_det.jpg
813,Larger Than Life,1996,4.1,17,2,15,11,4,6,0,6,0,2.6,1363,28,http://content9.flixster.com/movie/18/83/22/1883227_det.jpg
814,A Boy Called Hate,1995,0,1,1,0,100,0,0,0,0,0,0,0,0,http://content6.flixster.com/movie/10/97/39/10973916_det.jpg
815,Power 98,1996,\N,\N,\N,\N,\N,\N,\N,\N,\N,\N,\N,\N,\N,\N
818,A Very Brady Sequel,1996,5.6,32,16,16,50,6.5,9,6,3,66,2.3,4591,26,http://content6.flixster.com/movie/10/89/53/10895312_det.jpg
820,La mort en ce jardin,1956,7.8,11,10,1,90,0,2,2,0,100,3.4,201,47,http://content7.flixster.com/movie/10/84/99/10849941_det.jpg
821,The Crude Oasis,1995,0,1,0,1,0,0,1,0,1,0,3.1,38,50,http://content9.flixster.com/movie/10/89/37/10893795_det.jpg
823,La collectionneuse,1967,7.1,9,8,1,88,0,2,1,1,50,3.9,566,83,http://content6.flixster.com/movie/29/83/298328_det.jpg
824,Jeder für sich und Gott gegen alle,1974,0,0,0,0,0,0,0,0,0,0,0,0,0,http://images.rottentomatoescdn.com/images/defaults/poster_default.gif
827,O Convento,1995,3.5,7,2,5,28,0,0,0,0,0,0,0,0,http://content6.flixster.com/movie/10/85/90/10859028_det.jpg
828,The Adventures of Pinocchio,1996,4.8,15,4,11,26,5.4,5,1,4,20,2.6,1746,33,http://content6.flixster.com/movie/10/86/08/10860880_det.jpg
829,Joe's Apartment,1996,3.8,26,4,22,15,3.6,8,1,7,12,2.5,3311,43,http://content9.flixster.com/movie/11/15/13/11151375_det.jpg
830,The First Wives Club,1996,5.4,32,13,19,40,5.7,7,2,5,28,3.2,9522,67,http://content9.flixster.com/movie/25/55/255511_det.jpg
831,Stonewall,1995,6.5,8,5,3,62,0,3,1,2,33,3.4,282,57,http://content9.flixster.com/movie/10/85/48/10854819_det.jpg
832,Ransom,1996,6.4,30,21,9,70,5.7,7,4,3,57,3.1,10364,61,http://content9.flixster.com/movie/10/91/77/10917783_det.jpg
833,High School Musical 3: Senior Year,2008,5.9,127,83,44,65,6,27,18,9,66,3.6,80210,76,http://content9.flixster.com/movie/10/89/47/10894743_det.jpg
834,Phat Beach,1996,0,3,0,3,0,0,1,0,1,0,3,375,46,http://content6.flixster.com/movie/10/85/88/10858856_det.jpg
835,Foxfire,1996,5.3,10,3,7,30,0,4,1,3,25,3.5,3071,67,http://content8.flixster.com/movie/10/87/90/10879038_det.jpg
836,Chain Reaction,1996,4.1,31,4,27,12,5.1,9,2,7,22,2.7,6845,33,http://content8.flixster.com/movie/10/94/13/10941374_det.jpg
837,Matilda,1996,7.4,20,18,2,90,7.4,5,5,0,100,3.1,24214,65,http://content6.flixster.com/movie/10/88/58/10885848_det.jpg
838,Emma,1996,0,0,0,0,0,0,0,0,0,0,0,0,0,http://content7.flixster.com/movie/73/95/22/7395229_det.jpg
839,The Crow: City of Angels,1996,3.4,33,4,29,12,3.3,8,1,7,12,3,12460,51,http://content6.flixster.com/movie/10/93/21/10932152_det.jpg
840,House Arrest,1996,3.5,12,1,11,8,0,3,0,3,0,2.8,2789,44,http://content9.flixster.com/movie/55/06/07/5506075_det.jpg
841,Les yeux sans visage,1960,8.2,42,41,1,97,7.8,9,8,1,88,4,785,86,http://content9.flixster.com/movie/10/85/78/10857831_det.jpg
842,Bordello of Blood,1996,3.2,27,4,23,14,3.6,7,1,6,14,2.6,3764,41,http://content8.flixster.com/movie/10/88/79/10887978_det.jpg
844,Xinghua san yue tian,1994,0,0,0,0,0,0,0,0,0,0,0,0,0,http://content6.flixster.com/movie/10/97/41/10974180_det.jpg
845,Tian guo ni zi,1994,0,3,2,1,66,0,0,0,0,0,0,0,0,http://content9.flixster.com/movie/10/97/43/10974335_det.jpg
846,Flirt,1995,6.6,10,7,3,70,0,2,0,2,0,3.7,271,71,http://content7.flixster.com/movie/10/88/38/10883881_det.jpg
847,The Big Squeeze,1996,5,7,3,4,42,0,1,0,1,0,3.8,49,75,http://content8.flixster.com/movie/10/85/19/10851946_det.jpg
848,The Spitfire Grill,1996,5.4,26,9,17,34,5.2,6,0,6,0,3.6,777,77,http://content8.flixster.com/movie/10/88/20/10882010_det.jpg
849,Escape from L.A.,1996,5.6,45,25,20,55,5.9,14,8,6,57,2.8,10054,41,http://content9.flixster.com/movie/27/26/272607_det.jpg
850,Xich lo,1995,6.5,11,8,3,72,0,0,0,0,0,0,0,0,http://content6.flixster.com/movie/29/56/295620_det.jpg
851,Basquiat,1996,0,0,0,0,0,0,0,0,0,0,0,0,0,http://content6.flixster.com/movie/10/85/19/10851952_det.jpg
852,Tin Cup,1996,6.5,48,33,15,68,7,13,10,3,76,2.9,6148,57,http://content9.flixster.com/movie/26/86/268607_det.jpg
853,Evil Angels,1988,6.8,20,18,2,90,0,1,1,0,100,3.3,1554,63,http://content6.flixster.com/movie/26/47/264712_det.jpg
858,The Godfather,1972,9,66,66,0,100,8.4,11,11,0,100,4.4,172072,97,http://content9.flixster.com/movie/11/12/76/11127687_det.jpg
860,Der bewegte Mann,1994,5.9,9,5,4,55,0,3,2,1,66,3.5,359,64,http://content7.flixster.com/movie/10/85/95/10859537_det.jpg
861,Ging chat goo si 3: Chiu kup ging chat,1992,7.3,37,35,2,94,6.8,9,8,1,88,3.4,4064,69,http://content9.flixster.com/movie/10/86/39/10863979_det.jpg
862,Manny & Lo,1996,5.8,21,13,8,61,6.2,11,8,3,72,3.4,477,55,http://content7.flixster.com/movie/10/86/80/10868093_det.jpg
864,The Time Traveler's Wife,2009,5.1,151,56,95,37,4.8,34,10,24,29,2.9,189828,65,http://content7.flixster.com/movie/10/92/43/10924397_det.jpg
865,Small Faces,1996,6.7,9,6,3,66,0,2,2,0,100,4.1,183,85,http://content6.flixster.com/movie/10/93/94/10939484_det.jpg
866,Bound,1996,7.7,34,30,4,88,8.6,5,5,0,100,3.5,5521,80,http://content7.flixster.com/movie/60/48/98/6048989_det.jpg
867,Carpool,1996,2.4,10,0,10,0,0,3,0,3,0,2.6,1096,39,http://content7.flixster.com/movie/10/52/89/10528985_det.jpg
868,Death in Brunswick,1991,0,4,2,2,50,0,0,0,0,0,0,0,0,http://content6.flixster.com/movie/21/54/85/2154856_det.jpg
869,Kansas City,1996,5.9,33,19,14,57,6.2,9,5,4,55,3,608,37,http://content8.flixster.com/movie/28/25/282598_det.jpg
870,Gone Fishin',1997,2.2,22,1,21,4,2.4,6,0,6,0,2.6,2183,39,http://content6.flixster.com/movie/10/94/35/10943536_det.jpg
872,Ai qing wan sui,1994,8.1,5,4,1,80,0,0,0,0,0,0,0,0,http://content7.flixster.com/movie/30/50/305029_det.jpg
875,Nothing to Lose,1997,5.1,23,6,17,26,5.7,5,1,4,20,3.1,5245,67,http://content7.flixster.com/movie/10/45/21/10452197_det.jpg
876,Chao ji ji hua,1993,6,14,9,5,64,0,1,1,0,100,3.1,871,46,http://content6.flixster.com/movie/28/07/280704_det.jpg
877,Girls Town,1996,6.8,23,20,3,86,7,10,9,1,90,3.8,173,76,http://content9.flixster.com/movie/66/25/56/6625567_det.jpg
879,The Relic,1997,4.4,28,9,19,32,5.8,5,2,3,40,2.7,3098,36,http://content8.flixster.com/movie/63/26/07/6326074_det.jpg
880,The Island of Dr. Moreau,1996,4.3,31,7,24,22,4,5,0,5,0,2.4,5032,26,http://content7.flixster.com/movie/28/70/287025_det.jpg
881,First Kid,1996,4,12,2,10,16,0,2,0,2,0,2.5,2541,37,http://content9.flixster.com/movie/26/04/260491_det.jpg
882,The Trigger Effect,1996,6.4,23,17,6,73,0,3,1,2,33,3,521,35,http://content7.flixster.com/movie/27/74/277421_det.jpg
884,Sweet Nothing in My Ear,2008,0,0,0,0,0,0,0,0,0,0,0,0,0,http://content7.flixster.com/movie/10/89/53/10895381_det.jpg
885,Bill & Ted's Bogus Journey,1991,6,33,19,14,57,6,6,4,2,66,3,17201,59,http://content9.flixster.com/movie/10/88/19/10881967_det.jpg
886,Bulletproof Monk,2003,4.3,130,28,102,21,4,31,5,26,16,2.9,13789,50,http://content8.flixster.com/movie/10/88/61/10886106_det.jpg
887,Talk of Angels,1998,0,3,2,1,66,0,0,0,0,0,0,0,0,http://content9.flixster.com/movie/28/97/76/2897767_det.jpg
888,The Land Before Time III: The Time of the Great Giving,1995,0,4,2,2,50,0,0,0,0,0,0,0,0,http://content7.flixster.com/movie/10/92/43/10924385_det.jpg
889,Miami Vice,2006,5.6,189,89,100,47,6.4,41,28,13,68,2.8,55637,48,http://content8.flixster.com/movie/78/65/786578_det.jpg
891,Halloween: The Curse of Michael Myers,1995,2.5,27,1,26,3,1.7,6,0,6,0,3.1,12571,56,http://content6.flixster.com/movie/97/82/14/9782144_det.jpg
892,Twelfth Night,1996,6.8,30,21,9,70,6.5,10,7,3,70,3.7,1937,77,http://content9.flixster.com/movie/10/89/35/10893535_det.jpg
893,Mother Night,1996,6.3,23,14,9,60,6.4,5,2,3,40,3.6,706,74,http://content9.flixster.com/movie/10/92/33/10923347_det.jpg
896,Les roseaux sauvages,1994,8.2,10,10,0,100,0,3,3,0,100,4,604,86,http://content8.flixster.com/movie/11/12/23/11122346_det.jpg
897,For Whom the Bell Tolls,1943,6.4,12,10,2,83,0,0,0,0,0,0,0,0,http://content7.flixster.com/movie/29/51/295129_det.jpg
898,The Philadelphia Story,1940,8.6,43,43,0,100,8,5,5,0,100,4.1,11465,92,http://content7.flixster.com/movie/10/08/01/10080157_det.jpg
899,Singin' in the Rain,1952,9.2,44,44,0,100,8.8,9,9,0,100,3.9,28033,91,http://content7.flixster.com/movie/10/93/77/10937761_det.jpg
900,An American in Paris,1951,7.9,47,46,1,97,7.2,5,5,0,100,3.7,6926,77,http://content6.flixster.com/movie/10/85/50/10855056_det.jpg
901,Funny Face,1957,7.6,22,19,3,86,0,2,2,0,100,3.7,8892,80,http://content8.flixster.com/movie/10/88/03/10880354_det.jpg
902,Breakfast at Tiffany's,1961,7.4,43,37,6,86,7.4,5,5,0,100,3.9,56438,91,http://content9.flixster.com/movie/28/57/285711_det.jpg
903,Vertigo,1958,8.6,54,53,1,98,8,14,13,1,92,4.1,28291,92,http://content6.flixster.com/movie/57/58/575852_det.jpg
904,Rear Window,1954,8.9,60,60,0,100,8.7,17,17,0,100,4.2,33508,95,http://content6.flixster.com/movie/89/52/98/8952988_det.jpg
905,It Happened One Night,1934,8.7,32,31,1,96,8.2,5,5,0,100,4.1,7375,92,http://content8.flixster.com/movie/29/14/291410_det.jpg
906,Gaslight,1944,7.6,16,14,2,87,0,1,1,0,100,4,2391,89,http://content8.flixster.com/movie/10/85/60/10856082_det.jpg
907,The Gay Divorcee,1934,7.8,8,8,0,100,0,0,0,0,0,0,0,0,http://content8.flixster.com/movie/37/40/82/3740826_det.jpg
908,North by Northwest,1959,9,58,58,0,100,7.8,6,6,0,100,4.2,23243,93,http://content9.flixster.com/movie/10/93/42/10934207_det.jpg
909,The Apartment,1960,8.3,43,39,4,90,7.6,8,7,1,87,4.1,9116,93,http://content8.flixster.com/movie/11/15/13/11151366_det.jpg
910,Some Like It Hot,1959,8.9,40,39,1,97,0,4,4,0,100,4.1,23119,93,http://content9.flixster.com/movie/10/55/31/10553171_det.jpg
911,Charade,1963,8.1,33,30,3,90,6,5,3,2,60,4.1,9173,92,http://content6.flixster.com/movie/40/80/61/4080612_det.jpg
912,Casablanca,1942,9,58,56,2,96,7.7,7,6,1,85,4,66776,94,http://content9.flixster.com/movie/10/84/88/10848811_det.jpg
913,The Maltese Falcon,1941,9,40,40,0,100,8.2,6,6,0,100,4,14452,90,http://content9.flixster.com/movie/10/87/69/10876999_det.jpg
914,My Fair Lady,1964,8,36,34,2,94,8.6,6,6,0,100,3.7,27491,87,http://content8.flixster.com/movie/10/93/43/10934366_det.jpg
915,Sabrina,1954,7.4,31,28,3,90,7.2,5,5,0,100,3.8,12812,87,http://content7.flixster.com/movie/10/93/36/10933669_det.jpg
916,Roman Holiday,1953,8.2,43,42,1,97,7.5,6,5,1,83,4.1,17541,93,http://content6.flixster.com/movie/29/08/290804_det.jpg
917,A Little Princess,1995,8.4,20,19,1,95,0,3,3,0,100,3.4,13643,81,http://content6.flixster.com/movie/29/07/290716_det.jpg
918,Meet Me in St. Louis,1944,8.4,24,24,0,100,0,4,4,0,100,3.8,7067,84,http://content9.flixster.com/movie/53/80/62/5380627_det.jpg
919,The Wizard of Oz,1939,9.2,70,70,0,100,8.7,11,11,0,100,3.6,69148,82,http://content6.flixster.com/movie/25/30/253028_det.jpg
920,Gone with the Wind,1939,8.7,62,60,2,96,8.3,13,13,0,100,3.9,62786,91,http://content9.flixster.com/movie/10/93/18/10931807_det.jpg
921,My Favorite Year,1982,7.8,22,22,0,100,0,0,0,0,0,0,0,0,http://content7.flixster.com/movie/10/92/21/10922157_det.jpg
922,Sunset Blvd.,1950,9.2,52,51,1,98,8.2,7,7,0,100,4.3,12588,95,http://content7.flixster.com/movie/10/88/29/10882989_det.jpg
923,Citizen Kane,1941,9.4,54,54,0,100,8.9,7,7,0,100,4.1,33926,91,http://content7.flixster.com/movie/10/93/41/10934161_det.jpg
924,2001: A Space Odyssey,1968,8.8,53,51,2,96,7.1,11,9,2,81,3.7,46687,86,http://content6.flixster.com/movie/10/87/27/10872760_det.jpg
925,Golden Earrings,1947,0,0,0,0,0,0,0,0,0,0,0,0,0,http://content7.flixster.com/movie/10/86/24/10862449_det.jpg
926,All About Eve,1950,9,54,54,0,100,8.2,10,10,0,100,4.2,10267,94,http://content8.flixster.com/movie/10/95/54/10955402_det.jpg
927,The Women,2008,3.9,142,18,124,12,3.8,34,4,30,11,3,20081,41,http://content6.flixster.com/movie/10/85/30/10853064_det.jpg
928,Rebecca,1940,8.7,36,36,0,100,8.2,5,5,0,100,0,0,0,http://content9.flixster.com/movie/28/61/286199_det.jpg
929,Foreign Correspondent,1940,7.9,28,26,2,92,0,3,3,0,100,3.7,1921,77,http://content9.flixster.com/movie/99/05/70/9905707_det.jpg
930,Notorious,2009,5.5,136,68,68,50,6.2,36,22,14,61,3.6,66668,66,http://content8.flixster.com/movie/10/88/40/10884038_det.jpg
931,Spellbound,1945,7.3,30,26,4,86,0,1,1,0,100,3.8,4332,82,http://content7.flixster.com/movie/10/93/88/10938881_det.jpg
932,An Affair to Remember,1957,6.4,25,16,9,64,0,1,0,1,0,4,7962,88,http://content6.flixster.com/movie/30/79/307928_det.jpg
933,To Catch a Thief,1955,8,32,31,1,96,0,2,2,0,100,0,0,0,http://content7.flixster.com/movie/10/93/55/10935581_det.jpg
934,Father of the Bride,1991,5.8,29,21,8,72,0,2,2,0,100,3.2,22336,67,http://content9.flixster.com/movie/25/83/258323_det.jpg
935,The Band Wagon,1953,8.5,13,13,0,100,0,1,1,0,100,3.8,1257,79,http://content8.flixster.com/movie/10/93/42/10934214_det.jpg
936,Ninotchka,1939,8.3,23,23,0,100,0,3,3,0,100,4.1,1769,89,http://content9.flixster.com/movie/97/89/92/9789927_det.png
937,Love in the Afternoon,1957,7.1,23,20,3,86,0,4,4,0,100,3.8,2060,80,http://content8.flixster.com/movie/29/21/292126_det.jpg
938,Gigi,1958,7.1,27,20,7,74,0,4,3,1,75,3.7,5450,75,http://content8.flixster.com/movie/10/88/00/10880022_det.jpg
939,The Reluctant Debutante,1958,0,4,2,2,50,0,0,0,0,0,0,0,0,http://content8.flixster.com/movie/51/06/96/5106962_det.jpg
940,The Adventures of Robin Hood,1938,8.9,43,43,0,100,8.6,7,7,0,100,3.7,6404,84,http://content9.flixster.com/movie/11/14/22/11142287_det.jpg
941,The Mask of Zorro,1998,7.1,66,54,12,81,6.5,13,10,3,76,3.3,31107,70,http://content8.flixster.com/movie/75/96/759614_det.jpg
942,Laura,1944,8.6,45,45,0,100,8,6,6,0,100,0,0,0,http://content8.flixster.com/movie/29/04/290494_det.jpg
943,The Ghost and Mrs. Muir,1947,8.2,12,12,0,100,0,0,0,0,0,0,0,0,http://content8.flixster.com/movie/10/85/60/10856078_det.jpg
944,Lost Horizon,1937,7.6,8,8,0,100,0,0,0,0,0,0,0,0,http://content7.flixster.com/movie/98/97/81/9897817_det.jpg
945,Top Hat,1935,8.6,37,37,0,100,8,6,6,0,100,4,2908,89,http://content9.flixster.com/movie/10/13/03/10130383_det.jpg
946,To Be or Not to Be,1942,8.7,34,33,1,97,7,5,4,1,80,4.2,1733,92,http://content8.flixster.com/movie/91/04/09/9104098_det.jpg
947,My Man Godfrey,1936,8.4,26,26,0,100,8,6,6,0,100,4.1,1789,90,http://content7.flixster.com/movie/31/11/311193_det.jpg
948,Giant,1956,7.7,35,34,1,97,7.8,6,6,0,100,3.9,5890,86,http://content9.flixster.com/movie/60/48/83/6048835_det.jpg
949,East of Eden,1955,8.2,30,26,4,86,0,3,2,1,66,4,5957,90,http://content7.flixster.com/movie/10/93/17/10931781_det.jpg
950,The Thin Man,1934,8.5,26,26,0,100,0,1,1,0,100,4.2,3591,93,http://content6.flixster.com/movie/10/43/19/10431924_det.jpg
951,His Girl Friday,1940,8.6,36,35,1,97,0,4,4,0,100,0,0,0,http://content9.flixster.com/movie/10/93/46/10934643_det.jpg
952,Around the World in 80 Days,2004,4.8,127,39,88,30,4.7,33,9,24,27,2.7,14038,45,http://content7.flixster.com/movie/11/14/86/11148613_det.jpg
953,It's a Wonderful Life,1946,8.7,54,51,3,94,8.4,6,6,0,100,4,35280,94,http://content9.flixster.com/movie/29/04/290427_det.jpg
954,Mr. Smith Goes to Washington,1939,7.4,12,10,2,83,7.4,7,6,1,85,3.6,869,66,http://content8.flixster.com/movie/10/86/77/10867718_det.jpg
955,Bringing Up Baby,1938,8.4,36,34,2,94,0,4,3,1,75,4,8722,90,http://content7.flixster.com/movie/10/85/69/10856933_det.jpg
956,Penny Serenade,1941,7.4,15,14,1,93,0,3,3,0,100,3.7,1083,74,http://content7.flixster.com/movie/28/93/289325_det.jpg
957,The Scarlet Letter,1995,3,33,5,28,15,3.6,11,1,10,9,2.9,3493,48,http://content7.flixster.com/movie/10/86/16/10861633_det.jpg
958,Lady of Burlesque,1943,5.5,5,3,2,60,0,3,2,1,66,3.2,263,52,http://content8.flixster.com/movie/10/83/91/10839118_det.jpg
959,Of Human Bondage,1934,6.9,9,7,2,77,0,0,0,0,0,0,0,0,http://content6.flixster.com/movie/11/13/92/11139204_det.jpg
960,Angel on My Shoulder,1946,0,3,2,1,66,0,0,0,0,0,0,0,0,http://content9.flixster.com/movie/10/39/82/10398203_det.jpg
961,Little Lord Fauntleroy,1936,7,5,4,1,80,0,0,0,0,0,0,0,0,http://content9.flixster.com/movie/49/60/85/4960855_det.jpg
963,The Inspector General,1949,6.8,8,7,1,87,0,0,0,0,0,0,0,0,http://content8.flixster.com/movie/28/75/287514_det.jpg
964,Angel and the Badman,1947,6.5,6,4,2,66,0,0,0,0,0,0,0,0,http://content6.flixster.com/movie/10/91/88/10918872_det.jpg
965,The 39 Steps,1935,8.8,32,31,1,96,0,4,4,0,100,3.8,5603,84,http://content6.flixster.com/movie/10/87/29/10872908_det.jpg
966,A Walk in the Sun,1945,0,0,0,0,0,0,0,0,0,0,0,0,0,http://content8.flixster.com/movie/10/84/92/10849294_det.jpg
967,Outlaw,2007,0,0,0,0,0,0,0,0,0,0,0,0,0,http://content7.flixster.com/movie/10/86/83/10868301_det.jpg
968,Night of the Living Dead,1968,8.5,45,43,2,95,7,5,4,1,80,3.7,26113,85,http://content6.flixster.com/movie/10/91/62/10916208_det.jpg
969,The African Queen,1951,8.7,29,29,0,100,0,3,3,0,100,3.8,6609,87,http://content7.flixster.com/movie/20/48/78/2048785_det.jpg
970,Beat the Devil,1953,6.6,11,7,4,63,0,2,1,1,50,3.3,793,55,http://content6.flixster.com/movie/31/14/311416_det.jpg
971,Cat on a Hot Tin Roof,1958,7.8,30,30,0,100,0,4,4,0,100,3.9,6600,91,http://content9.flixster.com/movie/30/75/307523_det.jpg
972,The Last Time I Saw Paris,1954,6.3,6,5,1,83,0,2,1,1,50,3.1,883,44,http://content9.flixster.com/movie/10/87/75/10877599_det.jpg
973,Meet John Doe,1941,7.2,13,11,2,84,0,0,0,0,0,0,0,0,http://content8.flixster.com/movie/30/06/300618_det.jpg
974,La battaglia di Algeri,1966,9,70,69,1,98,8.9,17,17,0,100,4.4,4132,95,http://content9.flixster.com/movie/10/94/26/10942603_det.jpg
976,A Farewell to Arms,1932,7.6,8,7,1,87,0,0,0,0,0,0,0,0,http://content6.flixster.com/movie/10/90/60/10906004_det.jpg
980,Huang jia shi jie,1985,0,2,2,0,100,0,0,0,0,0,0,0,0,http://content7.flixster.com/movie/35/59/28/3559281_det.jpg
981,On Dangerous Ground,1952,8.3,11,11,0,100,0,1,1,0,100,3.8,411,75,http://content8.flixster.com/movie/28/52/91/2852910_det.jpg
982,Picnic,1955,6.5,6,3,3,50,0,1,0,1,0,3.5,632,64,http://content8.flixster.com/movie/25/80/258002_det.jpg
983,Madagascar Skin,1995,0,3,2,1,66,0,1,0,1,0,3.5,295,58,http://content6.flixster.com/movie/10/83/80/10838088_det.jpg
984,The Pompatus of Love,1995,3.8,6,1,5,16,0,2,1,1,50,2.9,52,31,http://content7.flixster.com/movie/10/85/36/10853669_det.jpg
985,Small Wonder,1985,\N,\N,\N,\N,\N,\N,\N,\N,\N,\N,\N,\N,\N,\N
986,Fly Away Home,1996,7.1,32,27,5,84,8.1,7,7,0,100,3,5636,63,http://content6.flixster.com/movie/26/54/265420_det.jpg
987,Bliss,1997,5.8,12,6,6,50,0,4,1,3,25,3.4,337,58,http://content8.flixster.com/movie/27/47/274702_det.jpg
988,Grace of My Heart,1996,6.7,22,16,6,72,0,4,0,4,0,3.6,611,71,http://content9.flixster.com/movie/27/44/274423_det.jpg
989,Schlafes Bruder,1995,6.6,7,5,2,71,0,2,2,0,100,4.1,119,84,http://content7.flixster.com/movie/10/97/64/10976437_det.jpg
990,Maximum Risk,1996,4.3,31,9,22,29,4.2,10,3,7,30,2.8,2236,38,http://content9.flixster.com/movie/27/74/277423_det.jpg
991,Michael Collins,1996,6.8,44,34,10,77,6.8,9,7,2,77,3.6,4673,79,http://content8.flixster.com/movie/26/86/268618_det.jpg
992,The Rich Man's Wife,1996,4.1,14,2,12,14,0,4,0,4,0,3,769,49,http://content7.flixster.com/movie/28/19/281925_det.jpg
993,Infinity,1996,6.2,13,8,5,61,0,4,2,2,50,3.1,399,38,http://content7.flixster.com/movie/26/46/264697_det.jpg
994,Big Night,1996,8,52,50,2,96,8.2,11,11,0,100,3.9,1944,84,http://content7.flixster.com/movie/10/87/40/10874069_det.jpg
996,Last Man Standing,1996,5.1,30,11,19,36,4,6,1,5,16,3.1,8711,56,http://content7.flixster.com/movie/10/94/88/10948865_det.jpg
997,Caught,1996,6.3,12,9,3,75,0,3,2,1,66,3.2,209,58,http://content9.flixster.com/movie/28/09/280923_det.jpg
998,Set It Off,1996,6,23,14,9,60,7.5,6,5,1,83,3.6,10301,86,http://content8.flixster.com/movie/26/90/269030_det.jpg
999,2 Days in the Valley,1996,6.1,52,32,20,61,6,11,8,3,72,3,3984,48,http://content6.flixster.com/movie/26/94/269408_det.jpg
1000,Curdled,1996,4.3,12,2,10,16,0,2,0,2,0,3.4,441,62,http://content9.flixster.com/movie/43/21/04/4321043_det.jpg
1001,The Associate,1996,5.1,17,4,13,23,6.2,7,3,4,42,2.9,1259,52,http://content7.flixster.com/movie/25/98/259813_det.jpg
1002,Ed's Next Move,1996,6.3,9,7,2,77,0,2,2,0,100,3.2,43,75,http://content8.flixster.com/movie/10/85/80/10858018_det.jpg
1003,Extreme Measures,1996,6,31,17,14,54,5.7,6,2,4,33,2.9,2772,37,http://content7.flixster.com/movie/28/29/282909_det.jpg
1004,The Glimmer Man,1996,3.4,24,3,21,12,2.6,9,0,9,0,2.7,2801,48,http://content7.flixster.com/movie/27/22/272217_det.jpg
1005,D3: The Mighty Ducks,1996,3.7,14,2,12,14,0,4,0,4,0,2.8,9838,50,http://content7.flixster.com/movie/26/31/263193_det.jpg
1006,The Chamber,1996,4.5,24,3,21,12,4.6,7,0,7,0,3,1633,43,http://content7.flixster.com/movie/10/88/80/10888009_det.jpg
1007,The Apple Dumpling Gang,1975,6,8,4,4,50,0,2,0,2,0,3.2,2133,60,http://content8.flixster.com/movie/25/12/251202_det.jpg
1008,"Davy Crockett, King of the Wild Frontier",1955,0,4,4,0,100,0,0,0,0,0,0,0,0,http://content7.flixster.com/movie/11/14/51/11145149_det.jpg
1009,Escape to Witch Mountain,1975,6,20,15,5,75,0,3,2,1,66,3.1,3761,60,http://content8.flixster.com/movie/10/89/29/10892994_det.jpg
1010,The Love Bug,1968,5.7,15,11,4,73,0,4,1,3,25,3.1,3795,63,http://content8.flixster.com/movie/25/11/251198_det.jpg
1011,Herbie Rides Again,1974,0,4,3,1,75,0,0,0,0,0,0,0,0,http://content8.flixster.com/movie/25/21/252102_det.jpg
1012,Old Yeller,1957,7.7,17,16,1,94,0,2,2,0,100,3.3,6399,73,http://content8.flixster.com/movie/10/94/43/10944394_det.jpg
1013,The Parent Trap,1998,7,34,27,7,79,6.5,7,4,3,57,3.1,41455,67,http://content9.flixster.com/movie/10/88/10/10881003_det.jpg
1014,Pollyanna,1960,7.4,11,9,2,81,0,2,2,0,100,3.3,3331,71,http://content7.flixster.com/movie/25/10/251005_det.jpg
1015,Homeward Bound: The Incredible Journey,1993,6.5,22,19,3,86,6.9,8,7,1,87,3.2,15019,66,http://content8.flixster.com/movie/10/91/53/10915370_det.jpg
1016,The Shaggy Dog,2006,4.4,103,28,75,27,4.8,29,10,19,34,2.9,41890,50,http://content9.flixster.com/movie/10/89/84/10898411_det.jpg
1017,Swiss Family Robinson,1960,6.7,17,14,3,82,0,2,1,1,50,3.3,3986,71,http://content8.flixster.com/movie/10/86/95/10869530_det.jpg
1018,That Darn Cat,1997,3.8,14,1,13,7,0,4,0,4,0,2.5,2029,30,http://content6.flixster.com/movie/10/86/44/10864404_det.jpg
1019,20000 Leagues Under the Sea,1954,7.7,24,22,2,91,0,4,4,0,100,3.2,7628,57,http://content6.flixster.com/movie/11/14/17/11141728_det.jpg
1020,Cool Runnings,1993,6,30,22,8,73,6,6,4,2,66,3.4,35317,77,http://content8.flixster.com/movie/25/47/254718_det.jpg
1021,Angels in the Outfield,1951,0,1,1,0,100,0,0,0,0,0,0,0,0,http://content8.flixster.com/movie/10/89/81/10898186_det.jpg
1022,Cinderella,1950,7.3,26,24,2,92,8,5,5,0,100,3.5,63946,76,http://content9.flixster.com/movie/25/06/250619_det.jpg
1023,Winnie the Pooh and the Blustery Day,1968,\N,\N,\N,\N,\N,\N,\N,\N,\N,\N,\N,\N,\N,\N
1024,The Three Caballeros,1944,6.8,15,13,2,86,0,4,3,1,75,3.3,2192,62,http://content9.flixster.com/movie/10/88/70/10887063_det.jpg
1025,The Sword in the Stone,1963,6,22,16,6,72,0,3,2,1,66,3.3,11900,68,http://content6.flixster.com/movie/25/07/250724_det.jpg
1026,So Dear to My Heart,1948,0,0,0,0,0,0,0,0,0,0,0,0,0,http://content8.flixster.com/movie/56/75/49/5675490_det.jpg
1027,Robin Hood: Prince of Thieves,1991,5.2,27,15,12,55,0,2,1,1,50,3.4,30722,72,http://content6.flixster.com/movie/10/93/73/10937328_det.jpg
1028,Mary Poppins,1964,8.2,37,37,0,100,0,3,3,0,100,3.5,44140,79,http://content6.flixster.com/movie/62/99/53/6299532_det.jpg
1029,Dumbo,1941,8.4,31,30,1,96,0,4,4,0,100,3.3,32327,65,http://content8.flixster.com/movie/10/83/83/10838302_det.jpg
1030,Pete's Dragon,1977,4.6,20,10,10,50,0,2,2,0,100,3.1,7622,59,http://content6.flixster.com/movie/25/09/250924_det.jpg
1031,Bedknobs and Broomsticks,1971,6,28,17,11,60,4.8,5,1,4,20,3.3,15857,67,http://content6.flixster.com/movie/11/15/24/11152484_det.jpg
1032,Alice in Wonderland,1951,6.5,22,18,4,81,0,3,2,1,66,3.3,37778,70,http://content8.flixster.com/movie/10/83/99/10839910_det.jpg
1033,The Fox and the Hound,1981,6.6,22,15,7,68,0,3,3,0,100,3.4,24666,77,http://content8.flixster.com/movie/10/84/96/10849638_det.jpg
1034,Freeway,1996,6.4,35,26,9,74,7.6,8,6,2,75,3.4,4677,73,http://content7.flixster.com/movie/27/08/270821_det.jpg
1035,The Sound of Music,1965,7.7,47,38,9,80,5,5,2,3,40,3.6,72590,86,http://content6.flixster.com/movie/35/91/82/3591824_det.jpg
1036,Die Hard,1988,8.1,50,47,3,94,6.2,9,6,3,66,3.9,99625,91,http://content8.flixster.com/movie/10/93/34/10933490_det.gif
1037,The Lawnmower Man,1992,4.9,19,9,10,47,0,0,0,0,0,0,0,0,http://content8.flixster.com/movie/10/85/16/10851698_det.jpg
1038,Unhook the Stars,1996,6.6,16,13,3,81,6.4,6,5,1,83,3.2,257,49,http://content9.flixster.com/movie/27/66/276699_det.jpg
1039,Synthetic Pleasures,1995,5.4,6,1,5,16,0,2,0,2,0,0,0,0,http://content7.flixster.com/movie/10/97/63/10976305_det.jpg
1040,Secret Agent,1936,7.6,10,10,0,100,0,0,0,0,0,0,0,0,http://content8.flixster.com/movie/10/35/29/10352954_det.jpg
1041,Secrets & Lies,1996,8.6,34,32,2,94,9.2,7,7,0,100,4.1,3358,90,http://content6.flixster.com/movie/10/86/84/10868484_det.jpg
1042,That Thing You Do!,1996,7.1,50,46,4,92,7.2,17,16,1,94,3.2,14364,69,http://content9.flixster.com/movie/10/89/08/10890851_det.jpg
1043,To Gillian on Her 37th Birthday,1996,4.7,27,4,23,14,5.2,7,0,7,0,2.9,1032,43,http://content9.flixster.com/movie/26/66/266615_det.jpg
1044,Surviving Picasso,1996,5,17,5,12,29,6.2,6,2,4,33,3.4,1054,58,http://content8.flixster.com/movie/74/43/17/7443178_det.jpg
1045,Love Is All There Is,1996,0,2,0,2,0,0,0,0,0,0,0,0,0,http://content6.flixster.com/movie/27/61/276104_det.jpg
1046,Beautiful Thing,1996,6.8,20,18,2,90,6.8,8,7,1,87,4.3,3357,91,http://content8.flixster.com/movie/26/94/269414_det.jpg
1047,The Long Kiss Goodnight,1996,6.1,29,20,9,68,4.1,6,0,6,0,3.3,10833,69,http://content8.flixster.com/movie/59/86/77/5986778_det.jpg
1049,The Ghost and the Darkness,1996,5.5,45,23,22,51,4.3,10,2,8,20,3.3,7987,71,http://content9.flixster.com/movie/10/86/46/10864623_det.jpg
1050,Looking for Richard,1996,7.1,45,37,8,82,6.5,12,8,4,66,3.6,1885,73,http://content6.flixster.com/movie/10/91/36/10913644_det.jpg
1051,Trees Lounge,1996,6.9,25,20,5,80,0,4,3,1,75,3.6,1441,78,http://content9.flixster.com/movie/28/39/283995_det.jpg
1053,Normal Life,1996,6,10,7,3,70,0,2,2,0,100,3,289,45,http://content7.flixster.com/movie/10/88/24/10882453_det.jpg
1054,Get on the Bus,1996,7.5,38,33,5,86,7.7,10,9,1,90,3.5,1014,70,http://content6.flixster.com/movie/10/86/99/10869944_det.jpg
1055,Shadow Conspiracy,1997,3,27,0,27,0,3.3,9,0,9,0,2.6,692,24,http://content9.flixster.com/movie/31/37/313791_det.jpg
1056,Jude,1996,7.3,28,24,4,85,7.7,8,7,1,87,3.6,1931,71,http://content9.flixster.com/movie/27/59/275991_det.jpg
1057,Everyone Says I Love You,1996,7.3,41,32,9,78,7,9,5,4,55,3.4,6964,63,http://content6.flixster.com/movie/10/89/31/10893116_det.jpg
1058,Azúcar amarga,1996,0,3,2,1,66,0,0,0,0,0,0,0,0,http://content9.flixster.com/movie/10/91/32/10913275_det.jpg
1059,Romeo + Juliet,1996,0,0,0,0,0,0,0,0,0,0,0,0,0,http://content6.flixster.com/movie/10/85/38/10853892_det.jpg
1060,Swingers,1996,7.7,51,44,7,86,7.6,10,8,2,80,3.8,14060,89,http://content9.flixster.com/movie/11/12/17/11121759_det.jpg
1061,Sleepers,1996,6.7,48,35,13,72,7.3,9,8,1,88,3.6,20694,81,http://content9.flixster.com/movie/27/01/270111_det.jpg
1062,The Sunchaser,1996,3.9,5,1,4,20,0,1,0,1,0,3.3,191,52,http://content8.flixster.com/movie/83/85/33/8385330_det.jpg
1063,Indiana Jones and the Last Crusade,1989,7.9,54,48,6,88,6.5,7,5,2,71,3.9,103952,91,http://content7.flixster.com/movie/10/91/96/10919621_det.jpg
1064,Aladdin and the King of Thieves,1995,4.4,9,2,7,22,0,0,0,0,0,0,0,0,http://content6.flixster.com/movie/10/93/64/10936432_det.jpg
1066,Shall We Dance,2004,5.4,152,69,83,45,5.2,37,16,21,43,3,26935,63,http://content9.flixster.com/movie/10/84/66/10846607_det.jpg
1067,A Damsel in Distress,1937,0,4,3,1,75,0,1,1,0,100,3.5,179,59,http://content9.flixster.com/movie/10/87/43/10874351_det.jpg
1068,Crossfire,1947,7.7,12,10,2,83,0,3,3,0,100,3.5,577,72,http://content7.flixster.com/movie/11/12/18/11121857_det.jpg
1069,"Murder, My Sweet",1944,7.7,14,13,1,92,0,0,0,0,0,0,0,0,http://content6.flixster.com/movie/10/89/53/10895388_det.jpg
1070,Macao,1952,5.7,9,5,4,55,0,2,0,2,0,3.4,169,55,http://content6.flixster.com/movie/10/92/51/10925124_det.jpg
1071,For the Moment,1993,0,0,0,0,0,0,0,0,0,0,0,0,0,http://content6.flixster.com/movie/10/88/39/10883976_det.jpg
1073,Willy Wonka & the Chocolate Factory,1971,7.5,29,26,3,89,0,0,0,0,0,0,0,0,http://content9.flixster.com/movie/25/32/253203_det.jpg
1076,The Innocents,1961,7.9,24,23,1,95,0,4,3,1,75,4,2095,85,http://content7.flixster.com/movie/28/56/285693_det.jpg
1077,Sleeper,1973,8,28,28,0,100,0,4,4,0,100,3.7,6718,80,http://content8.flixster.com/movie/25/67/256722_det.jpg
1078,Bananas,1971,7,18,16,2,88,0,1,1,0,100,3.6,4533,73,http://content8.flixster.com/movie/10/90/14/10901434_det.jpg
1079,A Fish Called Wanda,1988,8,46,44,2,95,7.8,8,7,1,87,3.4,15157,77,http://content9.flixster.com/movie/26/75/267511_det.jpg
1080,Life of Brian,1979,8.2,53,51,2,96,7.9,13,12,1,92,3.9,40453,91,http://content7.flixster.com/movie/10/94/54/10945437_det.jpg
1081,Victor Victoria,1982,8,17,16,1,94,0,1,1,0,100,3.7,3624,82,http://content6.flixster.com/movie/25/53/255300_det.jpg
1082,The Manchurian Candidate,1962,8.6,48,47,1,97,7.5,6,5,1,83,3.9,6006,89,http://content7.flixster.com/movie/26/56/265601_det.jpg
1083,The Great Race,1965,6.1,20,15,5,75,0,2,2,0,100,3.8,2175,81,http://content6.flixster.com/movie/10/88/81/10888116_det.jpg
1084,Bonnie and Clyde,1967,8.1,46,41,5,89,6,7,4,3,57,3.7,12684,84,http://content6.flixster.com/movie/11/14/98/11149888_det.jpg
1085,The Old Man and the Sea,1958,6.4,8,7,1,87,0,0,0,0,0,0,0,0,http://content8.flixster.com/movie/10/88/22/10882258_det.jpg
1086,Dial M for Murder,1954,7.2,26,21,5,80,6.8,6,5,1,83,3.9,9307,88,http://content7.flixster.com/movie/10/86/71/10867193_det.jpg
1087,M. Butterfly,1993,0,0,0,0,0,0,0,0,0,0,0,0,0,http://images.rottentomatoescdn.com/images/defaults/poster_default.gif
1088,Dirty Dancing,1987,5.8,43,29,14,67,5.8,6,4,2,66,3.7,185439,88,http://content6.flixster.com/movie/10/91/46/10914656_det.jpg
1089,Reservoir Dogs,1992,8.9,45,43,2,95,8.5,12,11,1,91,4.1,125757,93,http://content6.flixster.com/movie/10/83/91/10839128_det.jpg
1090,Platoon,1986,7.8,42,36,6,85,6.8,10,7,3,70,3.9,49655,91,http://content7.flixster.com/movie/10/86/50/10865025_det.jpg
1091,Weekend at Bernie's,1989,4.9,21,10,11,47,0,1,0,1,0,3,6596,57,http://content9.flixster.com/movie/10/88/30/10883063_det.jpg
1092,Basic Instinct,1992,6,42,25,17,59,5.7,10,6,4,60,3.1,14326,64,http://content7.flixster.com/movie/28/33/283309_det.jpg
1093,The Doors,1991,5.8,44,25,19,56,4.1,9,2,7,22,3.6,14440,80,http://content7.flixster.com/movie/28/48/284817_det.jpg
1094,The Crying Game,1992,8.5,38,38,0,100,9.4,6,6,0,100,3.5,5761,76,http://content7.flixster.com/movie/27/86/278613_det.jpg
1095,Glengarry Glen Ross,1992,8.5,41,40,1,97,0,4,4,0,100,3.9,9083,87,http://content6.flixster.com/movie/10/93/46/10934652_det.jpg
1096,Sophie's Choice,1982,7.1,26,21,5,80,6.6,5,3,2,60,3.9,5468,87,http://content6.flixster.com/movie/10/88/09/10880940_det.jpg
1097,E.T.: The Extra-Terrestrial,1982,8.9,89,87,2,97,8.6,18,17,1,94,3.5,154405,65,http://content8.flixster.com/movie/16/90/48/1690482_det.jpg
1098,The Search for One-eye Jimmy,1994,0,0,0,0,0,0,0,0,0,0,0,0,0,http://content9.flixster.com/movie/35/55/91/3555915_det.jpg
1099,A Christmas Carol,1984,0,0,0,0,0,0,0,0,0,0,0,0,0,http://content9.flixster.com/movie/10/99/61/10996135_det.jpg
1100,Days of Thunder,1990,4.6,43,17,26,39,5.6,8,5,3,62,3,14585,59,http://content9.flixster.com/movie/25/70/257091_det.jpg
1101,Top Gun,1986,0,0,0,0,0,0,0,0,0,0,0,0,0,http://images.rottentomatoescdn.com/images/defaults/poster_default.gif
1102,American Strays,1996,0,0,0,0,0,0,0,0,0,0,0,0,0,http://content6.flixster.com/movie/11/15/11/11151128_det.jpg
1103,Rebel Without a Cause,1955,8.2,41,39,2,95,7.7,5,5,0,100,3.9,14558,87,http://content7.flixster.com/movie/10/87/09/10870961_det.jpg
1104,A Streetcar Named Desire,1951,8.5,46,45,1,97,8.5,5,5,0,100,3.9,13151,88,http://content6.flixster.com/movie/25/45/254524_det.jpg
1105,Children of the Corn: The Gathering,1996,0,1,0,1,0,0,0,0,0,0,0,0,0,http://content8.flixster.com/movie/10/91/84/10918478_det.jpg
1107,Loser,2000,4.2,94,23,71,24,4.5,26,9,17,34,2.6,5745,37,http://content7.flixster.com/movie/26/34/263425_det.jpg
1111,Microcosmos: Le peuple de l'herbe,1996,8,29,28,1,96,9.3,5,5,0,100,4,1418,89,http://content9.flixster.com/movie/10/86/09/10860943_det.jpg
1112,Palookaville,1995,6.2,11,7,4,63,0,3,3,0,100,3.3,334,58,http://content7.flixster.com/movie/28/19/281993_det.jpg
1113,The Associate,1996,5.1,17,4,13,23,6.2,7,3,4,42,2.9,1259,52,http://content7.flixster.com/movie/25/98/259813_det.jpg
1114,The Funeral,1996,7,24,20,4,83,7.6,5,5,0,100,3.4,1110,65,http://content7.flixster.com/movie/28/48/284821_det.jpg
1115,Sleepover,2004,3.7,95,14,81,14,3.9,29,5,24,17,3.3,29842,62,http://content6.flixster.com/movie/10/94/27/10942700_det.jpg
1116,La fille seule,1995,6.8,7,5,2,71,0,0,0,0,0,0,0,0,http://content6.flixster.com/movie/10/89/99/10899968_det.jpg
1117,Le huitième jour,1996,6.8,6,4,2,66,0,3,1,2,33,4,1377,86,http://content6.flixster.com/movie/19/57/20/1957200_det.jpg
1119,Punch-Drunk Love,2002,7.4,179,141,38,78,7.4,36,29,7,80,3.2,24379,72,http://content7.flixster.com/movie/27/01/270105_det.jpg
1120,The People vs. Larry Flynt,1996,7.7,53,46,7,86,7.7,15,13,2,86,3.3,7206,73,http://content9.flixster.com/movie/27/96/279603_det.jpg
1121,Glory Daze,1995,0,4,0,4,0,0,0,0,0,0,0,0,0,http://content8.flixster.com/movie/28/01/280106_det.jpg
1123,A Perfect Candidate,1996,6.9,16,14,2,87,7.5,8,7,1,87,3.2,252,66,http://content7.flixster.com/movie/30/24/302417_det.jpg
1124,On Golden Pond,1981,7.5,21,19,2,90,0,4,3,1,75,3.7,4024,84,http://content7.flixster.com/movie/26/46/264625_det.jpg
1125,The Return of the Pink Panther,1975,6.6,16,14,2,87,0,0,0,0,0,0,0,0,http://content7.flixster.com/movie/10/87/22/10872257_det.jpg
1126,Drop Dead Fred,1991,2.7,12,1,11,8,0,1,0,1,0,3.1,20039,72,http://content7.flixster.com/movie/25/58/255809_det.jpg
1127,The Abyss,1989,7.2,43,38,5,88,6.5,6,4,2,66,3.5,17381,78,http://content7.flixster.com/movie/26/41/264193_det.jpg
1128,The Fog,2005,2.7,66,3,63,4,2.8,11,0,11,0,2.5,14642,35,http://content7.flixster.com/movie/25/03/250317_det.jpg
1129,Escape from New York,1981,6.8,45,37,8,82,0,4,2,2,50,3.4,15629,72,http://content8.flixster.com/movie/27/30/273002_det.jpg
1130,The Howling,1981,6.1,25,15,10,60,0,1,0,1,0,3.2,4849,61,http://content6.flixster.com/movie/28/39/283992_det.jpg
1131,Jean de Florette,1986,8,19,19,0,100,0,3,3,0,100,4.2,3691,94,http://content8.flixster.com/movie/25/83/258318_det.jpg
1132,Manon des sources,1986,8.9,13,13,0,100,0,2,2,0,100,4.2,2871,91,http://content6.flixster.com/movie/10/94/69/10946936_det.jpg
1133,Kinsey,2004,7.6,187,168,19,89,7.9,39,36,3,92,3.4,6162,72,http://content6.flixster.com/movie/10/94/53/10945324_det.jpg
1135,Private Benjamin,1980,6.7,22,19,3,86,0,1,1,0,100,3,3377,57,http://content6.flixster.com/movie/27/50/275008_det.jpg
1136,Monty Python and the Holy Grail,1975,7.8,51,48,3,94,7.1,13,12,1,92,4.1,94032,94,http://content7.flixster.com/movie/26/07/260725_det.jpg
1137,Hustler White,1996,0,2,1,1,50,0,0,0,0,0,0,0,0,http://content7.flixster.com/movie/28/80/288093_det.jpg
1138,Dadetown,1995,0,4,3,1,75,0,3,2,1,66,0,0,0,http://images.rottentomatoescdn.com/images/defaults/poster_default.gif
1139,Everything Relative,1996,4.9,8,2,6,25,0,4,1,3,25,3.2,49,50,http://content8.flixster.com/movie/10/88/06/10880662_det.jpg
1140,Entertaining Angels: The Dorothy Day Story,1996,4.8,6,3,3,50,0,1,0,1,0,3.7,176,67,http://content8.flixster.com/movie/35/32/07/3532074_det.jpg
1142,Get Over It,2001,5.1,62,28,34,45,5.4,18,9,9,50,2.9,9761,51,http://content9.flixster.com/movie/10/87/96/10879663_det.jpg
1143,Trois vies & une seule mort,1996,6.3,9,5,4,55,0,2,1,1,50,4,162,80,http://content7.flixster.com/movie/83/72/46/8372465_det.jpg
1144,The Line King: The Al Hirschfeld Story,1996,0,2,2,0,100,0,0,0,0,0,0,0,0,http://content8.flixster.com/movie/10/85/81/10858174_det.jpg
1146,Curtis's Charm,1995,\N,\N,\N,\N,\N,\N,\N,\N,\N,\N,\N,\N,\N,\N
1147,When We Were Kings,1996,8.4,42,41,1,97,8.1,12,12,0,100,4.1,2489,91,http://content7.flixster.com/movie/10/92/29/10922993_det.jpg
1148,Wallace & Gromit in The Wrong Trousers,1993,9.1,24,24,0,100,0,0,0,0,0,0,0,0,http://content9.flixster.com/movie/74/28/86/7428867_det.jpg
1149,JLG/JLG - autoportrait de décembre,1994,\N,\N,\N,\N,\N,\N,\N,\N,\N,\N,\N,\N,\N,\N
1150,Le retour de Martin Guerre,1982,8,9,9,0,100,0,0,0,0,0,0,0,0,http://content9.flixster.com/movie/29/94/299491_det.jpg
1151,Faust: Love of the Damned,2000,0,3,1,2,33,0,0,0,0,0,0,0,0,http://content7.flixster.com/movie/10/90/86/10908669_det.jpg
1152,He Walked by Night,1948,7.6,6,5,1,83,0,0,0,0,0,0,0,0,http://content8.flixster.com/movie/10/33/53/10335338_det.jpg
1153,Raw Deal,1986,3.8,12,3,9,25,0,1,0,1,0,2.7,3041,32,http://content7.flixster.com/movie/10/87/80/10878017_det.jpg
1154,T-Men,1947,7.8,6,6,0,100,0,0,0,0,0,0,0,0,http://content7.flixster.com/movie/34/90/10/3490101_det.jpg
1156,I bambini ci guardano,1944,0,2,2,0,100,0,0,0,0,0,0,0,0,http://content7.flixster.com/movie/10/93/91/10939149_det.jpg
1157,La symphonie pastorale,1946,0,0,0,0,0,0,0,0,0,0,0,0,0,http://content7.flixster.com/movie/10/86/41/10864137_det.jpg
1161,Die Blechtrommel,1979,7.3,12,9,3,75,0,1,0,1,0,4,2140,86,http://content7.flixster.com/movie/10/86/23/10862349_det.jpg
1162,The Ruling Class,1972,7.2,11,9,2,81,0,1,0,1,0,3.9,956,85,http://content8.flixster.com/movie/28/04/280402_det.jpg
1163,Mina Tannenbaum,1994,0,2,2,0,100,0,0,0,0,0,0,0,0,http://content8.flixster.com/movie/10/54/46/10544670_det.jpg
1164,2 ou 3 choses que je sais d'elle,1967,8,29,27,2,93,7.6,8,7,1,87,3.8,1050,73,http://content9.flixster.com/movie/55/83/45/5583455_det.jpg
1167,Dear God,1996,3.6,33,4,29,12,3.2,10,0,10,0,2.6,883,26,http://content6.flixster.com/movie/10/91/90/10919008_det.jpg
1168,Bad Moon,1996,3.3,5,1,4,20,0,1,0,1,0,2.8,1122,41,http://content9.flixster.com/movie/27/37/273711_det.jpg
1169,"Hollywoodism: Jews, Movies and the American Dream",1998,\N,\N,\N,\N,\N,\N,\N,\N,\N,\N,\N,\N,\N,\N
1170,Best of the Best 3: No Turning Back,1995,0,0,0,0,0,0,0,0,0,0,0,0,0,http://content6.flixster.com/movie/11/14/40/11144072_det.jpg
1171,Bob Roberts,1992,7.5,34,34,0,100,7.4,7,7,0,100,3.5,1689,70,http://content6.flixster.com/movie/10/91/75/10917528_det.jpg
1172,Nuovo Cinema Paradiso,1988,7.9,56,50,6,89,7.8,15,13,2,86,4.4,21396,96,http://content9.flixster.com/movie/11/12/58/11125855_det.jpg
1173,The Cook the Thief His Wife & Her Lover,1989,7.3,37,33,4,89,8,7,6,1,85,3.9,5208,88,http://content6.flixster.com/movie/27/68/276824_det.jpg
1174,Grosse fatigue,1994,6.8,6,3,3,50,0,2,1,1,50,3.3,124,60,http://content8.flixster.com/movie/10/85/01/10850122_det.jpg
1175,Delicatessen,1991,7.6,39,34,5,87,5.4,6,3,3,50,4.1,14805,91,http://content6.flixster.com/movie/21/65/51/2165516_det.jpg
1176,La double vie de Véronique,1991,7.6,25,21,4,84,7.6,5,5,0,100,4.3,5676,92,http://content8.flixster.com/movie/10/94/04/10940458_det.jpg
1177,Enchanted April,1992,7.2,19,17,2,89,0,2,2,0,100,3.9,2525,80,http://content8.flixster.com/movie/10/87/94/10879422_det.jpg
1178,Paths of Glory,1957,8.6,39,36,3,92,7.1,7,5,2,71,0,0,0,http://content8.flixster.com/movie/28/63/286322_det.jpg
1179,The Grifters,1990,7.9,38,34,4,89,7.1,8,6,2,75,3.4,2730,69,http://content6.flixster.com/movie/28/29/282900_det.jpg
1180,Hear My Song,1991,7.1,12,11,1,91,0,2,2,0,100,3.7,154,74,http://content7.flixster.com/movie/44/09/73/4409737_det.jpg
1183,The English Patient,1996,7.7,58,48,10,82,7.8,17,15,2,88,3.6,22977,82,http://content7.flixster.com/movie/10/88/86/10888661_det.jpg
1184,Mediterraneo,1991,6.3,13,10,3,76,0,1,0,1,0,4.1,1443,91,http://content8.flixster.com/movie/10/05/64/10056494_det.jpg
1185,My Left Foot: The Story of Christy Brown,1989,8.2,30,30,0,100,8.1,5,5,0,100,3.9,5875,90,http://content6.flixster.com/movie/14/81/63/1481632_det.jpg
1186,"Sex, Lies, and Videotape",1989,7.9,34,33,1,97,8,5,5,0,100,3.3,5946,73,http://content7.flixster.com/movie/27/06/270617_det.jpg
1187,Passion Fish,1992,7.8,22,22,0,100,0,3,3,0,100,3.6,614,79,http://content6.flixster.com/movie/27/83/278392_det.jpg
1188,Strictly Ballroom,1992,0,0,0,0,0,0,0,0,0,0,0,0,0,http://content6.flixster.com/movie/10/84/26/10842624_det.jpg
1189,The Thin Blue Line,1988,8.7,11,11,0,100,0,1,1,0,100,4,1805,89,http://content7.flixster.com/movie/29/37/293729_det.jpg
1190,Átame!,1990,6.5,23,17,6,73,0,4,1,3,25,3.7,4683,79,http://content8.flixster.com/movie/11/13/35/11133522_det.gif
1191,Madonna: Truth or Dare,1991,6.1,16,12,4,75,0,2,2,0,100,3.2,2102,62,http://content6.flixster.com/movie/26/97/269792_det.jpg
1192,Paris Is Burning,1990,7.4,9,9,0,100,0,2,2,0,100,4,878,82,http://content7.flixster.com/movie/26/93/269309_det.jpg
1193,One Flew Over the Cuckoo's Nest,1975,8.8,50,48,2,96,6.3,6,4,2,66,4.2,61369,95,http://content6.flixster.com/movie/26/74/267412_det.jpg
1194,Up in Smoke,1978,5.1,16,7,9,43,0,2,0,2,0,3.6,11888,81,http://content9.flixster.com/movie/62/26/95/6226959_det.jpg
1196,Star Wars: Episode V - The Empire Strikes Back,1980,8.6,71,69,2,97,7.5,17,15,2,88,4.1,146071,94,http://content6.flixster.com/movie/10/94/47/10944712_det.jpg
1197,The Princess Bride,1987,8.2,44,42,2,95,7.4,7,6,1,85,4,116640,92,http://content7.flixster.com/movie/10/92/26/10922677_det.png
1198,Raiders of the Lost Ark,1981,0,0,0,0,0,0,0,0,0,0,0,0,0,http://images.rottentomatoescdn.com/images/defaults/poster_default.gif
1199,Brazil,1985,8.6,40,39,1,97,7.2,8,7,1,87,4.1,35162,89,http://content8.flixster.com/movie/26/99/269902_det.jpg
1200,Aliens,1986,8.8,47,47,0,100,8,7,7,0,100,3.8,72406,90,http://content6.flixster.com/movie/10/85/78/10857876_det.jpg
1201,"Il buono, il brutto, il cattivo.",1966,8.7,62,61,1,98,8,11,10,1,90,4,40790,93,http://content9.flixster.com/movie/10/91/38/10913807_det.jpg
1202,Withnail & I,1987,8.3,28,26,2,92,0,1,1,0,100,4.4,11574,95,http://content6.flixster.com/movie/28/74/287404_det.jpg
1203,12 Angry Men,1957,8.8,36,36,0,100,0,4,4,0,100,4.1,22784,95,http://content8.flixster.com/movie/10/88/47/10884742_det.jpg
1204,Lawrence of Arabia,1962,8.8,56,55,1,98,8.3,15,14,1,93,4.1,22451,91,http://content6.flixster.com/movie/25/53/255304_det.jpg
1206,A Clockwork Orange,1971,0,0,0,0,0,0,0,0,0,0,0,0,0,http://content8.flixster.com/movie/10/85/63/10856338_det.jpg
1207,To Kill a Mockingbird,1962,8.8,39,38,1,97,0,3,3,0,100,3.8,19861,91,http://content6.flixster.com/movie/10/41/76/10417668_det.jpg
1208,Apocalypse Now,1979,8.8,61,60,1,98,8.4,11,10,1,90,4.1,67647,93,http://content6.flixster.com/movie/11/12/07/11120788_det.jpg
1209,C'era una volta il West,1968,9,48,47,1,97,7.2,5,4,1,80,4.3,18310,94,http://content9.flixster.com/movie/10/88/22/10882283_det.jpg
1210,Star Wars: Episode VI - Return of the Jedi,1983,6.7,63,49,14,77,6.4,17,13,4,76,4,137818,93,http://content7.flixster.com/movie/10/94/47/10944709_det.jpg
1211,Der Himmel über Berlin,1987,8.5,39,38,1,97,7.5,6,5,1,83,4.4,9110,94,http://content9.flixster.com/movie/25/46/254691_det.jpg
1212,The Third Man,1949,9.1,57,57,0,100,8.2,14,14,0,100,4.3,13251,94,http://content8.flixster.com/movie/11/14/87/11148754_det.jpg
1213,Goodfellas,1990,8.8,58,56,2,96,7.8,10,9,1,90,4.3,124589,96,http://content8.flixster.com/movie/10/93/19/10931922_det.jpg
1214,Alien,1979,0,0,0,0,0,0,0,0,0,0,0,0,0,http://content7.flixster.com/movie/10/87/47/10874757_det.jpg
1215,Army of Darkness,1992,6.9,37,27,10,72,0,4,2,2,50,3.8,33240,85,http://content6.flixster.com/movie/10/86/53/10865344_det.jpg
1216,Le grand bleu,1988,5.8,12,8,4,66,0,2,0,2,0,4.1,10653,92,http://content9.flixster.com/movie/10/94/57/10945723_det.jpg
1217,Ran,1985,8.7,56,54,2,96,8.5,11,11,0,100,4.3,9990,94,http://content8.flixster.com/movie/10/89/37/10893702_det.jpg
1218,Dip huet seung hung,1989,8.6,31,31,0,100,0,4,4,0,100,4,6079,91,http://content6.flixster.com/movie/29/00/290000_det.jpg
1219,Psycho,1960,8.9,67,66,1,98,7.5,8,7,1,87,3.9,32475,90,http://content7.flixster.com/movie/68/89/78/6889781_det.jpg
1220,The Blues Brothers,1980,6.9,45,38,7,84,4.8,5,2,3,40,3.7,29786,89,http://content6.flixster.com/movie/10/84/85/10848572_det.jpg
1221,The Godfather: Part II,1974,9.2,55,54,1,98,7.3,6,5,1,83,4.3,106035,96,http://content9.flixster.com/movie/26/72/267219_det.jpg
1222,Full Metal Jacket,1987,8.2,55,53,2,96,7.7,8,7,1,87,4,77926,93,http://content8.flixster.com/movie/53/08/530874_det.jpg
1223,A Grand Day Out with Wallace and Gromit,1989,8.3,19,19,0,100,0,0,0,0,0,0,0,0,http://content8.flixster.com/movie/74/28/88/7428882_det.jpg
1224,Henry V,1989,8.2,32,32,0,100,7.8,7,7,0,100,4,3619,87,http://content9.flixster.com/movie/25/39/253911_det.jpg
1225,Amadeus,1984,8.6,69,66,3,95,8.1,12,11,1,91,3.9,24420,94,http://content6.flixster.com/movie/25/50/255000_det.jpg
1226,The Quiet Man,1952,8,34,31,3,91,0,4,4,0,100,4.1,6203,91,http://content8.flixster.com/movie/29/63/296314_det.jpg
1227,Once Upon a Time in America,1984,8.4,29,27,2,93,0,4,3,1,75,4.2,25390,92,http://content7.flixster.com/movie/10/91/75/10917577_det.jpg
1228,Raging Bull,1980,9,54,53,1,98,8.1,9,8,1,88,4.1,33528,92,http://content9.flixster.com/movie/10/93/45/10934583_det.jpg
1230,Annie Hall,1977,8.8,46,45,1,97,8.2,5,5,0,100,3.9,27350,92,http://content8.flixster.com/movie/10/85/12/10851294_det.jpg
1231,The Right Stuff,1983,8.6,30,29,1,96,0,1,1,0,100,3.9,5615,87,http://content7.flixster.com/movie/58/56/27/5856273_det.jpg
1232,Stalker,1979,8.2,16,16,0,100,0,2,2,0,100,4.5,6877,95,http://content7.flixster.com/movie/29/43/294309_det.jpg
1233,Das Boot,1981,9,36,36,0,100,8.5,5,5,0,100,4.1,11718,94,http://content6.flixster.com/movie/10/92/18/10921888_det.jpg
1234,The Sting,1973,8.1,45,41,4,91,6.9,5,4,1,80,4.1,16187,93,http://content7.flixster.com/movie/11/11/96/11119697_det.jpg
1235,Harold and Maude,1971,7.6,38,32,6,84,0,4,0,4,0,4.2,15115,93,http://content9.flixster.com/movie/25/38/253827_det.jpg
1236,Trust the Man,2005,4.6,100,27,73,27,4.5,25,3,22,12,2.9,11451,38,http://content8.flixster.com/movie/21/37/19/2137190_det.jpg
1237,Det sjunde inseglet,1957,9,46,43,3,93,0,4,3,1,75,4.3,12987,94,http://content6.flixster.com/movie/10/91/35/10913568_det.jpg
1238,Local Hero,1983,8.8,30,30,0,100,0,4,4,0,100,4.1,2127,87,http://content8.flixster.com/movie/25/52/255294_det.jpg
1240,Terminator Salvation,2009,5,251,80,171,31,4.9,35,10,25,28,3.4,267474,64,http://content8.flixster.com/movie/10/92/76/10927658_det.jpg
1241,Braindead,1992,7.4,20,17,3,85,0,1,1,0,100,3.8,16839,84,http://content6.flixster.com/movie/28/59/285900_det.jpg
1242,Glory,1989,7.9,40,37,3,92,7.4,9,8,1,88,4,13978,92,http://content7.flixster.com/movie/10/86/41/10864113_det.jpg
1243,Rosencrantz & Guildenstern Are Dead,1990,6.3,27,18,9,66,0,4,0,4,0,4,4144,89,http://content9.flixster.com/movie/25/43/254319_det.jpg
1244,Manhattan,1979,8.6,43,42,1,97,8.5,6,6,0,100,4.1,14496,92,http://content7.flixster.com/movie/26/79/267901_det.jpg
1245,Miller's Crossing,1990,8,51,46,5,90,6.9,9,7,2,77,4,14665,90,http://content6.flixster.com/movie/26/73/267312_det.jpg
1246,Dead Poets Society,1989,7.2,49,42,7,85,6.5,7,5,2,71,3.8,56733,90,http://content9.flixster.com/movie/10/58/40/10584083_det.jpg
1247,The Graduate,1967,8,44,39,5,88,6.7,6,5,1,83,3.7,22493,90,http://content8.flixster.com/movie/27/15/271514_det.jpg
1248,Touch of Evil,1958,0,0,0,0,0,0,0,0,0,0,0,0,0,http://content8.flixster.com/movie/10/85/14/10851430_det.jpg
1249,La Femme Nikita,1997,\N,\N,\N,\N,\N,\N,\N,\N,\N,\N,\N,\N,\N,\N
1250,The Bridge on the River Kwai,1957,8.8,43,41,2,95,7.9,6,5,1,83,3.9,10774,90,http://content7.flixster.com/movie/10/92/73/10927333_det.jpg
1251,8½,1963,8.4,34,33,1,97,7.5,9,8,1,88,4.3,12375,92,http://content9.flixster.com/movie/49/37/75/4937759_det.jpg
1252,Chinatown,1974,9.3,47,47,0,100,8.8,6,6,0,100,4.2,22995,92,http://content7.flixster.com/movie/10/87/19/10871921_det.jpg
1253,The Day the Earth Stood Still,1951,8,50,47,3,94,7,5,4,1,80,3.8,8999,86,http://content7.flixster.com/movie/10/87/31/10873109_det.jpg
1254,The Treasure of the Sierra Madre,1948,9,38,38,0,100,8.5,5,5,0,100,4.1,6732,90,http://content8.flixster.com/movie/89/34/49/8934498_det.jpg
1255,Bad Taste,1987,6.4,20,14,6,70,0,0,0,0,0,0,0,0,http://content8.flixster.com/movie/11/14/76/11147638_det.jpg
1256,Duck Soup,1933,8.9,35,33,2,94,0,4,3,1,75,4.1,7416,91,http://content7.flixster.com/movie/29/49/294993_det.jpg
1257,Better Off Dead...,1985,7,21,17,4,80,0,1,1,0,100,3.7,11561,86,http://content7.flixster.com/movie/10/84/19/10841913_det.jpg
1258,The Shining,1980,7.8,45,39,6,86,5.4,6,3,3,50,4,91362,91,http://content8.flixster.com/movie/10/92/96/10929678_det.jpg
1259,Stand by Me,1986,7.8,34,32,2,94,0,2,2,0,100,0,0,0,http://content9.flixster.com/movie/28/31/283115_det.jpg
1260,M,1931,9,40,40,0,100,8.4,8,8,0,100,4.3,9191,94,http://content8.flixster.com/movie/10/85/69/10856942_det.jpg
1261,Evil Dead II,1987,7.8,42,41,1,97,6.6,6,5,1,83,3.8,30657,86,http://content9.flixster.com/movie/51/02/510275_det.jpg
1262,The Great Escape,1963,0,0,0,0,0,0,0,0,0,0,0,0,0,http://content8.flixster.com/movie/10/85/23/10852306_det.jpg
1263,The Deer Hunter,1978,8.3,44,40,4,90,7.1,5,4,1,80,4.1,27513,91,http://content6.flixster.com/movie/26/75/267592_det.jpg
1264,Diva,1981,8.1,41,39,2,95,8,14,13,1,92,4,1807,86,http://content8.flixster.com/movie/10/84/36/10843630_det.jpg
1265,Groundhog Day,1993,7.9,52,50,2,96,7.5,10,10,0,100,3.3,34921,79,http://content7.flixster.com/movie/26/23/262309_det.jpg
1266,Unforgiven,1992,8.5,56,54,2,96,7.5,11,9,2,81,4,27203,91,http://content9.flixster.com/movie/10/93/21/10932195_det.jpg
1267,The Manchurian Candidate,1962,8.6,48,47,1,97,7.5,6,5,1,83,3.9,6006,89,http://content7.flixster.com/movie/26/56/265601_det.jpg
1268,Pump Up the Volume,1990,6.7,31,25,6,80,0,3,2,1,66,3.4,5356,79,http://content8.flixster.com/movie/27/20/272094_det.jpg
1269,Arsenic and Old Lace,1944,7.6,21,19,2,90,0,3,2,1,66,4,9161,91,http://content8.flixster.com/movie/95/83/75/9583750_det.jpg
1270,Back to the Future,1985,8.4,54,52,2,96,7.3,6,5,1,83,3.8,126816,88,http://content6.flixster.com/movie/31/17/311700_det.jpg
1271,Fried Green Tomatoes,1991,6.5,22,18,4,81,0,3,3,0,100,3.7,24457,88,http://content7.flixster.com/movie/10/88/22/10882269_det.jpg
1272,Patton,1970,8.2,36,35,1,97,8.3,6,5,1,83,4,8522,93,http://content7.flixster.com/movie/18/68/40/1868409_det.jpg
1273,Down by Law,1986,7.4,24,21,3,87,6.1,6,4,2,66,4.3,6805,94,http://content8.flixster.com/movie/10/93/40/10934066_det.jpg
1274,Akira,1988,7.3,34,30,4,88,6.9,6,5,1,83,4,33398,89,http://content6.flixster.com/movie/28/40/284000_det.jpg
1275,Highlander,1986,5.9,29,19,10,65,0,2,1,1,50,3.5,18748,78,http://content7.flixster.com/movie/10/94/47/10944769_det.jpg
1276,Cool Hand Luke,1967,8.8,44,44,0,100,8.5,6,6,0,100,4.1,17521,93,http://content9.flixster.com/movie/29/06/290627_det.jpg
1277,Cyrano de Bergerac,1950,6.9,12,10,2,83,0,3,1,2,33,3.8,668,81,http://content7.flixster.com/movie/10/93/42/10934285_det.jpg
1278,Young Frankenstein,1974,8.5,46,43,3,93,0,4,4,0,100,3.8,37773,91,http://content6.flixster.com/movie/10/06/45/10064516_det.jpg
1279,Night on Earth,1991,6.3,16,13,3,81,0,2,2,0,100,4,5592,91,http://content8.flixster.com/movie/54/92/80/5492802_det.jpg
1280,Da hong deng long gao gao gua,1991,8.4,24,23,1,95,7.6,9,8,1,88,4.1,5193,92,http://content8.flixster.com/movie/10/89/42/10894258_det.jpg
1281,The Great Dictator,1940,8.9,34,32,2,94,8.8,7,6,1,85,4.2,16082,93,http://content8.flixster.com/movie/10/93/78/10937802_det.jpg
1282,Fantasia,1940,8.5,42,41,1,97,8.3,6,6,0,100,3.5,12184,77,http://content7.flixster.com/movie/10/88/07/10880753_det.jpg
1283,High Noon,1952,8.8,41,39,2,95,8.5,5,5,0,100,3.9,6074,87,http://content7.flixster.com/movie/30/88/308893_det.jpg
1284,The Big Sleep,1946,8.6,43,41,2,95,7.5,8,7,1,87,4.1,7772,91,http://content9.flixster.com/movie/10/89/25/10892543_det.jpg
1285,Heathers,1989,7.8,41,39,2,95,7,9,7,2,77,3.7,17025,82,http://content7.flixster.com/movie/28/00/280093_det.jpg
1286,Somewhere in Time,1980,5.8,16,10,6,62,0,4,1,3,25,3.9,7602,88,http://content7.flixster.com/movie/10/87/45/10874553_det.jpg
1287,Ben-Hur,1959,7.8,33,30,3,90,0,4,3,1,75,3.7,25817,80,http://content9.flixster.com/movie/10/93/53/10935339_det.jpg
1288,This Is Spinal Tap,1984,8.6,53,51,2,96,7.7,7,6,1,85,3.9,23608,91,http://content9.flixster.com/movie/28/14/281499_det.jpg
1289,Koyaanisqatsi,1982,8,18,16,2,88,0,1,1,0,100,4.3,4109,91,http://content6.flixster.com/movie/28/60/286016_det.jpg
1290,Some Kind of Wonderful,1987,6.4,33,26,7,78,5.8,6,4,2,66,3.5,7505,78,http://content8.flixster.com/movie/10/84/77/10847746_det.jpg
1291,Indiana Jones and the Last Crusade,1989,7.9,54,48,6,88,6.5,7,5,2,71,3.9,103952,91,http://content7.flixster.com/movie/10/91/96/10919621_det.jpg
1292,Being There,1979,8.4,38,36,2,94,0,4,4,0,100,4.1,6371,91,http://content6.flixster.com/movie/25/44/254496_det.jpg
1293,Gandhi,1982,7.7,40,34,6,85,6.9,5,4,1,80,3.9,10562,91,http://content9.flixster.com/movie/10/85/69/10856927_det.jpg
1295,The Unbearable Lightness of Being,1988,8.3,17,16,1,94,0,2,1,1,50,3.9,5178,84,http://content8.flixster.com/movie/27/30/273098_det.jpg
1296,A Room with a View,1985,8.6,21,21,0,100,0,2,2,0,100,3.9,6394,85,http://content6.flixster.com/movie/28/87/288792_det.jpg
1297,Real Genius,1985,6.5,23,17,6,73,0,4,2,2,50,3.5,6720,78,http://content6.flixster.com/movie/25/42/254292_det.jpg
1298,Pink Floyd The Wall,1982,6.5,17,11,6,64,0,0,0,0,0,0,0,0,http://content8.flixster.com/movie/10/87/16/10871678_det.jpg
1299,The Killing Fields,1984,8.1,33,30,3,90,5.8,6,3,3,50,4,6389,89,http://content7.flixster.com/movie/26/93/269393_det.jpg
1300,Mitt liv som hund,1985,7.9,28,28,0,100,0,3,3,0,100,4.1,2751,88,http://content6.flixster.com/movie/26/43/264304_det.jpg
1301,Forbidden Planet,1956,8.1,36,35,1,97,0,2,2,0,100,3.8,4780,82,http://content7.flixster.com/movie/25/08/250801_det.jpg
1302,Field of Dreams,1989,7.7,45,41,4,91,5.9,8,5,3,62,3.4,16498,85,http://content7.flixster.com/movie/10/84/97/10849709_det.jpg
1303,The Man Who Would Be King,1975,8.6,20,19,1,95,0,4,3,1,75,4,3790,88,http://content8.flixster.com/movie/25/47/254722_det.jpg
1304,Butch Cassidy and the Sundance Kid,1969,8.1,42,38,4,90,6.5,5,3,2,60,3.9,17396,90,http://content6.flixster.com/movie/10/93/10/10931056_det.jpg
1305,"Paris, Texas",1984,8.2,25,25,0,100,0,1,1,0,100,4.2,6389,93,http://content6.flixster.com/movie/10/93/85/10938524_det.jpg
1306,Bis ans Ende der Welt,1991,6.5,12,10,2,83,0,1,0,1,0,4.1,1508,87,http://content8.flixster.com/movie/44/43/77/4443770_det.jpg
1307,When Harry Met Sally...,1989,7.8,47,43,4,91,6.2,8,6,2,75,3.5,47834,83,http://content6.flixster.com/movie/31/25/312596_det.jpg
1310,Hype!,1996,7.5,6,6,0,100,0,2,2,0,100,3.9,430,85,http://content6.flixster.com/movie/28/70/287012_det.jpg
1311,Santa with Muscles,1996,0,3,0,3,0,0,0,0,0,0,0,0,0,http://content8.flixster.com/movie/10/86/76/10867690_det.jpg
1312,Female Perversions,1996,6.3,21,14,7,66,6.8,9,7,2,77,3.1,264,48,http://content9.flixster.com/movie/10/97/76/10977687_det.jpg
1313,Mad Dog Time,1996,2.9,6,1,5,16,0,2,0,2,0,2.9,429,48,http://content9.flixster.com/movie/11/12/32/11123267_det.jpg
1314,Breathing Room,2008,0,0,0,0,0,0,0,0,0,0,0,0,0,http://content7.flixster.com/movie/10/90/03/10900357_det.jpg
1317,I'm Not Rappaport,1996,5.6,15,5,10,33,0,4,1,3,25,3.4,285,61,http://content6.flixster.com/movie/26/50/265020_det.jpg
1318,Blue Juice,1995,0,2,0,2,0,0,1,0,1,0,3,1487,46,http://content7.flixster.com/movie/27/77/277701_det.jpg
1320,Alien³,1992,5,39,15,24,38,5.8,7,4,3,57,3.1,30526,55,http://content9.flixster.com/movie/27/38/273891_det.jpg
1321,An American Werewolf in London,1981,7.5,43,38,5,88,0,4,2,2,50,3.4,18421,76,http://content7.flixster.com/movie/28/37/283709_det.jpg
1322,Amityville 1992: It's About Time,1992,2.3,7,1,6,14,0,0,0,0,0,0,0,0,http://content6.flixster.com/movie/27/25/272500_det.jpg
1323,Amityville 3-D,1983,2.9,15,0,15,0,0,2,0,2,0,2.7,2070,32,http://content7.flixster.com/movie/26/28/262801_det.jpg
1324,Amityville: Dollhouse,1996,0,2,0,2,0,0,0,0,0,0,0,0,0,http://content9.flixster.com/movie/27/32/273299_det.jpg
1325,Amityville: A New Generation,1993,0,1,0,1,0,0,0,0,0,0,0,0,0,http://content6.flixster.com/movie/10/88/97/10889788_det.jpg
1326,Amityville II: The Possession,1982,2.7,14,1,13,7,0,1,0,1,0,2.9,3306,47,http://content6.flixster.com/movie/63/30/69/6330692_det.jpg
1327,The Amityville Horror,2005,4.2,155,37,118,23,3.9,33,7,26,21,3.2,31070,64,http://content8.flixster.com/movie/24/97/249734_det.jpg
1328,The Amityville Curse,1990,3.6,5,1,4,20,0,0,0,0,0,0,0,0,http://content7.flixster.com/movie/55/05/10/5505101_det.jpg
1329,Blood for Dracula,1974,6.4,15,10,5,66,0,2,1,1,50,3.4,1432,58,http://content6.flixster.com/movie/10/91/36/10913628_det.jpg
1330,April Fool's Day,2008,0,3,0,3,0,0,0,0,0,0,0,0,0,http://content8.flixster.com/movie/10/92/20/10922090_det.jpg
1331,Audrey Rose,1977,5.4,9,5,4,55,0,0,0,0,0,0,0,0,http://content7.flixster.com/movie/26/14/261405_det.jpg
1332,Believers,2007,0,3,0,3,0,0,0,0,0,0,0,0,0,http://content9.flixster.com/movie/10/14/14/10141427_det.jpg
1333,The Birds,1963,8,40,38,2,95,0,4,2,2,50,3.5,17449,80,http://content8.flixster.com/movie/10/83/82/10838298_det.jpg
1334,The Blob,1988,5.6,16,9,7,56,0,0,0,0,0,0,0,0,http://content6.flixster.com/movie/27/38/273804_det.jpg
1335,Blood Beach,1980,2.6,6,0,6,0,0,0,0,0,0,0,0,0,http://content9.flixster.com/movie/10/86/83/10868347_det.jpg
1336,Body Parts,1991,4.4,15,6,9,40,0,1,0,1,0,2.6,958,31,http://content9.flixster.com/movie/10/04/67/10046739_det.jpg
1337,Invasion of the Body Snatchers,1956,8.9,36,36,0,100,0,2,2,0,100,3.6,3820,81,http://content8.flixster.com/movie/10/95/44/10954478_det.jpg
1339,Dracula,1931,7.7,42,39,3,92,7.7,6,6,0,100,3.6,8598,76,http://content9.flixster.com/movie/29/22/292203_det.jpg
1340,Bride of Frankenstein,1935,8.9,39,39,0,100,8.6,6,6,0,100,3.7,4867,82,http://content8.flixster.com/movie/30/28/302822_det.jpg
1341,Burnt Offerings,1976,5.2,8,3,5,37,0,1,0,1,0,3.1,927,45,http://content7.flixster.com/movie/25/77/257797_det.jpg
1342,Candyman,1992,6.3,37,27,10,72,5.4,5,3,2,60,3,12889,58,http://content6.flixster.com/movie/27/80/278008_det.jpg
1343,Cape Fear,1991,6.9,38,29,9,76,8.3,6,6,0,100,3.4,13943,74,http://content9.flixster.com/movie/10/93/72/10937223_det.jpg
1344,Cape Fear,1991,6.9,38,29,9,76,8.3,6,6,0,100,3.4,13943,74,http://content9.flixster.com/movie/10/93/72/10937223_det.jpg
1345,Carrie,1976,8,42,38,4,90,6.4,7,4,3,57,3.3,23161,70,http://content9.flixster.com/movie/28/14/281415_det.jpg
1346,Cat People,1982,6.1,36,23,13,63,0,3,2,1,66,3,2400,46,http://content8.flixster.com/movie/28/49/284902_det.jpg
1347,A Nightmare on Elm Street,1984,7.7,40,38,2,95,0,4,4,0,100,3.5,57452,78,http://content7.flixster.com/movie/11/12/18/11121889_det.jpg
1348,"Nosferatu, eine Symphonie des Grauens",1922,8.9,47,46,1,97,8.2,5,5,0,100,3.9,11264,86,http://content9.flixster.com/movie/28/92/289207_det.jpg
1349,Nosferatu a Venezia,1988,0,0,0,0,0,0,0,0,0,0,0,0,0,http://content7.flixster.com/movie/10/85/60/10856093_det.jpg
1350,The Omen,1976,7,32,27,5,84,0,2,1,1,50,3.5,17016,78,http://content6.flixster.com/movie/10/93/48/10934824_det.jpg
1351,Blood and Wine,1996,6.1,31,19,12,61,6.5,9,6,3,66,3,951,36,http://content7.flixster.com/movie/10/88/75/10887533_det.jpg
1352,Albino Alligator,1996,5.5,17,8,9,47,5.4,6,2,4,33,3,1198,42,http://content8.flixster.com/movie/10/83/84/10838426_det.jpg
1353,The Mirror Has Two Faces,1996,5.3,28,15,13,53,0,4,1,3,25,3.5,2549,72,http://content6.flixster.com/movie/10/92/03/10920300_det.jpg
1354,Breaking the Waves,1996,8,42,36,6,85,7.8,7,6,1,85,4.1,7949,91,http://content9.flixster.com/movie/10/91/67/10916763_det.jpg
1355,Nochnoy dozor,2004,5.9,125,73,52,58,5.9,30,17,13,56,3.3,19774,70,http://content8.flixster.com/movie/22/60/07/2260074_det.jpg
1356,Star Trek: First Contact,1996,7.4,52,48,4,92,7.4,13,12,1,92,3.5,20013,84,http://content9.flixster.com/movie/10/88/85/10888599_det.jpg
1357,Shine,1996,8,31,28,3,90,8.8,7,7,0,100,3.8,6087,89,http://content6.flixster.com/movie/10/95/41/10954120_det.jpg
1358,Sling Blade,1996,8.3,49,47,2,95,7.9,16,14,2,87,3.9,10557,91,http://content7.flixster.com/movie/10/93/85/10938549_det.jpg
1359,Jingle All the Way,1996,4,38,6,32,15,5.3,6,1,5,16,2.6,10937,42,http://content9.flixster.com/movie/25/51/255123_det.jpg
1361,Paradise Lost: The Child Murders at Robin Hood Hills,1996,8.2,24,23,1,95,0,3,3,0,100,4.1,1701,90,http://content7.flixster.com/movie/11/14/56/11145609_det.jpg
1363,The Preacher's Wife,1996,5.8,38,23,15,60,7.2,11,8,3,72,2.9,3793,54,http://content7.flixster.com/movie/10/84/31/10843145_det.jpg
1364,Kjærlighetens kjøtere,1995,0,0,0,0,0,0,0,0,0,0,0,0,0,http://content7.flixster.com/movie/30/86/308629_det.jpg
1365,Ridicule,1996,7.3,17,13,4,76,8.2,5,5,0,100,3.8,979,83,http://content8.flixster.com/movie/10/87/61/10876134_det.jpg
1366,The Crucible,1996,7.2,26,20,6,76,8.3,6,4,2,66,3.2,4752,64,http://content9.flixster.com/movie/10/85/09/10850975_det.jpg
1367,One Hundred and One Dalmatians,1961,8,37,36,1,97,7.6,5,5,0,100,3.3,29711,63,http://content7.flixster.com/movie/10/92/06/10920681_det.jpg
1369,J'ai pas sommeil,1994,7.5,7,5,2,71,0,2,1,1,50,3.4,283,70,http://content8.flixster.com/movie/10/88/71/10887118_det.jpg
1370,Die Hard,1988,8.1,50,47,3,94,6.2,9,6,3,66,3.9,99625,91,http://content8.flixster.com/movie/10/93/34/10933490_det.gif
1371,Star Trek: The Motion Picture,1979,5.8,31,15,16,48,4.8,5,2,3,40,3.1,14598,48,http://content9.flixster.com/movie/25/77/257795_det.jpg
1372,Star Trek VI: The Undiscovered Country,1991,6.8,46,38,8,82,7.1,6,5,1,83,3.5,13463,77,http://content7.flixster.com/movie/10/88/86/10888601_det.jpg
1373,Star Trek V: The Final Frontier,1989,4,41,9,32,21,3.4,7,0,7,0,2.8,11133,37,http://content9.flixster.com/movie/10/89/11/10891103_det.jpg
1374,Star Trek: The Wrath of Khan,1982,7.8,40,36,4,90,7.1,6,5,1,83,3.7,18490,86,http://content8.flixster.com/movie/10/88/85/10888590_det.jpg
1375,Star Trek III: The Search for Spock,1984,6.4,38,29,9,76,6.4,6,5,1,83,3.3,13649,60,http://content6.flixster.com/movie/10/88/86/10888604_det.jpg
1376,Star Trek IV: The Voyage Home,1986,6.8,37,31,6,83,6.2,7,5,2,71,3.5,14361,77,http://content9.flixster.com/movie/10/88/86/10888603_det.jpg
1377,Batman Returns,1992,6.5,46,36,10,78,5.8,9,6,3,66,3.3,65412,68,http://content7.flixster.com/movie/56/82/90/5682901_det.jpg
1378,Young Guns,1988,4.6,25,10,15,40,0,3,1,2,33,3.5,11858,77,http://content6.flixster.com/movie/11/14/43/11144324_det.jpg
1379,Young Guns II,1990,4.9,16,6,10,37,0,2,0,2,0,3.2,7476,67,http://content7.flixster.com/movie/11/14/43/11144321_det.jpg
1380,Grease,1978,6.7,54,45,9,83,5.9,11,9,2,81,3.7,176349,85,http://content8.flixster.com/movie/55/35/45/5535450_det.jpg
1381,Grease,1978,6.7,54,45,9,83,5.9,11,9,2,81,3.7,176349,85,http://content8.flixster.com/movie/55/35/45/5535450_det.jpg
1382,Marked for Death,1990,3.2,9,2,7,22,0,0,0,0,0,0,0,0,http://content8.flixster.com/movie/27/16/271606_det.jpg
1383,Adrenalin: Fear the Rush,1996,1.4,5,0,5,0,0,1,0,1,0,2.7,684,30,http://content9.flixster.com/movie/15/97/11/1597119_det.jpg
1384,The Substance of Fire,1996,6.1,10,6,4,60,0,3,1,2,33,3,189,26,http://content7.flixster.com/movie/28/32/283217_det.jpg
1385,Under Siege,1992,6.2,23,17,6,73,0,3,2,1,66,3,9661,60,http://content9.flixster.com/movie/27/21/272191_det.jpg
1386,Terror in a Texas Town,1958,0,3,3,0,100,0,0,0,0,0,0,0,0,http://content9.flixster.com/movie/10/84/99/10849939_det.jpg
1387,Jaws,1975,8.8,37,37,0,100,8.5,5,5,0,100,3.5,63534,81,http://content7.flixster.com/movie/10/93/72/10937249_det.jpg
1388,Jaws,1975,8.8,37,37,0,100,8.5,5,5,0,100,3.5,63534,81,http://content7.flixster.com/movie/10/93/72/10937249_det.jpg
1389,Jaws 3-D,1983,2.9,24,3,21,12,0,2,0,2,0,2.5,15576,33,http://content6.flixster.com/movie/10/93/72/10937248_det.jpg
1390,My Fellow Americans,1996,5.2,38,19,19,50,4.6,14,4,10,28,3.2,1831,61,http://content6.flixster.com/movie/25/90/259092_det.jpg
1391,Mars Attacks!,1996,5.8,56,28,28,50,5.4,15,6,9,40,2.8,24991,49,http://content8.flixster.com/movie/10/88/97/10889794_det.jpg
1392,Citizen Ruth,1996,6.8,24,19,5,79,6,5,3,2,60,3.5,998,72,http://content9.flixster.com/movie/10/89/27/10892735_det.jpg
1393,Jerry Maguire,1996,7.4,57,48,9,84,7.5,19,17,2,89,3.3,32601,72,http://content9.flixster.com/movie/26/81/268123_det.jpg
1394,Raising Arizona,1987,7.6,49,44,5,89,5.5,6,3,3,50,3.6,19379,82,http://content9.flixster.com/movie/99/56/74/9956747_det.jpg
1395,Tin Men,1987,6.4,19,15,4,78,0,1,1,0,100,3.1,778,54,http://content7.flixster.com/movie/26/96/269609_det.jpg
1396,Sneakers,1992,6.8,45,36,9,80,6.4,7,5,2,71,3.4,6830,77,http://content7.flixster.com/movie/10/51/26/10512625_det.jpg
1397,Bastard Out of Carolina,1996,7.1,9,9,0,100,0,0,0,0,0,0,0,0,http://content8.flixster.com/movie/27/35/273522_det.jpg
1398,In Love and War,1996,4.1,26,3,23,11,3.4,6,0,6,0,3,2942,52,http://content8.flixster.com/movie/26/21/262106_det.jpg
1399,Marvin's Room,1996,6.7,47,38,9,80,6,13,9,4,69,3.2,4558,58,http://content9.flixster.com/movie/10/88/77/10887763_det.jpg
1401,Ghosts of Mississippi,1996,5.8,26,13,13,50,6.4,7,3,4,42,3.4,1916,64,http://content6.flixster.com/movie/10/88/54/10885484_det.jpg
1404,Night Falls on Manhattan,1996,6.7,26,17,9,65,8,5,4,1,80,3.2,471,49,http://content8.flixster.com/movie/10/83/87/10838794_det.jpg
1405,Beavis and Butt-Head Do America,1996,6.2,51,36,15,70,6.4,12,8,4,66,3,19512,61,http://content9.flixster.com/movie/25/53/255323_det.jpg
1406,La cérémonie,1995,7.7,27,25,2,92,7.4,12,11,1,91,3.9,747,85,http://content8.flixster.com/movie/30/64/306422_det.jpg
1407,Scream,1996,7,53,43,10,81,6.6,14,10,4,71,3.2,50339,70,http://content7.flixster.com/movie/10/84/96/10849637_det.jpg
1408,The Last of the Mohicans,1992,8,32,31,1,96,7.9,7,7,0,100,3.6,34073,84,http://content6.flixster.com/movie/27/61/276124_det.jpg
1409,Michael Clayton,2007,7.6,192,173,19,90,7.9,37,35,2,94,3.6,123924,72,http://content8.flixster.com/movie/99/32/72/9932722_det.jpg
1410,The Evening Star,1996,4.2,25,6,19,24,4.2,6,1,5,16,3.2,1029,59,http://content8.flixster.com/movie/25/99/259926_det.jpg
1411,Hamlet,1996,8.2,54,51,3,94,7.2,14,11,3,78,3.8,5816,86,http://content7.flixster.com/movie/10/94/26/10942625_det.jpg
1412,Some Mother's Son,1996,6.3,15,10,5,66,6.8,6,3,3,50,4,520,86,http://content8.flixster.com/movie/34/90/07/3490070_det.jpg
1413,The Whole Wide World,1996,6.9,15,12,3,80,0,4,3,1,75,3.6,707,73,http://content8.flixster.com/movie/25/86/258602_det.jpg
1414,The Mother,2003,7,88,68,20,77,7.4,32,29,3,90,3.4,862,61,http://content7.flixster.com/movie/27/51/275101_det.jpg
1415,Les voleurs,1996,7,11,9,2,81,0,4,4,0,100,3.4,257,64,http://content7.flixster.com/movie/10/19/65/10196545_det.jpg
1416,Evita,1996,6.5,31,19,12,61,6.4,6,4,2,66,3.1,8855,65,http://content9.flixster.com/movie/25/44/254419_det.jpg
1417,The Portrait of a Lady,1996,5.5,28,12,16,42,6.2,6,3,3,50,3.2,2438,50,http://content8.flixster.com/movie/26/56/265694_det.jpg
1419,Walkabout,1971,8.1,26,24,2,92,0,3,3,0,100,3.9,1862,86,http://content6.flixster.com/movie/27/00/270092_det.jpg
1420,Message to Love: The Isle of Wight Festival,1997,0,0,0,0,0,0,0,0,0,0,0,0,0,http://images.rottentomatoescdn.com/images/defaults/poster_default.gif
1421,The Grateful Dead,1977,0,0,0,0,0,0,0,0,0,0,0,0,0,http://content6.flixster.com/movie/10/83/90/10839040_det.jpg
1422,Murder at 1600,1997,5,30,10,20,33,5.3,6,1,5,16,2.9,4012,48,http://content8.flixster.com/movie/10/92/33/10923346_det.jpg
1423,Hearts and Minds,1974,0,0,0,0,0,0,0,0,0,0,0,0,0,http://content9.flixster.com/movie/10/88/83/10888339_det.jpg
1425,Fierce Creatures,1997,5.6,31,17,14,54,5.6,5,1,4,20,3.1,3023,56,http://content8.flixster.com/movie/10/89/15/10891554_det.jpg
1426,Zeus and Roxanne,1997,4.4,7,3,4,42,0,1,0,1,0,2.9,1549,47,http://content8.flixster.com/movie/26/30/263014_det.jpg
1427,Turbulence,1997,3.2,18,3,15,16,0,4,0,4,0,2.5,718,23,http://content9.flixster.com/movie/10/84/08/10840899_det.jpg
1428,Angel Baby,1995,\N,\N,\N,\N,\N,\N,\N,\N,\N,\N,\N,\N,\N,\N
1429,Ging chaat goo si 4: Ji gaan daan yam mo,1996,6,21,11,10,52,0,4,2,2,50,3,4216,55,http://content6.flixster.com/movie/26/65/266524_det.jpg
1430,Underworld,2003,4.7,155,47,108,30,4.4,32,5,27,15,3.6,101467,82,http://content9.flixster.com/movie/10/88/49/10884903_det.jpg
1431,Beverly Hills Ninja,1997,3.2,28,4,24,14,4.6,8,3,5,37,2.8,13679,54,http://content9.flixster.com/movie/25/95/259519_det.jpg
1432,Metro,1997,4,33,5,28,15,3.6,9,1,8,11,2.6,2757,31,http://content7.flixster.com/movie/62/77/83/6277833_det.jpg
1433,The Time Machine,2002,4.8,146,41,105,28,5,32,6,26,18,2.7,10389,45,http://content6.flixster.com/movie/10/91/76/10917636_det.jpg
1434,The Strangers,2008,5,146,65,81,44,4.8,26,13,13,50,3.1,55773,48,http://content9.flixster.com/movie/11/12/79/11127923_det.jpg
1437,The Cement Garden,1993,0,0,0,0,0,0,0,0,0,0,0,0,0,http://images.rottentomatoescdn.com/images/defaults/poster_default.gif
1438,Dante's Peak,1997,4.9,25,7,18,28,4.8,7,0,7,0,2.7,20021,45,http://content7.flixster.com/movie/10/91/66/10916621_det.jpg
1439,Meet Wally Sparks,1997,2.5,14,2,12,14,0,2,1,1,50,2.6,586,32,http://content6.flixster.com/movie/27/78/277828_det.jpg
1440,Amos & Andrew,1993,4,23,5,18,21,3.9,8,1,7,12,2.7,1624,36,http://content6.flixster.com/movie/32/93/27/3293272_det.jpg
1441,Benny & Joon,1993,5.7,30,22,8,73,5.1,8,4,4,50,3.6,28905,85,http://content7.flixster.com/movie/10/90/45/10904585_det.jpg
1442,Prefontaine,1997,6.4,26,16,10,61,6.7,9,5,4,55,3.7,1530,79,http://content8.flixster.com/movie/25/51/255198_det.jpg
1444,Guantanamera,1995,6.9,9,7,2,77,0,3,2,1,66,3.5,310,69,http://content9.flixster.com/movie/10/89/29/10892915_det.jpg
1445,McHale's Navy,1997,2.2,29,1,28,3,1.7,7,0,7,0,2.6,1386,36,http://content8.flixster.com/movie/25/91/259102_det.jpg
1446,Kolja,1996,7.8,22,21,1,95,8.8,6,6,0,100,4.2,2011,91,http://content8.flixster.com/movie/26/24/262498_det.jpg
1447,Gridlock'd,1997,6.8,31,27,4,87,7.1,10,9,1,90,3.6,2054,79,http://content7.flixster.com/movie/28/37/283717_det.jpg
1449,Waiting for Guffman,1996,7.7,53,48,5,90,7.2,11,9,2,81,3.9,8495,90,http://content9.flixster.com/movie/10/87/12/10871239_det.jpg
1450,Kavkazskiy plennik,1996,7.2,23,20,3,86,8.3,8,8,0,100,3.9,356,85,http://content7.flixster.com/movie/27/46/274693_det.jpg
1453,The Beautician and the Beast,1997,4.6,18,3,15,16,4.7,6,1,5,16,2.4,2687,43,http://content9.flixster.com/movie/26/00/260003_det.jpg
1454,SubUrbia,1996,6.3,21,13,8,61,6.4,6,3,3,50,3.3,1247,66,http://content7.flixster.com/movie/10/87/78/10877809_det.jpg
1455,Hotel de Love,1996,5.1,8,2,6,25,0,3,0,3,0,3.7,121,67,http://content8.flixster.com/movie/72/14/16/7214166_det.jpg
1456,The Pest,1997,2.3,23,2,21,8,2.2,7,1,6,14,2.7,4963,63,http://content8.flixster.com/movie/25/85/258526_det.jpg
1457,Fools Rush In,1997,4.8,27,9,18,33,5.1,7,2,5,28,3,9687,61,http://content9.flixster.com/movie/31/38/313803_det.jpg
1458,Touch,1997,4.7,17,5,12,29,0,3,0,3,0,2.9,494,36,http://content8.flixster.com/movie/39/55/09/3955094_det.jpg
1459,Absolute Power,1997,5.5,41,19,22,46,6.2,10,5,5,50,3.2,6094,52,http://content7.flixster.com/movie/55/34/87/5534877_det.jpg
1460,That Darn Cat,1997,3.8,14,1,13,7,0,4,0,4,0,2.5,2029,30,http://content6.flixster.com/movie/10/86/44/10864404_det.jpg
1461,Vegas Vacation,1997,3.8,28,4,24,14,3.2,10,1,9,10,3,7915,55,http://content7.flixster.com/movie/10/86/96/10869605_det.jpg
1463,That Old Feeling,1997,5,15,6,9,40,0,4,2,2,50,3,901,57,http://content6.flixster.com/movie/25/92/259296_det.jpg
1464,Lost Highway,1997,6.2,39,23,16,58,6,6,2,4,33,3.9,17451,87,http://content9.flixster.com/movie/10/89/41/10894179_det.jpg
1465,Rosewood,1997,7.1,47,40,7,85,7,11,8,3,72,3.7,1445,82,http://content7.flixster.com/movie/27/01/270117_det.jpg
1466,Donnie Brasco,1997,7.8,54,47,7,87,7.1,16,12,4,75,3.7,40329,85,http://content7.flixster.com/movie/60/49/62/6049625_det.jpg
1468,Booty Call,1997,4.2,12,3,9,25,5.4,6,2,4,33,2.8,3264,56,http://content9.flixster.com/movie/11/12/63/11126367_det.jpg
1471,Boys Life 2,1997,6.7,5,4,1,80,0,2,2,0,100,3.3,79,64,http://content6.flixster.com/movie/10/85/10/10851024_det.jpg
1472,City of Industry,1997,5.2,13,6,7,46,4.7,6,1,5,16,2.9,791,31,http://content8.flixster.com/movie/27/54/275494_det.jpg
1473,Children of Men,2006,8,208,193,15,92,7.8,41,37,4,90,3.7,127695,81,http://content6.flixster.com/movie/27/04/67/2704676_det.jpg
1474,Jungle 2 Jungle,1997,4,39,7,32,17,4.2,13,3,10,23,2.7,9218,44,http://content9.flixster.com/movie/25/96/259695_det.jpg
1475,Kama Sutra: A Tale of Love,1996,5,18,7,11,38,5.9,5,2,3,40,3.5,1793,72,http://content7.flixster.com/movie/11/12/12/11121289_det.jpg
1476,Private Parts,1997,0,0,0,0,0,0,0,0,0,0,0,0,0,http://content7.flixster.com/movie/10/92/42/10924221_det.jpg
1477,Love Jones,1997,6.4,15,10,5,66,6.8,5,4,1,80,4.2,4854,96,http://content7.flixster.com/movie/10/88/65/10886513_det.jpg
1479,The Saint,1997,4.6,44,13,31,29,4.3,15,3,12,20,3.1,11647,62,http://content6.flixster.com/movie/10/86/88/10868812_det.jpg
1480,Smilla's Sense of Snow,1997,6,32,17,15,53,6.5,7,4,3,57,3.3,1224,59,http://content7.flixster.com/movie/27/65/276509_det.jpg
1482,Van Helsing,2004,0,0,0,0,0,0,0,0,0,0,0,0,0,http://content8.flixster.com/movie/10/84/54/10845422_det.jpg
1483,Crash,2004,7.1,197,148,49,75,7.1,39,30,9,76,4,98746,89,http://content7.flixster.com/movie/24/97/249717_det.jpg
1484,The Daytrippers,1996,6.4,22,16,6,72,0,4,3,1,75,3.5,621,67,http://content7.flixster.com/movie/28/48/284809_det.jpg
1485,Liar Liar,1997,6.9,51,42,9,82,7.5,15,13,2,86,3.4,93496,72,http://content6.flixster.com/movie/26/42/264208_det.jpg
1486,The Quiet Room,1996,0,4,3,1,75,0,0,0,0,0,0,0,0,http://content9.flixster.com/movie/10/91/52/10915291_det.jpg
1487,Selena,1997,6,38,24,14,63,6.2,9,6,3,66,3.2,17729,76,http://content9.flixster.com/movie/10/86/75/10867511_det.jpg
1488,The Devil's Own,1997,5.3,34,10,24,29,6.3,7,2,5,28,3,7624,46,http://content8.flixster.com/movie/21/77/85/2177854_det.jpg
1489,Cats Don't Dance,1997,6.5,15,10,5,66,0,4,3,1,75,3.5,2510,72,http://content9.flixster.com/movie/10/88/92/10889223_det.jpg
1490,B*A*P*S,1997,3,30,4,26,13,4.9,8,3,5,37,2.9,1372,57,http://content6.flixster.com/movie/10/84/83/10848328_det.jpg
1493,Love and Other Catastrophes,1996,5.5,13,6,7,46,0,3,0,3,0,3.8,270,75,http://content9.flixster.com/movie/10/90/14/10901411_det.jpg
1495,Turbo: A Power Rangers Movie,1997,3.8,17,3,14,17,3.8,8,2,6,25,2.7,1946,42,http://content7.flixster.com/movie/10/94/61/10946113_det.jpg
1496,Anna Karenina,1935,7.4,7,7,0,100,0,0,0,0,0,0,0,0,http://content7.flixster.com/movie/10/94/46/10944689_det.jpg
1497,Double Team,1997,3.8,19,2,17,10,4.8,5,0,5,0,2.2,4157,31,http://content6.flixster.com/movie/10/88/96/10889692_det.jpg
1498,Inventing the Abbotts,1997,5.4,25,8,17,32,5.4,7,2,5,28,3.2,2432,54,http://content6.flixster.com/movie/10/86/16/10861636_det.jpg
1499,Anaconda,1997,4.7,45,17,28,37,5.6,10,5,5,50,2.5,21526,32,http://content9.flixster.com/movie/10/85/54/10855479_det.jpg
1500,Grosse Pointe Blank,1997,7.1,57,44,13,77,6.5,15,11,4,73,3.7,17815,85,http://content7.flixster.com/movie/26/73/267397_det.jpg
1501,Keys to Tulsa,1996,4.1,8,1,7,12,0,1,0,1,0,2.9,271,28,http://content6.flixster.com/movie/10/84/01/10840164_det.jpg
1502,KISS Meets the Phantom of the Park,1978,0,0,0,0,0,0,0,0,0,0,0,0,0,http://content6.flixster.com/movie/31/31/313192_det.jpg
1503,8 Heads in a Duffel Bag,1997,3.3,18,2,16,11,0,4,0,4,0,2.6,2533,34,http://content6.flixster.com/movie/10/88/92/10889240_det.jpg
1504,Hollow Reed,1996,7.4,12,11,1,91,0,3,2,1,66,3.1,40,47,http://content8.flixster.com/movie/10/85/78/10857874_det.jpg
1507,Paradise Road,1997,6,20,10,10,50,5.8,7,2,5,28,3.6,918,75,http://content7.flixster.com/movie/27/62/276221_det.jpg
1508,The Time Traveler's Wife,2009,5.1,151,56,95,37,4.8,34,10,24,29,2.9,189828,65,http://content7.flixster.com/movie/10/92/43/10924397_det.jpg
1509,Walk All Over Me,2007,0,4,2,2,50,0,1,0,1,0,3,609,37,http://content6.flixster.com/movie/10/91/88/10918812_det.jpg
1510,A Brother's Kiss,1997,0,4,4,0,100,0,2,2,0,100,2.9,289,44,http://content7.flixster.com/movie/28/48/284813_det.jpg
1511,Shekvarebuli kulinaris ataserti retsepti,1996,6.4,10,6,4,60,0,3,1,2,33,3.5,32,50,http://content9.flixster.com/movie/10/87/72/10877223_det.jpg
1513,Romy and Michele's High School Reunion,1997,6.2,49,34,15,69,5.9,16,9,7,56,2.8,12541,60,http://content6.flixster.com/movie/10/89/47/10894788_det.jpg
1514,Feng yue,1996,6.4,13,8,5,61,6.2,5,2,3,40,3.5,585,67,http://content7.flixster.com/movie/27/05/270517_det.jpg
1515,Volcano,1997,5,38,16,22,42,4.5,10,3,7,30,2.7,14505,43,http://content8.flixster.com/movie/25/89/258910_det.jpg
1516,Children of the Revolution,1996,6.6,17,13,4,76,7,6,4,2,66,3.3,479,60,http://content9.flixster.com/movie/10/88/07/10880735_det.jpg
1517,Austin Powers: International Man of Mystery,1997,0,0,0,0,0,0,0,0,0,0,0,0,0,http://content7.flixster.com/movie/10/85/37/10853769_det.jpg
1518,Mujeres al borde de un ataque de nervios,1988,7.6,26,23,3,88,0,4,4,0,100,4,6254,88,http://content9.flixster.com/movie/10/87/03/10870371_det.jpg
1519,Broken English,2007,6.3,73,47,26,64,6.2,23,14,9,60,3.4,14630,61,http://content9.flixster.com/movie/10/88/86/10888655_det.jpg
1520,The Ten Commandments,1956,7.3,29,26,3,89,0,4,2,2,50,3.6,11440,83,http://content9.flixster.com/movie/25/22/252211_det.jpg
1522,Ripe,1996,4,5,0,5,0,0,2,0,2,0,0,0,0,http://content6.flixster.com/movie/10/86/20/10862068_det.jpg
1523,"Truth or Consequences, N.M.",1997,4.5,14,5,9,35,0,2,0,2,0,3.1,880,51,http://content6.flixster.com/movie/28/30/283020_det.jpg
1525,Warriors of Virtue,1997,4,10,1,9,10,0,4,0,4,0,2.9,927,45,http://content8.flixster.com/movie/26/48/264814_det.jpg
1526,Fathers' Day,1997,4,31,6,25,19,4.8,6,2,4,33,2.5,2603,31,http://content8.flixster.com/movie/24/53/74/2453742_det.jpg
1527,The Fifth Element,1997,6.3,53,38,15,71,5.2,10,4,6,40,3.7,84664,84,http://content7.flixster.com/movie/10/94/16/10941677_det.jpg
1528,Intimate Relations,1996,5.2,7,1,6,14,0,3,0,3,0,3.6,31,64,http://content7.flixster.com/movie/10/86/21/10862101_det.jpg
1529,Nirgendwo in Afrika,2001,7.5,97,83,14,85,7.6,30,25,5,83,4,1773,88,http://content6.flixster.com/movie/10/93/76/10937636_det.jpg
1531,Losing Chase,1996,0,4,2,2,50,0,0,0,0,0,0,0,0,http://content7.flixster.com/movie/63/53/00/6353009_det.jpg
1532,Sprung,1997,4.2,9,2,7,22,0,4,0,4,0,3.5,343,70,http://content8.flixster.com/movie/27/92/279222_det.jpg
1533,La promesse,1996,7.7,19,18,1,94,7.7,8,8,0,100,3.9,599,85,http://content9.flixster.com/movie/30/43/304311_det.jpg
1534,Le bonheur,1965,0,2,2,0,100,0,0,0,0,0,0,0,0,http://content6.flixster.com/movie/97/65/46/9765468_det.jpg
1535,Love! Valour! Compassion!,1997,6.1,20,13,7,65,6.5,7,5,2,71,3.6,899,70,http://content6.flixster.com/movie/27/23/272396_det.jpg
1537,Shall we dansu?,1996,7.9,33,30,3,90,7.6,5,4,1,80,3.9,2687,86,http://content9.flixster.com/movie/10/91/66/10916667_det.jpg
1538,The Second Jungle Book: Mowgli & Baloo,1997,0,0,0,0,0,0,0,0,0,0,0,0,0,http://content6.flixster.com/movie/90/13/91/9013916_det.jpg
1539,Twin Town,1997,5.4,13,6,7,46,0,4,1,3,25,4.2,2298,90,http://content8.flixster.com/movie/94/77/97/9477974_det.jpg
1541,Addicted to Love,1997,5.6,30,17,13,56,6,5,3,2,60,2.8,4654,50,http://content9.flixster.com/movie/10/93/23/10932379_det.jpg
1542,Brassed Off,1996,6.6,28,22,6,78,6.4,6,4,2,66,3.5,2625,68,http://content7.flixster.com/movie/10/88/35/10883553_det.jpg
1543,The Designated Mourner,1997,6.2,16,11,5,68,6.6,5,4,1,80,3.6,50,71,http://content9.flixster.com/movie/10/84/43/10844303_det.jpg
1544,The Lost World: Jurassic Park,1997,5.6,59,29,30,49,5.1,13,6,7,46,3.2,46513,55,http://content9.flixster.com/movie/10/84/11/10841191_det.jpg
1545,Ponette,1996,8.1,21,19,2,90,0,3,3,0,100,4.1,956,89,http://content9.flixster.com/movie/29/57/295707_det.jpg
1546,Schizopolis,1996,6.5,16,10,6,62,0,3,1,2,33,3.8,1164,79,http://content6.flixster.com/movie/10/93/41/10934148_det.jpg
1547,Saving Shiloh,2006,5.1,21,8,13,38,5.8,10,5,5,50,3.9,511,82,http://content7.flixster.com/movie/58/00/78/5800789_det.jpg
1548,The War at Home,2005,\N,\N,\N,\N,\N,\N,\N,\N,\N,\N,\N,\N,\N,\N
1549,Rough Magic,1995,4.6,7,1,6,14,0,3,0,3,0,2.9,455,34,http://content9.flixster.com/movie/26/66/266691_det.jpg
1550,Trial and Error,1997,5,29,12,17,41,7,6,3,3,50,2.7,602,27,http://content6.flixster.com/movie/26/36/263612_det.jpg
1551,Buddy,1997,5.4,19,5,14,26,6.2,6,2,4,33,2.8,1106,37,http://content6.flixster.com/movie/26/42/264224_det.jpg
1552,Con Air,1997,5.7,60,34,26,56,4.9,11,3,8,27,3.4,47142,77,http://content9.flixster.com/movie/59/50/55/5950555_det.jpg
1554,The Pillow Book,1996,6.7,26,20,6,76,0,3,3,0,100,3.8,4178,78,http://content9.flixster.com/movie/29/25/292599_det.jpg
1555,En avoir (ou pas),1995,\N,\N,\N,\N,\N,\N,\N,\N,\N,\N,\N,\N,\N,\N
1556,Speed 2: Cruise Control,1997,3.1,51,1,50,1,3.2,14,1,13,7,2.2,17521,28,http://content8.flixster.com/movie/26/58/265830_det.jpg
1558,Sudden Manhattan,1996,5.6,6,4,2,66,0,0,0,0,0,0,0,0,http://content6.flixster.com/movie/10/84/93/10849332_det.jpg
1561,Wedding Bell Blues,1996,4,5,2,3,40,0,1,0,1,0,3.3,287,54,http://content7.flixster.com/movie/28/16/281613_det.jpg
1562,Batman & Robin,1997,0,1,1,0,100,0,0,0,0,0,0,0,0,http://content7.flixster.com/movie/11/13/50/11135017_det.jpg
1563,Dream with the Fishes,1997,6.1,19,11,8,57,0,3,2,1,66,3.7,452,79,http://content9.flixster.com/movie/28/09/280911_det.jpg
1564,Roseanna's Grave,1997,5.8,7,3,4,42,0,4,2,2,50,3.6,557,73,http://content6.flixster.com/movie/10/86/08/10860840_det.jpg
1565,Head Above Water,1996,0,0,0,0,0,0,0,0,0,0,0,0,0,http://content8.flixster.com/movie/10/86/75/10867562_det.jpg
1566,Hercules,1997,7,49,41,8,83,6.8,13,10,3,76,3.2,23787,68,http://content6.flixster.com/movie/25/25/252524_det.jpg
1567,The Last Time I Committed Suicide,1997,0,3,1,2,33,0,0,0,0,0,0,0,0,http://content8.flixster.com/movie/10/89/67/10896710_det.jpg
1568,"Murder Me, Murder You",1983,\N,\N,\N,\N,\N,\N,\N,\N,\N,\N,\N,\N,\N,\N
1569,My Best Friend's Wedding,1997,6.5,54,39,15,72,5.9,17,10,7,58,3.3,64013,72,http://content7.flixster.com/movie/55/35/54/5535541_det.jpg
1570,Tetsuo II: Body Hammer,1992,0,3,2,1,66,0,1,1,0,100,3.4,1154,61,http://content9.flixster.com/movie/10/89/35/10893579_det.jpg
1571,Chacun cherche son chat,1996,7.3,16,14,2,87,0,3,3,0,100,3.8,726,76,http://content7.flixster.com/movie/10/88/92/10889261_det.jpg
1572,Le mépris,1963,8.4,35,33,2,94,8.1,8,7,1,87,4.1,3449,86,http://content6.flixster.com/movie/10/93/40/10934024_det.jpg
1573,Face/Off,1997,7.9,60,56,4,93,8.4,15,15,0,100,3.5,62348,81,http://content8.flixster.com/movie/10/85/08/10850854_det.jpg
1574,The Fall,2006,6.2,101,60,41,59,5.8,21,9,12,42,3.8,23397,85,http://content9.flixster.com/movie/10/87/50/10875031_det.jpg
1575,Gabbeh,1996,7.1,19,17,2,89,7.9,8,8,0,100,3.7,394,73,http://content7.flixster.com/movie/30/24/302493_det.jpg
1580,Men in Black,1997,7.5,67,61,6,91,7.3,19,16,3,84,3.5,73637,73,http://content7.flixster.com/movie/83/03/830325_det.jpg
1581,Out to Sea,1997,5.3,20,7,13,35,0,4,1,3,25,3,1331,53,http://content6.flixster.com/movie/25/89/258996_det.jpg
1582,Wild America,1997,4.5,18,3,15,16,4.9,5,0,5,0,2.9,3839,58,http://content9.flixster.com/movie/10/94/53/10945391_det.jpg
1583,A Simple Wish,1997,4.6,15,4,11,26,0,3,0,3,0,2.7,4830,40,http://content6.flixster.com/movie/26/50/265012_det.jpg
1584,Contact,1997,6.8,55,37,18,67,6.5,13,7,6,53,3.1,19572,74,http://content9.flixster.com/movie/25/44/254411_det.jpg
1585,Love Serenade,1996,6.9,9,8,1,88,0,4,3,1,75,3.6,297,75,http://content7.flixster.com/movie/28/20/282097_det.jpg
1586,G.I. Jane,1997,6,29,16,13,55,6.4,6,3,3,50,3,11537,58,http://content8.flixster.com/movie/62/99/46/6299466_det.jpg
1587,Conan the Barbarian,1982,6.4,25,19,6,76,0,3,2,1,66,3.1,17014,66,http://content8.flixster.com/movie/28/20/282010_det.jpg
1588,George of the Jungle,1997,5.3,50,27,23,54,6.2,14,10,4,71,2.9,21989,47,http://content9.flixster.com/movie/25/63/256399_det.jpg
1589,Cop Land,1997,6.5,59,42,17,71,6.1,18,13,5,72,3.1,8531,57,http://content6.flixster.com/movie/28/35/283596_det.jpg
1590,Event Horizon,1997,4.3,33,7,26,21,5.2,5,1,4,20,3.2,15014,63,http://content6.flixster.com/movie/26/93/269324_det.jpg
1591,Spawn,1997,4,40,8,32,20,4.2,9,2,7,22,2.8,18405,46,http://content8.flixster.com/movie/27/19/271926_det.jpg
1592,Air Bud,1997,4.9,20,9,11,45,0,4,2,2,50,2.6,11606,42,http://content8.flixster.com/movie/25/88/258894_det.jpg
1593,Picture Perfect,1997,5.4,40,19,21,47,5.2,9,3,6,33,2.7,4981,41,http://content9.flixster.com/movie/26/12/261223_det.jpg
1594,In the Company of Men,1997,7.9,53,47,6,88,7.9,13,12,1,92,3.7,1900,80,http://content9.flixster.com/movie/10/86/14/10861495_det.jpg
1595,Free Willy 3: The Rescue,1997,4.7,15,6,9,40,0,2,2,0,100,2.8,7843,51,http://content6.flixster.com/movie/31/21/312112_det.jpg
1596,Career Girls,1997,7.1,23,20,3,86,8.4,5,5,0,100,3.6,812,75,http://content7.flixster.com/movie/27/82/278213_det.jpg
1597,Conspiracy Theory,1997,6.2,41,21,20,51,6.1,14,6,8,42,3.2,14632,66,http://content8.flixster.com/movie/10/88/46/10884674_det.jpg
1598,Desperate Measures,1998,4.1,29,5,24,17,3.8,6,0,6,0,2.9,1973,39,http://content6.flixster.com/movie/27/79/277912_det.jpg
1599,Steel Magnolias,1989,5.8,18,12,6,66,0,1,1,0,100,3.6,26167,88,http://content7.flixster.com/movie/10/93/46/10934665_det.jpg
1600,She's So Lovely,1997,6,41,26,15,63,6.9,7,6,1,85,3.2,1353,56,http://content6.flixster.com/movie/10/88/14/10881400_det.jpg
1601,Hoodlum,1997,5.5,19,8,11,42,7.2,6,5,1,83,3.3,2875,63,http://content9.flixster.com/movie/27/53/275303_det.jpg
1602,Leave It to Beaver,1997,4,27,5,22,18,4.4,10,2,8,20,2.6,1310,35,http://content8.flixster.com/movie/26/58/265814_det.jpg
1603,Mimic,1997,6.3,30,17,13,56,6.3,6,3,3,50,2.7,5478,37,http://content9.flixster.com/movie/55/37/43/5537439_det.jpg
1604,Money Talks,1997,\N,\N,\N,\N,\N,\N,\N,\N,\N,\N,\N,\N,\N,\N
1605,Excess Baggage,1997,4.5,30,10,20,33,4.7,5,1,4,20,2.5,3231,37,http://content9.flixster.com/movie/26/36/263699_det.jpg
1606,Kull the Conqueror,1997,3.6,19,5,14,26,0,4,0,4,0,2.6,1819,35,http://content6.flixster.com/movie/10/93/54/10935432_det.jpg
1608,Air Force One,1997,7,50,39,11,78,7.1,18,15,3,83,3.2,26434,62,http://content8.flixster.com/movie/11/14/67/11146758_det.jpg
1609,One Eight Seven,1997,5.2,27,8,19,29,5.4,5,1,4,20,3.3,3318,68,http://content6.flixster.com/movie/27/35/273524_det.jpg
1610,The Hunt for Red October,1990,7.8,42,40,2,95,0,4,3,1,75,3.6,18875,84,http://content9.flixster.com/movie/26/27/262727_det.jpg
1611,My Own Private Idaho,1991,7,32,27,5,84,8.7,6,6,0,100,3.6,8810,79,http://content9.flixster.com/movie/10/93/52/10935275_det.jpg
1612,"Kiss Me, Guido",1997,5.4,15,6,9,40,5.8,5,1,4,20,3.1,439,53,http://content9.flixster.com/movie/28/21/282199_det.jpg
1613,Star Maps,1997,5,15,5,10,33,0,4,0,4,0,3.1,60,44,http://content9.flixster.com/movie/10/85/19/10851963_det.jpg
1614,In & Out,1997,6.9,28,20,8,71,8,5,5,0,100,2.9,4273,47,http://content7.flixster.com/movie/25/58/255829_det.jpg
1615,The Edge,1997,6.3,46,27,19,58,6.4,11,6,5,54,3.2,5719,67,http://content8.flixster.com/movie/26/94/269418_det.jpg
1616,The Peacemaker,1997,6,31,13,18,41,5.4,6,0,6,0,2.8,6439,41,http://content8.flixster.com/movie/10/88/49/10884906_det.jpg
1617,L.A. Confidential,1997,8.6,83,82,1,98,8.1,21,20,1,95,3.7,25453,90,http://content7.flixster.com/movie/10/89/54/10895493_det.jpg
1619,Seven Years in Tibet,1997,6.3,32,19,13,59,6.2,5,2,3,40,3.4,13241,71,http://content7.flixster.com/movie/23/12/92/2312921_det.jpg
1620,Kiss the Girls,1997,5.4,28,9,19,32,5.4,6,2,4,33,3.3,9940,68,http://content9.flixster.com/movie/26/95/269591_det.jpg
1621,Soul Food,1997,6.3,41,33,8,80,6.4,13,10,3,76,3.6,3884,85,http://content9.flixster.com/movie/10/88/06/10880611_det.jpg
1622,Kicked in the Head,1997,4.1,9,1,8,11,0,4,0,4,0,3.1,226,45,http://content8.flixster.com/movie/10/88/44/10884494_det.jpg
1623,Wishmaster,1997,3.4,27,6,21,22,2.9,5,1,4,20,2.8,3480,48,http://content7.flixster.com/movie/28/32/283225_det.jpg
1624,A Thousand Acres,1997,4.3,47,11,36,23,3.7,14,1,13,7,3,932,40,http://content9.flixster.com/movie/10/88/70/10887047_det.jpg
1625,The Game,1997,7.2,43,30,13,69,7.2,11,7,4,63,3.5,23139,82,http://content9.flixster.com/movie/28/04/280403_det.jpg
1626,Fire Down Below,1997,3.3,26,3,23,11,3.3,7,1,6,14,2.6,3327,48,http://content9.flixster.com/movie/27/36/273603_det.jpg
1627,U Turn,1997,6.1,48,28,20,58,5.2,13,6,7,46,3.1,5988,59,http://content7.flixster.com/movie/27/09/270905_det.jpg
1628,The Day of the Locust,1975,6.8,8,5,3,62,0,1,1,0,100,3.6,582,75,http://content9.flixster.com/movie/27/77/277703_det.jpg
1629,The MatchMaker,1997,5.6,26,14,12,53,0,4,2,2,50,3.3,1220,66,http://content9.flixster.com/movie/28/03/280315_det.jpg
1631,The Assignment,1997,5.8,19,11,8,57,6.2,5,3,2,60,3.3,825,60,http://content8.flixster.com/movie/27/70/277094_det.jpg
1632,A Smile Like Yours,1997,0,0,0,0,0,0,0,0,0,0,0,0,0,http://content9.flixster.com/movie/10/84/78/10847859_det.jpg
1633,Ulee's Gold,1997,8,48,45,3,93,7.9,13,12,1,92,3.4,607,67,http://content6.flixster.com/movie/27/81/278192_det.jpg
1635,The Ice Storm,1997,7.6,56,46,10,82,7.3,13,10,3,76,3.6,7329,80,http://content7.flixster.com/movie/27/07/270713_det.jpg
1636,Stag,1997,4.4,5,2,3,40,0,0,0,0,0,0,0,0,http://content7.flixster.com/movie/19/57/46/1957461_det.jpg
1639,Chasing Amy,1997,7.5,66,60,6,90,7.4,22,20,2,90,3.5,27129,81,http://content7.flixster.com/movie/26/82/268201_det.jpg
1640,How to Be a Player,1997,3,7,1,6,14,0,1,0,1,0,3.4,1335,74,http://content8.flixster.com/movie/31/09/310922_det.jpg
1641,The Full Monty,1997,7.6,41,39,2,95,7.6,7,7,0,100,3.3,12102,73,http://content7.flixster.com/movie/26/91/269101_det.jpg
1642,Indian Summer,1996,6.7,6,5,1,83,0,2,2,0,100,3.2,492,45,http://content7.flixster.com/movie/10/70/10/10701045_det.jpg
1643,Mrs Brown,1997,7.3,39,36,3,92,7.6,8,7,1,87,3.7,2021,76,http://content6.flixster.com/movie/25/66/256624_det.jpg
1644,I Know What You Did Last Summer,1997,5.3,39,14,25,35,5.7,11,5,6,45,2.8,30659,49,http://content8.flixster.com/movie/10/86/89/10868922_det.jpg
1645,The Devil's Advocate,1997,6.2,43,28,15,65,5.8,10,4,6,40,3.4,30966,78,http://content6.flixster.com/movie/83/07/830796_det.jpg
1646,RocketMan,1997,3.9,15,4,11,26,5.7,5,2,3,40,3,3486,69,http://content7.flixster.com/movie/28/06/10/2806109_det.jpg
1647,Playing God,1997,4.1,28,4,24,14,4.7,7,2,5,28,2.9,2458,39,http://content9.flixster.com/movie/10/46/52/10465263_det.jpg
1648,The House of Yes,1997,5.9,35,22,13,62,6.3,8,5,3,62,3.7,1730,78,http://content9.flixster.com/movie/27/35/273507_det.jpg
1649,"Fast, Cheap & Out of Control",1997,8.1,29,27,2,93,0,3,3,0,100,3.9,980,82,http://content7.flixster.com/movie/10/91/62/10916277_det.jpg
1650,Washington Square,1997,7.2,27,22,5,81,7.6,6,4,2,66,3.4,579,58,http://content7.flixster.com/movie/10/93/23/10932321_det.jpg
1651,Telling Lies in America,1997,6.1,14,9,5,64,5.8,6,2,4,33,3,603,40,http://content9.flixster.com/movie/26/46/264615_det.jpg
1652,Year of the Horse,1997,5.7,23,12,11,52,5.4,8,5,3,62,3.7,36,82,http://content9.flixster.com/movie/10/97/92/10979203_det.jpg
1653,Gattaca,1997,7.1,55,45,10,81,6.1,11,6,5,54,3.5,36666,82,http://content9.flixster.com/movie/25/53/255319_det.jpg
1654,FairyTale: A True Story,1997,6.2,21,11,10,52,6.7,6,3,3,50,3.3,1880,63,http://content9.flixster.com/movie/10/90/50/10905063_det.jpg
1655,The Phantom of the Opera,2004,5,165,54,111,32,4.6,37,10,27,27,3.7,70849,86,http://content9.flixster.com/movie/35/84/18/3584187_det.jpg
1656,Swept from the Sea,1997,5.6,16,5,11,31,5,5,0,5,0,3.7,742,73,http://content8.flixster.com/movie/26/03/260322_det.jpg
1657,Wonderland,2003,5,98,34,64,34,4.5,32,7,25,21,3.3,3666,67,http://content7.flixster.com/movie/26/94/269429_det.jpg
1658,A Life Less Ordinary,1997,5.5,35,14,21,40,4.3,7,1,6,14,3.1,9301,57,http://content8.flixster.com/movie/38/48/02/3848022_det.jpg
1659,The Hurricane,1999,7,112,93,19,83,7.3,31,29,2,93,3.7,10473,84,http://content8.flixster.com/movie/10/93/94/10939402_det.jpg
1660,Eve's Bayou,1997,7.5,50,40,10,80,7.9,14,12,2,85,3.9,1799,87,http://content6.flixster.com/movie/10/88/76/10887660_det.jpg
1661,Switchback,1997,4.8,25,8,17,32,4.2,6,1,5,16,3,1273,45,http://content6.flixster.com/movie/27/62/276212_det.jpg
1662,Gang Related,1997,5.6,15,9,6,60,0,3,1,2,33,3.6,1924,73,http://content9.flixster.com/movie/27/56/275627_det.jpg
1663,Stripes,1981,6.6,33,29,4,87,0,4,3,1,75,0,0,0,http://content9.flixster.com/movie/27/68/276891_det.jpg
1665,Bean,1997,5.3,30,12,18,40,5.9,8,3,5,37,2.9,16961,56,http://content6.flixster.com/movie/26/58/265816_det.jpg
1666,Hugo Pool,1997,3.4,8,1,7,12,0,3,1,2,33,3,956,43,http://content8.flixster.com/movie/11/13/80/11138030_det.jpg
1667,Mad City,1997,5.3,27,10,17,37,4.9,6,1,5,16,2.9,2188,42,http://content6.flixster.com/movie/10/84/05/10840580_det.jpg
1668,One Night Stand,1997,5,28,8,20,28,6.1,7,3,4,42,2.9,964,43,http://content8.flixster.com/movie/11/13/59/11135922_det.jpg
1669,The Tango Lesson,1997,6,18,10,8,55,0,4,2,2,50,3.7,1178,73,http://content9.flixster.com/movie/10/92/62/10926247_det.jpg
1670,Welcome to Sarajevo,1997,6.9,25,19,6,76,7.6,5,4,1,80,3.5,985,75,http://content7.flixster.com/movie/10/90/11/10901161_det.jpg
1671,Deceiver,1997,5.4,26,12,14,46,6,7,4,3,57,3.2,586,53,http://content7.flixster.com/movie/28/12/281297_det.jpg
1672,The Rainmaker,1997,6.9,44,37,7,84,7,11,9,2,81,3.3,5792,70,http://content8.flixster.com/movie/10/83/79/10837982_det.jpg
1673,Boogie Nights,1997,8.1,64,59,5,92,8.8,11,11,0,100,3.5,22528,84,http://content9.flixster.com/movie/10/93/70/10937063_det.jpg
1674,Witness,1985,8.1,31,29,2,93,0,3,2,1,66,3.5,7634,76,http://content9.flixster.com/movie/27/34/273491_det.jpg
1675,Incognito,1997,5.1,9,3,6,33,0,0,0,0,0,0,0,0,http://content7.flixster.com/movie/10/88/05/10880553_det.jpg
1676,Starship Troopers,1997,6,55,33,22,60,6.3,14,8,6,57,3,24350,67,http://content9.flixster.com/movie/27/11/271119_det.jpg
1677,Critical Care,1997,6.3,15,8,7,53,7.2,9,7,2,77,2.8,392,28,http://content6.flixster.com/movie/28/05/280504_det.jpg
1678,The Joy Luck Club,1993,6.9,31,26,5,83,6.9,7,5,2,71,3.7,4795,87,http://content9.flixster.com/movie/10/90/37/10903727_det.jpg
1679,Chairman of the Board,1998,2.4,7,1,6,14,0,0,0,0,0,0,0,0,http://content8.flixster.com/movie/10/88/59/10885922_det.jpg
1680,Sliding Doors,1998,6.3,49,31,18,63,5.9,12,4,8,33,3.4,13328,74,http://content7.flixster.com/movie/10/87/38/10873849_det.jpg
1681,Mortal Kombat: Annihilation,1997,2.5,29,2,27,6,2.5,9,0,9,0,2.5,12426,36,http://content7.flixster.com/movie/52/53/89/5253893_det.png
1682,The Truman Show,1998,8.2,96,91,5,94,7.9,20,18,2,90,3.4,62890,82,http://content8.flixster.com/movie/11/12/69/11126926_det.jpg
1683,The Wings of the Dove,1997,7.8,28,24,4,85,9.1,7,7,0,100,3.7,1279,77,http://content9.flixster.com/movie/26/79/267919_det.jpg
1684,Mrs Dalloway,1997,6.4,26,16,10,61,7.3,6,5,1,83,3.3,497,59,http://content6.flixster.com/movie/26/63/266312_det.jpg
1685,"I Love You, I Love You Not",1996,5.4,5,2,3,40,0,0,0,0,0,0,0,0,http://content6.flixster.com/movie/10/89/38/10893844_det.jpg
1686,Red Corner,1997,5.1,22,7,15,31,5,6,1,5,16,3,1935,49,http://content6.flixster.com/movie/27/70/277016_det.jpg
1687,The Jackal,1997,4.2,25,3,22,12,0,4,0,4,0,3.1,12495,57,http://content9.flixster.com/movie/27/00/270015_det.jpg
1688,Anastasia,1997,7.1,48,41,7,85,7.1,9,7,2,77,3.2,33076,70,http://content8.flixster.com/movie/10/93/87/10938762_det.jpg
1689,The Man Who Knew Too Little,1997,5.4,30,12,18,40,4.9,6,2,4,33,3,4269,64,http://content9.flixster.com/movie/10/91/68/10916847_det.jpg
1690,Alien³,1992,5,39,15,24,38,5.8,7,4,3,57,3.1,30526,55,http://content9.flixster.com/movie/27/38/273891_det.jpg
1692,Alien Escape,1997,\N,\N,\N,\N,\N,\N,\N,\N,\N,\N,\N,\N,\N,\N
1693,Amistad,1997,6.9,57,44,13,77,6.6,10,6,4,60,3.5,9716,75,http://content6.flixster.com/movie/26/82/268208_det.jpg
1694,The Apostle,1997,8,44,40,4,90,8,10,9,1,90,3.6,2049,75,http://content8.flixster.com/movie/26/41/264198_det.jpg
1695,Artemisia,1997,6.3,22,14,8,63,6.4,6,4,2,66,3.4,390,67,http://content9.flixster.com/movie/27/47/274715_det.jpg
1696,Bent,1997,6.3,20,13,7,65,4.8,5,0,5,0,3.8,3465,79,http://content7.flixster.com/movie/27/12/271209_det.jpg
1698,Les Boys,1997,0,0,0,0,0,0,0,0,0,0,0,0,0,http://content9.flixster.com/movie/29/00/290011_det.jpg
1699,The Butcher Boy,1997,7.5,58,46,12,79,7.8,13,11,2,84,3.7,1377,81,http://content9.flixster.com/movie/27/01/81/2701819_det.jpg
1701,Deconstructing Harry,1997,7.2,33,23,10,69,7.5,6,4,2,66,3.6,5564,79,http://content8.flixster.com/movie/27/09/270998_det.jpg
1702,Flubber,1997,3.7,29,5,24,17,4.3,6,1,5,16,2.8,23244,43,http://content7.flixster.com/movie/10/90/92/10909265_det.jpg
1703,For Richer or Poorer,1997,3.7,19,3,16,15,4.4,5,0,5,0,2.7,3367,47,http://content6.flixster.com/movie/25/83/258308_det.jpg
1704,Good Will Hunting,1997,8,69,67,2,97,7.9,16,16,0,100,3.9,63868,92,http://content6.flixster.com/movie/10/84/63/10846372_det.jpg
1707,Home Alone 3,1997,4.3,21,5,16,23,5,6,2,4,33,2.6,22853,42,http://content7.flixster.com/movie/25/99/259909_det.jpg
1708,Ill Gotten Gains,1997,0,0,0,0,0,0,0,0,0,0,0,0,0,http://content6.flixster.com/movie/10/84/69/10846920_det.jpg
1709,Legal Deceit,1997,\N,\N,\N,\N,\N,\N,\N,\N,\N,\N,\N,\N,\N,\N
1710,Man of Her Dreams,1997,0,0,0,0,0,0,0,0,0,0,0,0,0,http://content6.flixster.com/movie/10/88/32/10883228_det.jpg
1711,Midnight in the Garden of Good and Evil,1997,6.2,30,15,15,50,6.4,6,2,4,33,3.3,7144,65,http://content8.flixster.com/movie/26/74/267414_det.jpg
1713,Mousehunt,1997,5.3,28,12,16,42,4.8,7,1,6,14,2.8,9269,50,http://content9.flixster.com/movie/10/88/57/10885755_det.jpg
1714,Never Met Picasso,1996,0,0,0,0,0,0,0,0,0,0,0,0,0,http://content9.flixster.com/movie/10/84/99/10849911_det.jpg
1715,Office Killer,1997,3.2,16,2,14,12,0,3,0,3,0,3,371,44,http://content6.flixster.com/movie/27/94/279416_det.jpg
1716,"Other Voices, Other Rooms",1995,0,1,0,1,0,0,0,0,0,0,0,0,0,http://content9.flixster.com/movie/11/00/80/11008071_det.jpg
1717,Scream 2,1997,6.8,66,53,13,80,7.4,17,16,1,94,2.9,29170,54,http://content8.flixster.com/movie/46/00/460098_det.jpg
1719,The Sweet Hereafter,1997,8.8,52,52,0,100,8.6,16,16,0,100,4,3068,86,http://content7.flixster.com/movie/10/88/64/10886473_det.jpg
1720,Time Tracers,1997,\N,\N,\N,\N,\N,\N,\N,\N,\N,\N,\N,\N,\N,\N
1721,Titanic,1997,7.4,97,80,17,82,6.6,29,21,8,72,3.3,464576,68,http://content8.flixster.com/movie/16/90/53/1690530_det.jpg
1722,Tomorrow Never Dies,1997,5.9,55,30,25,54,4.8,12,4,8,33,3.1,19587,60,http://content6.flixster.com/movie/10/91/35/10913520_det.jpg
1723,Twisted,2004,2.9,132,2,130,1,3.2,36,0,36,0,2.8,2961,40,http://content6.flixster.com/movie/27/63/276304_det.jpg
1725,The Education of Little Tree,1997,6.3,16,10,6,62,6.5,5,2,3,40,3.6,544,70,http://content9.flixster.com/movie/10/89/69/10896995_det.jpg
1726,The Postman,1997,3.8,31,3,28,9,3,6,0,6,0,2.8,8147,51,http://content7.flixster.com/movie/26/92/269217_det.jpg
1727,The Horse Whisperer,1998,6.9,52,37,15,71,6.8,13,9,4,69,3.2,7903,71,http://content8.flixster.com/movie/10/87/81/10878142_det.jpg
1728,The Winter Guest,1997,6.5,24,15,9,62,7.2,5,3,2,60,3.6,994,69,http://content8.flixster.com/movie/27/10/271094_det.jpg
1729,Jackie Brown,1997,7.3,68,58,10,85,6.3,18,11,7,61,3.5,36248,78,http://content9.flixster.com/movie/10/93/45/10934571_det.jpg
1730,Kundun,1997,7.3,58,44,14,75,6.7,15,10,5,66,3.7,3355,77,http://content9.flixster.com/movie/25/61/256127_det.jpg
1731,Mr. Magoo,1997,2.3,26,1,25,3,2.3,8,0,8,0,2.3,2618,30,http://content8.flixster.com/movie/10/60/67/10606782_det.jpg
1732,The Big Lebowski,1998,7.1,74,58,16,78,6.1,13,8,5,61,4,82903,93,http://content6.flixster.com/movie/10/95/21/10952108_det.jpg
1733,Afterglow,1997,6.8,30,21,9,70,7.4,7,5,2,71,3,386,38,http://content7.flixster.com/movie/28/15/281593_det.jpg
1734,Ma vie en rose,1997,7.4,20,18,2,90,7.6,5,5,0,100,4.1,3051,88,http://content8.flixster.com/movie/10/12/04/10120494_det.jpg
1735,Great Expectations,1998,5.4,32,12,20,37,5.4,7,3,4,42,3.4,10607,76,http://content6.flixster.com/movie/26/88/268896_det.jpg
1739,3 Ninjas: High Noon at Mega Mountain,1998,0,4,0,4,0,0,1,0,1,0,2.5,7721,32,http://content8.flixster.com/movie/10/88/99/10889978_det.jpg
1740,Men of Means,1999,\N,\N,\N,\N,\N,\N,\N,\N,\N,\N,\N,\N,\N,\N
1742,Caught Up,1998,4.1,7,0,7,0,0,3,0,3,0,3.1,627,45,http://content6.flixster.com/movie/27/96/279600_det.jpg
1743,Arguing the World,1998,6.8,5,4,1,80,0,1,1,0,100,3.1,150,47,http://content9.flixster.com/movie/10/92/43/10924327_det.jpg
1744,Firestorm,1998,0,0,0,0,0,0,0,0,0,0,0,0,0,http://content8.flixster.com/movie/10/86/63/10866338_det.jpg
1746,Senseless,1998,3.4,14,1,13,7,0,3,0,3,0,2.8,1704,50,http://content8.flixster.com/movie/10/95/43/10954306_det.jpg
1747,Wag the Dog,1997,7.4,70,59,11,84,7.5,19,17,2,89,3.4,8216,72,http://content7.flixster.com/movie/26/87/268793_det.jpg
1748,Dark City,1998,0,2,0,2,0,0,0,0,0,0,0,0,0,http://content6.flixster.com/movie/10/90/16/10901660_det.jpg
1749,The Leading Man,1996,6.4,8,5,3,62,0,2,2,0,100,3.6,534,71,http://content7.flixster.com/movie/27/35/273509_det.jpg
1750,Star Kid,1997,5.3,12,4,8,33,0,3,1,2,33,2.5,863,32,http://content8.flixster.com/movie/26/54/265402_det.jpg
1752,A Hard Rain's Gonna Fall,2008,\N,\N,\N,\N,\N,\N,\N,\N,\N,\N,\N,\N,\N,\N
1753,Half Baked,1998,4.2,24,7,17,29,0,2,0,2,0,3.4,26499,82,http://content8.flixster.com/movie/27/77/277702_det.jpg
1754,Fallen,1998,5.3,54,22,32,40,5.1,13,5,8,38,3.4,9162,75,http://content7.flixster.com/movie/26/99/269917_det.jpg
1755,Shooting Fish,1997,5.8,28,16,12,57,5.2,5,1,4,20,3.5,1362,72,http://content8.flixster.com/movie/31/37/313798_det.jpg
1756,The Prophecy II,1998,4.7,6,2,4,33,0,0,0,0,0,0,0,0,http://content7.flixster.com/movie/12/28/76/1228765_det.jpg
1757,Duo luo tian shi,1995,7.9,19,18,1,94,0,4,4,0,100,4,4014,86,http://content8.flixster.com/movie/30/83/308306_det.jpg
1759,"O Que É Isso, Companheiro?",1997,6.2,15,8,7,53,6.2,5,2,3,40,3.5,524,70,http://content6.flixster.com/movie/10/92/03/10920376_det.jpg
1760,Spice World,1997,4.5,33,9,24,27,5.1,7,1,6,14,2.1,9540,39,http://content6.flixster.com/movie/10/86/70/10867012_det.jpg
1762,Deep Rising,1998,4.2,27,8,19,29,3.9,6,1,5,16,2.8,3617,42,http://content6.flixster.com/movie/63/25/98/6325980_det.jpg
1765,A Letter from Death Row,1998,0,0,0,0,0,0,0,0,0,0,0,0,0,http://content7.flixster.com/movie/10/88/60/10886093_det.jpg
1767,Music from Another Room,1998,5,6,2,4,33,0,0,0,0,0,0,0,0,http://content8.flixster.com/movie/25/98/259826_det.jpg
1769,The Replacement Killers,1998,5.4,31,12,19,38,6,6,3,3,50,3,4222,51,http://content9.flixster.com/movie/11/12/30/11123091_det.jpg
1770,B. Monkey,1998,5.6,16,10,6,62,0,3,1,2,33,3.1,1126,49,http://content6.flixster.com/movie/27/29/272908_det.jpg
1771,The Night Flier,1997,0,4,1,3,25,0,1,0,1,0,2.8,1507,37,http://content8.flixster.com/movie/11/12/39/11123974_det.jpg
1772,Blues Brothers 2000,1998,5.1,42,19,23,45,5.5,10,4,6,40,2.7,8002,42,http://content6.flixster.com/movie/10/87/73/10877388_det.jpg
1773,Tokyo Fist,1995,0,2,2,0,100,0,0,0,0,0,0,0,0,http://content8.flixster.com/movie/10/33/59/10335954_det.jpg
1774,Zardoz,1974,5.2,18,8,10,44,0,1,0,1,0,3.1,2696,51,http://content6.flixster.com/movie/26/95/269596_det.jpg
1776,Joy Ride,2001,6.6,111,82,29,73,6.7,29,23,6,79,3.1,9370,63,http://content7.flixster.com/movie/27/21/272109_det.jpg
1777,The Wedding Singer,1998,6.1,59,39,20,66,5.8,12,8,4,66,3.5,86088,76,http://content6.flixster.com/movie/10/87/41/10874148_det.jpg
1779,Sphere,1998,4,49,6,43,12,3.8,12,1,11,8,2.7,9112,38,http://content8.flixster.com/movie/25/90/259018_det.jpg
1780,Ayn Rand: A Sense of Life,1997,5.8,11,6,5,54,0,3,1,2,33,3.4,268,58,http://content8.flixster.com/movie/29/91/299198_det.jpg
1781,A Further Gesture,1997,0,4,3,1,75,0,0,0,0,0,0,0,0,http://images.rottentomatoescdn.com/images/defaults/poster_default.gif
1782,Little City,1997,0,3,1,2,33,0,0,0,0,0,0,0,0,http://content6.flixster.com/movie/27/51/275120_det.jpg
1783,Palmetto,1998,5.1,31,11,20,35,5.2,6,1,5,16,2.7,679,28,http://content6.flixster.com/movie/27/64/276420_det.jpg
1784,As Good as It Gets,1997,7.2,75,64,11,85,7.3,21,19,2,90,3.5,30872,81,http://content6.flixster.com/movie/55/35/60/5535608_det.jpg
1785,King of New York,1990,6,23,16,7,69,6.2,5,3,2,60,3.7,5329,77,http://content9.flixster.com/movie/10/92/96/10929695_det.jpg
1788,Men with Guns,1997,7.6,26,23,3,88,0,4,4,0,100,3.9,476,84,http://content8.flixster.com/movie/10/92/05/10920542_det.jpg
1789,The Sadness of Sex,1995,0,0,0,0,0,0,0,0,0,0,0,0,0,http://images.rottentomatoescdn.com/images/defaults/poster_default.gif
1791,Twilight,2008,5.5,196,98,98,50,5.9,36,20,16,55,4.1,256646,82,http://content9.flixster.com/movie/10/88/60/10886003_det.jpg
1792,U.S. Marshals,1998,4.9,30,8,22,26,5,7,1,6,14,3.2,12491,59,http://content7.flixster.com/movie/11/14/00/11140001_det.jpg
1793,Welcome to Woop Woop,1997,3.8,17,5,12,29,0,2,0,2,0,3.4,280,65,http://content7.flixster.com/movie/35/59/57/3559577_det.jpg
1794,Love and Death on Long Island,1997,8,35,31,4,88,8.3,6,6,0,100,3.2,643,54,http://content9.flixster.com/movie/10/87/51/10875171_det.jpg
1795,El callejón de los milagros,1995,0,0,0,0,0,0,0,0,0,0,0,0,0,http://content8.flixster.com/movie/30/95/309506_det.jpg
1796,In God's Hands,1998,2.9,6,0,6,0,0,0,0,0,0,0,0,0,http://content9.flixster.com/movie/26/01/260191_det.jpg
1797,Everest,1998,7.7,13,12,1,92,0,1,1,0,100,3.5,699,71,http://content6.flixster.com/movie/28/60/286012_det.jpg
1798,Hush,1998,3.4,37,4,33,10,3.2,8,0,8,0,2.9,1448,43,http://content9.flixster.com/movie/10/87/07/10870779_det.jpg
1799,Suicide Kings,1997,5.4,29,10,19,34,5.4,6,2,4,33,3.4,10831,72,http://content6.flixster.com/movie/28/08/280824_det.jpg
1801,The Man in the Iron Mask,1998,5.4,35,11,24,31,6.2,7,2,5,28,3.1,24313,60,http://content6.flixster.com/movie/10/89/35/10893580_det.jpg
1804,The Newton Boys,1998,6.3,36,22,14,61,5.7,8,3,5,37,2.9,1826,43,http://content7.flixster.com/movie/26/03/260393_det.jpg
1805,Where the Wild Things Are,2009,6.9,241,176,65,73,6.4,40,26,14,65,3.4,236581,59,http://content9.flixster.com/movie/11/15/18/11151851_det.jpg
1806,Paulie,1998,6.1,36,22,14,61,5.9,12,4,8,33,2.8,3810,51,http://content9.flixster.com/movie/10/87/27/10872727_det.jpg
1807,"A Cool, Dry Place",1998,5.5,13,7,6,53,0,1,0,1,0,3.2,848,54,http://content8.flixster.com/movie/25/89/258906_det.jpg
1809,Hana-bi,1997,8.2,18,17,1,94,0,2,2,0,100,4.3,3702,91,http://content8.flixster.com/movie/29/83/298330_det.jpg
1810,Primary Colors,1998,7.2,74,59,15,79,6.7,21,14,7,66,3,3209,55,http://content6.flixster.com/movie/10/87/54/10875476_det.jpg
1811,Niagara,1953,6.2,10,8,2,80,0,0,0,0,0,0,0,0,http://content6.flixster.com/movie/10/85/38/10853848_det.jpg
1812,Wide Awake,1998,4.9,29,12,17,41,4.6,7,2,5,28,3.3,1235,65,http://content6.flixster.com/movie/10/85/35/10853592_det.jpg
1814,A Price Above Rubies,1998,5.9,27,15,12,55,5.7,5,2,3,40,3.1,429,51,http://content6.flixster.com/movie/10/87/85/10878584_det.jpg
1815,East of Eden,1955,8.2,30,26,4,86,0,3,2,1,66,4,5957,90,http://content7.flixster.com/movie/10/93/17/10931781_det.jpg
1816,Two Girls and a Guy,1997,5.6,57,30,27,52,6.4,18,10,8,55,2.8,1292,42,http://content7.flixster.com/movie/27/64/276425_det.jpg
1817,No Looking Back,1998,5.3,21,8,13,38,5.4,5,1,4,20,3.5,561,66,http://content6.flixster.com/movie/28/15/281596_det.jpg
1819,Storefront Hitchcock,1998,7.5,8,7,1,87,0,0,0,0,0,0,0,0,http://content8.flixster.com/movie/10/89/08/10890838_det.jpg
1820,The Proposition,2005,7.3,123,107,16,86,7.4,31,27,4,87,3.6,20228,77,http://content6.flixster.com/movie/31/42/314204_det.jpg
1821,The Object of My Affection,1998,5.8,48,24,24,50,5.6,11,5,6,45,3,6363,54,http://content7.flixster.com/movie/27/37/273725_det.jpg
1822,Meet the Deedles,1998,2.4,26,1,25,3,3,5,0,5,0,2.6,1774,39,http://content9.flixster.com/movie/10/88/97/10889707_det.jpg
1824,Homegrown,1998,5.9,15,7,8,46,0,3,2,1,66,3,1031,47,http://content7.flixster.com/movie/27/28/272817_det.jpg
1825,The Players Club,1998,5,15,4,11,26,6.3,5,3,2,60,3.6,5665,82,http://content6.flixster.com/movie/10/88/93/10889372_det.jpg
1826,Barney's Great Adventure,1998,0,0,0,0,0,0,0,0,0,0,0,0,0,http://content9.flixster.com/movie/10/86/99/10869943_det.jpg
1827,Big,1988,7.9,52,50,2,96,6.8,5,4,1,80,3.4,33658,73,http://content9.flixster.com/movie/10/83/88/10838839_det.jpg
1829,Chinese Box,1997,6.4,21,13,8,61,6.6,5,3,2,60,3.3,700,57,http://content7.flixster.com/movie/28/39/283997_det.jpg
1831,Lost in Space,1998,4.6,46,12,34,26,5.3,8,2,6,25,2.5,8293,30,http://content8.flixster.com/movie/10/89/34/10893434_det.jpg
1832,Heaven's Burning,1997,0,3,1,2,33,0,1,0,1,0,2.9,633,30,http://content7.flixster.com/movie/27/91/279197_det.jpg
1833,Mercury Rising,1998,4.2,35,6,29,17,4.6,8,1,7,12,3,7388,49,http://content6.flixster.com/movie/10/89/22/10892240_det.jpg
1834,The Spanish Prisoner,1997,7.4,59,52,7,88,7.2,13,12,1,92,3.7,1863,80,http://content8.flixster.com/movie/10/91/35/10913514_det.jpg
1835,City of Angels,1998,0,0,0,0,0,0,0,0,0,0,0,0,0,http://content6.flixster.com/movie/10/85/10/10851036_det.jpg
1836,The Last Days of Disco,1998,6.3,51,34,17,66,7.4,11,9,2,81,3.2,1361,58,http://content6.flixster.com/movie/10/91/40/10914076_det.jpg
1837,The Odd Couple II,1998,4.4,27,6,21,22,4.1,7,0,7,0,3.1,1418,57,http://content9.flixster.com/movie/11/14/28/11142855_det.jpg
1839,My Giant,1998,4.8,26,5,21,19,4.5,6,0,6,0,2.6,1175,30,http://content8.flixster.com/movie/26/44/264422_det.jpg
1840,He Got Game,1998,6.9,60,48,12,80,6.8,18,14,4,77,3.6,8293,81,http://content8.flixster.com/movie/60/49/75/6049754_det.jpg
1841,The Gingerbread Man,1998,6.2,40,24,16,60,6.9,11,8,3,72,2.8,1101,27,http://content6.flixster.com/movie/11/14/76/11147696_det.jpg
1842,Illtown,1996,5.3,11,6,5,54,0,1,0,1,0,3.2,34,75,http://content9.flixster.com/movie/10/97/83/10978347_det.jpg
1843,Slappy and the Stinkers,1998,0,4,0,4,0,0,0,0,0,0,0,0,0,http://content7.flixster.com/movie/26/58/265805_det.jpg
1844,Carne trémula,1997,7.1,37,29,8,78,7.2,10,7,3,70,3.9,4009,86,http://content9.flixster.com/movie/27/12/271215_det.jpg
1845,Zero Effect,1998,6.7,38,25,13,65,6.2,5,2,3,40,3.5,1908,74,http://content7.flixster.com/movie/27/55/275597_det.jpg
1846,Nil by Mouth,1997,6.2,19,12,7,63,7.6,5,4,1,80,4,1783,88,http://content6.flixster.com/movie/27/84/278420_det.jpg
1848,The Borrowers,1997,6.6,24,17,7,70,7.5,7,6,1,85,2.8,4043,48,http://content7.flixster.com/movie/11/14/95/11149597_det.jpg
1849,Prince Valiant,1954,0,0,0,0,0,0,0,0,0,0,0,0,0,http://content9.flixster.com/movie/25/83/258391_det.jpg
1850,"I Love You, Don't Touch Me!",1997,5.4,10,4,6,40,0,1,1,0,100,3.1,352,44,http://content6.flixster.com/movie/10/85/09/10850912_det.jpg
1851,Leather Jacket Love Story,1997,0,3,1,2,33,0,0,0,0,0,0,0,0,http://content9.flixster.com/movie/28/90/289011_det.jpg
1853,An Alan Smithee Film: Burn Hollywood Burn,1997,2.8,36,3,33,8,2.7,6,1,5,16,2.2,601,21,http://content6.flixster.com/movie/10/91/09/10910948_det.jpg
1854,Kissing a Fool,1998,4.7,28,8,20,28,5.6,6,3,3,50,2.7,899,43,http://content7.flixster.com/movie/27/40/274009_det.jpg
1855,Krippendorf's Tribe,1998,3.5,36,5,31,13,3.8,7,1,6,14,2.4,910,21,http://content9.flixster.com/movie/26/40/264003_det.jpg
1856,Kurt & Courtney,1998,5.3,21,12,9,57,0,3,2,1,66,3.1,1391,48,http://content8.flixster.com/movie/27/15/271522_det.jpg
1857,The Real Blonde,1997,5.4,26,9,17,34,6.2,6,3,3,50,2.9,430,39,http://content8.flixster.com/movie/27/91/279102_det.jpg
1858,Yat goh hiu yan,1997,5.6,27,12,15,44,6,6,3,3,50,2.9,4726,52,http://content9.flixster.com/movie/11/14/69/11146999_det.jpg
1859,Ta'm e guilass,1997,7.3,30,25,5,83,7.6,10,9,1,90,4,1878,84,http://content9.flixster.com/movie/10/87/21/10872163_det.jpg
1860,Karakter,1997,7.3,25,23,2,92,7.9,6,6,0,100,4.1,754,89,http://content8.flixster.com/movie/27/98/279814_det.jpg
1861,Budbringeren,1997,7.4,15,14,1,93,0,4,4,0,100,0,0,0,http://content7.flixster.com/movie/10/48/44/10484425_det.jpg
1862,Species II,1998,3.2,31,3,28,9,0,2,0,2,0,2.3,3562,26,http://content7.flixster.com/movie/11/15/11/11151153_det.jpg
1863,Major League: Back to the Minors,1998,3,19,4,15,21,0,4,1,3,25,2.6,1952,31,http://content6.flixster.com/movie/25/94/259400_det.jpg
1864,Sour Grapes,1998,3.5,13,3,10,23,0,3,0,3,0,2.8,451,38,http://content9.flixster.com/movie/27/66/276627_det.jpg
1865,Wild Man Blues,1997,7.2,37,32,5,86,7.4,9,8,1,88,3.4,581,61,http://content9.flixster.com/movie/10/97/90/10979007_det.jpg
1866,The Big Hit,1998,5.1,39,16,23,41,6,10,5,5,50,3.1,4322,60,http://content8.flixster.com/movie/27/46/274626_det.jpg
1867,Tarzan and the Lost City,1998,2.2,18,1,17,5,2.2,5,0,5,0,2.6,985,35,http://content8.flixster.com/movie/11/14/23/11142390_det.jpg
1869,Black Dog,1998,3.1,19,2,17,10,0,3,0,3,0,3,3586,62,http://content8.flixster.com/movie/10/86/90/10869030_det.jpg
1870,"Dancer, Texas Pop. 81",1998,6.6,15,12,3,80,0,3,2,1,66,3.3,531,62,http://content6.flixster.com/movie/10/86/95/10869540_det.jpg
1871,Priyatel pokoynika,1997,6.7,12,8,4,66,0,3,3,0,100,0,0,0,http://content9.flixster.com/movie/10/86/82/10868255_det.jpg
1872,Slumdog Millionaire,2008,8.2,220,206,14,93,8.2,38,36,2,94,4,328969,90,http://content9.flixster.com/movie/10/86/47/10864783_det.jpg
1873,Les misérables,1998,6.9,41,31,10,75,6.6,11,6,5,54,3.6,7310,81,http://content9.flixster.com/movie/25/51/255107_det.jpg
1874,Still Breathing,1997,5.6,13,8,5,61,5.5,5,3,2,60,3.6,699,71,http://content6.flixster.com/movie/26/52/265224_det.jpg
1875,Clockwatchers,1997,6.9,24,20,4,83,6.6,5,4,1,80,3.2,947,56,http://content7.flixster.com/movie/26/35/263513_det.jpg
1876,Deep Impact,1998,5.7,51,24,27,47,5.9,6,2,4,33,2.9,28624,51,http://content8.flixster.com/movie/10/88/98/10889858_det.jpg
1877,Little Men,1997,4.6,7,1,6,14,0,3,0,3,0,3.5,85,63,http://content7.flixster.com/movie/10/55/44/10554493_det.gif
1878,Face/Off,1997,7.9,60,56,4,93,8.4,15,15,0,100,3.5,62348,81,http://content8.flixster.com/movie/10/85/08/10850854_det.jpg
1879,The Hanging Garden,1997,7.3,16,15,1,93,0,4,4,0,100,3.6,485,70,http://content8.flixster.com/movie/10/90/64/10906450_det.jpg
1880,Lawn Dogs,1997,6.5,18,13,5,72,0,4,1,3,25,3.8,1154,84,http://content7.flixster.com/movie/27/69/276997_det.jpg
1881,Quest for Camelot,1998,5.3,21,7,14,33,5.9,6,2,4,33,3.1,4041,62,http://content6.flixster.com/movie/10/91/52/10915264_det.jpg
1882,Godzilla,1998,4.7,59,15,44,25,5.7,9,3,6,33,2.6,17658,38,http://content9.flixster.com/movie/25/99/259919_det.jpg
1883,Bulworth,1998,7,61,46,15,75,7.6,10,8,2,80,3.1,3041,60,http://content6.flixster.com/movie/27/10/271016_det.jpg
1884,Fear and Loathing in Las Vegas,1998,5.8,45,21,24,46,4.1,6,0,6,0,3.9,75860,90,http://content6.flixster.com/movie/10/88/64/10886456_det.jpg
1885,The Opposite of Sex,1998,7.1,40,33,7,82,6.9,7,4,3,57,3.1,3268,57,http://content7.flixster.com/movie/27/31/273121_det.jpg
1886,I Got the Hook Up,1998,3,12,2,10,16,0,2,0,2,0,3.2,1133,68,http://content9.flixster.com/movie/10/88/71/10887139_det.jpg
1887,Almost Heroes,1998,2.3,21,3,18,14,0,3,0,3,0,2.9,4626,63,http://content8.flixster.com/movie/60/49/77/6049770_det.jpg
1888,Hope Floats,1998,4.9,31,7,24,22,4.8,7,0,7,0,3.3,12082,73,http://content6.flixster.com/movie/26/48/264824_det.jpg
1889,Insomnia,2002,7.7,166,153,13,92,7.8,33,31,2,93,3.2,18085,66,http://content6.flixster.com/movie/27/69/276996_det.jpg
1890,Little Boy Blue,1997,5,8,2,6,25,0,0,0,0,0,0,0,0,http://content9.flixster.com/movie/38/91/55/3891551_det.jpg
1891,Coyote Ugly,2000,3.9,94,20,74,21,3.6,27,5,22,18,3.2,65988,73,http://content7.flixster.com/movie/25/81/258105_det.jpg
1892,A Perfect Murder,1998,6.2,49,27,22,55,6.2,14,8,6,57,3.1,9130,52,http://content9.flixster.com/movie/10/91/93/10919303_det.gif
1893,Jenseits der Stille,1996,7.5,11,9,2,81,8,5,5,0,100,3.9,474,83,http://content7.flixster.com/movie/27/24/272409_det.jpg
1894,Six Days Seven Nights,1998,5.4,38,14,24,36,5.4,6,0,6,0,2.7,10008,41,http://content9.flixster.com/movie/10/87/45/10874539_det.jpg
1895,Can't Hardly Wait,1998,5.4,45,20,25,44,5.4,12,5,7,41,3.1,11719,60,http://content9.flixster.com/movie/25/65/256595_det.jpg
1896,Cousin Bette,1998,6,21,10,11,47,5.6,5,1,4,20,3,408,38,http://content8.flixster.com/movie/27/12/271294_det.jpg
1897,High Art,1998,6.8,42,30,12,71,7.2,7,4,3,57,3.7,2153,76,http://content7.flixster.com/movie/10/89/19/10891985_det.jpg
1898,The Land Girls,1998,6.7,17,11,6,64,6.1,7,2,5,28,3.3,693,54,http://content7.flixster.com/movie/15/52/22/1552225_det.jpg
1899,Passion in the Desert,1997,6.1,20,13,7,65,0,4,1,3,25,3.2,162,55,http://content7.flixster.com/movie/10/88/55/10885545_det.jpg
1900,Bacheha-Ye aseman,1997,7.6,25,21,4,84,7.6,5,4,1,80,4.4,3834,94,http://content6.flixster.com/movie/10/94/64/10946460_det.jpg
1901,Dear Jesse,1998,6.8,6,5,1,83,0,1,1,0,100,3.8,29,100,http://content8.flixster.com/movie/10/91/90/10919006_det.jpg
1902,Dream for an Insomniac,1996,5,10,5,5,50,0,2,0,2,0,3.6,1167,74,http://content6.flixster.com/movie/27/87/278704_det.jpg
1903,Hav Plenty,1997,5.2,21,8,13,38,6.6,6,4,2,66,3.9,465,80,http://content6.flixster.com/movie/27/22/272224_det.jpg
1904,Henry Fool,1997,7.4,26,22,4,84,0,3,2,1,66,3.8,1375,78,http://content8.flixster.com/movie/10/88/94/10889490_det.jpg
1906,Mr. Jealousy,1997,6.5,12,8,4,66,0,4,2,2,50,3.3,437,59,http://content7.flixster.com/movie/28/00/280097_det.jpg
1907,Mulan,1998,7.5,72,62,10,86,7,14,10,4,71,3.4,52938,78,http://content6.flixster.com/movie/11/14/84/11148476_det.jpg
1908,Resurrection Man,1998,0,3,0,3,0,0,0,0,0,0,0,0,0,http://content7.flixster.com/movie/10/92/14/10921409_det.jpg
1909,The X Files,1998,6,68,43,25,63,5.9,15,8,7,53,3.3,13283,69,http://content6.flixster.com/movie/25/49/254904_det.jpg
1910,I Went Down,1997,7.2,19,16,3,84,0,4,2,2,50,4.2,202,88,http://content6.flixster.com/movie/50/89/57/5089576_det.jpg
1911,Doctor Dolittle,1998,5.2,49,21,28,42,5.5,8,4,4,50,2.8,23847,46,http://content6.flixster.com/movie/11/15/12/11151232_det.jpg
1912,Out of Sight,1998,7.9,69,64,5,92,8,14,13,1,92,3.2,11285,65,http://content6.flixster.com/movie/10/88/64/10886428_det.jpg
1913,Picnic at Hanging Rock,1975,8.3,29,27,2,93,9.7,5,5,0,100,4,3210,84,http://content9.flixster.com/movie/25/96/259615_det.jpg
1914,Smoke Signals,1998,7.3,29,25,4,86,8.1,5,5,0,100,3.9,2767,83,http://content6.flixster.com/movie/25/44/254404_det.jpg
1915,Viagem ao Princípio do Mundo,1997,6.2,5,3,2,60,0,0,0,0,0,0,0,0,http://content9.flixster.com/movie/10/94/65/10946519_det.jpg
1916,Buffalo '66,1998,7,40,31,9,77,7.1,7,5,2,71,3.8,7504,87,http://content6.flixster.com/movie/10/87/71/10877180_det.jpg
1917,Armageddon,1998,5.1,77,32,45,41,3.8,17,3,14,17,3.5,105398,77,http://content7.flixster.com/movie/55/05/68/5505685_det.jpg
1918,Lethal Weapon 4,1998,5.9,61,33,28,54,6.1,12,6,6,50,3.3,20840,70,http://content7.flixster.com/movie/11/12/88/11128829_det.jpg
1919,Madeline,1998,6.5,26,17,9,65,6.5,6,4,2,66,2.6,3549,45,http://content7.flixster.com/movie/25/93/259317_det.jpg
1920,Small Soldiers,1998,6.2,41,19,22,46,6.8,12,6,6,50,2.8,9855,46,http://content6.flixster.com/movie/18/47/19/1847196_det.jpg
1921,Pi,1998,7.2,49,42,7,85,6.7,11,8,3,72,3.8,33850,86,http://content7.flixster.com/movie/26/78/267897_det.jpg
1922,What Ever Happened to Baby Jane?,1962,7.6,37,33,4,89,0,3,2,1,66,3.9,7128,89,http://content8.flixster.com/movie/10/93/55/10935590_det.jpg
1923,There's Something About Mary,1998,0,2,0,2,0,0,1,0,1,0,3.1,233,47,http://content7.flixster.com/movie/10/88/61/10886109_det.jpg
1924,Plan 9 from Outer Space,1958,4.9,30,19,11,63,0,1,1,0,100,2.8,6105,46,http://content8.flixster.com/movie/10/85/09/10850926_det.jpg
1925,Der Himmel über Berlin,1987,8.5,39,38,1,97,7.5,6,5,1,83,4.4,9110,94,http://content9.flixster.com/movie/25/46/254691_det.jpg
1926,The Broadway Melody,1929,5.4,16,6,10,37,0,4,2,2,50,2.9,515,31,http://content8.flixster.com/movie/11/12/95/11129594_det.jpg
1927,All Quiet on the Western Front,1930,8.6,32,31,1,96,7.8,5,5,0,100,3.8,3797,85,http://content6.flixster.com/movie/66/23/12/6623120_det.jpg
1928,Spirit: Stallion of the Cimarron,2002,6.4,125,86,39,68,6.9,29,23,6,79,3.3,8302,72,http://content9.flixster.com/movie/10/87/48/10874827_det.jpg
1929,Grand Hotel,1932,7.4,28,24,4,85,7.6,5,5,0,100,3.8,1661,77,http://content7.flixster.com/movie/29/63/296321_det.jpg
1930,Cavalcade,1933,6.7,14,9,5,64,0,4,4,0,100,3,314,35,http://content9.flixster.com/movie/10/88/00/10880031_det.jpg
1931,Mutiny on the Bounty,1935,8.2,28,26,2,92,7.5,6,5,1,83,3.7,1846,79,http://content9.flixster.com/movie/10/88/45/10884511_det.jpg
1932,The Great Ziegfeld,1936,6,21,12,9,57,6,5,3,2,60,3.4,704,60,http://content8.flixster.com/movie/30/32/303222_det.jpg
1933,The Life of Emile Zola,1937,7,20,14,6,70,7.2,5,4,1,80,3.6,620,72,http://content7.flixster.com/movie/10/84/90/10849013_det.jpg
1934,You Can't Take It with You,1938,7.3,27,26,1,96,0,4,4,0,100,4,2934,87,http://content7.flixster.com/movie/10/91/55/10915585_det.jpg
1935,How Green Was My Valley,1941,7.8,34,30,4,88,7.2,5,5,0,100,3.9,1995,83,http://content6.flixster.com/movie/30/92/309228_det.jpg
1936,Mrs. Miniver,1942,7.6,22,19,3,86,8.2,5,5,0,100,3.9,1307,85,http://content8.flixster.com/movie/10/08/01/10080150_det.jpg
1937,Going My Way,1944,7,19,14,5,73,0,4,3,1,75,3.8,1251,80,http://content6.flixster.com/movie/10/89/81/10898136_det.jpg
1938,The Lost Weekend,1945,8.2,24,24,0,100,0,4,4,0,100,4,2562,86,http://content9.flixster.com/movie/10/95/53/10955391_det.jpg
1939,The Best Years of Our Lives,1946,8.6,35,34,1,97,8.1,8,8,0,100,4.2,3330,91,http://content7.flixster.com/movie/10/17/14/10171413_det.jpg
1940,Gentleman's Agreement,1947,7,30,25,5,83,6.8,5,4,1,80,3.8,1308,79,http://content8.flixster.com/movie/30/79/307930_det.jpg
1941,Hamlet,1996,8.2,54,51,3,94,7.2,14,11,3,78,3.8,5816,86,http://content7.flixster.com/movie/10/94/26/10942625_det.jpg
1942,All the King's Men,2006,0,0,0,0,0,0,0,0,0,0,0,0,0,http://content6.flixster.com/movie/10/84/23/10842352_det.jpg
1943,The Greatest Show on Earth,1952,0,0,0,0,0,0,0,0,0,0,0,0,0,http://content6.flixster.com/movie/10/88/18/10881888_det.jpg
1944,From Here to Eternity,1953,8,40,35,5,87,7.9,7,6,1,85,3.9,4410,83,http://content9.flixster.com/movie/29/27/292711_det.jpg
1945,On the Waterfront,1954,9,49,49,0,100,8.9,10,10,0,100,4.2,11904,94,http://content9.flixster.com/movie/29/10/291015_det.jpg
1946,Back to the Future,1985,8.4,54,52,2,96,7.3,6,5,1,83,3.8,126816,88,http://content6.flixster.com/movie/31/17/311700_det.jpg
1947,West Side Story,1961,8.1,49,45,4,91,8,7,6,1,85,3.5,18648,82,http://content9.flixster.com/movie/10/91/74/10917475_det.jpg
1948,Tom Jones,1963,7.8,26,21,5,80,0,4,3,1,75,3.3,1389,60,http://content9.flixster.com/movie/29/03/290315_det.jpg
1949,A Man for All Seasons,1966,7.8,27,23,4,85,0,4,3,1,75,4,2887,86,http://content6.flixster.com/movie/25/08/250892_det.jpg
1950,In the Heat of the Night,1967,8.1,28,27,1,96,0,4,4,0,100,3.9,4274,90,http://content8.flixster.com/movie/25/71/257126_det.jpg
1951,Oliver!,1968,7.7,25,21,4,84,0,4,3,1,75,3.4,9490,72,http://content9.flixster.com/movie/11/15/34/11153479_det.jpg
1952,Midnight Cowboy,1969,8.3,49,44,5,89,6.8,6,5,1,83,3.9,8994,87,http://content6.flixster.com/movie/10/88/51/10885192_det.jpg
1953,The French Connection,1971,8.5,45,44,1,97,8.2,6,6,0,100,3.8,8751,86,http://content9.flixster.com/movie/10/93/21/10932163_det.jpg
1954,Rocky,1976,8.1,41,38,3,92,7.6,5,4,1,80,3.2,165793,65,http://content6.flixster.com/movie/10/89/83/10898396_det.jpg
1955,Kramer vs. Kramer,1979,7.9,34,30,4,88,7.4,6,5,1,83,3.7,9401,85,http://content8.flixster.com/movie/10/92/41/10924118_det.jpg
1956,Ordinary People,1980,7.9,32,29,3,90,7.5,6,5,1,83,3.8,5284,86,http://content8.flixster.com/movie/26/77/267722_det.jpg
1957,Chariots of Fire,1981,7.4,36,31,5,86,7.4,6,5,1,83,3.6,7456,77,http://content7.flixster.com/movie/10/93/45/10934597_det.jpg
1958,Terms of Endearment,1983,7.4,35,31,4,88,7.1,5,4,1,80,3.7,7594,82,http://content6.flixster.com/movie/26/77/267716_det.jpg
1959,Out of Africa,1985,6.2,32,20,12,62,6.5,6,4,2,66,3.7,10166,84,http://content9.flixster.com/movie/10/85/35/10853583_det.jpg
1960,The Last Emperor,1987,7.9,44,40,4,90,7.6,9,7,2,77,3.7,7466,86,http://content8.flixster.com/movie/10/53/54/10535418_det.jpg
1961,Rain Man,1988,7.6,54,47,7,87,4.5,7,2,5,28,3.8,42473,88,http://content6.flixster.com/movie/10/85/35/10853584_det.jpg
1962,Driving Miss Daisy,1989,7,41,32,9,78,7.9,8,8,0,100,3.4,7698,79,http://content6.flixster.com/movie/26/22/262224_det.jpg
1963,Take the Money and Run,1969,6.9,13,12,1,92,0,1,0,1,0,0,0,0,http://content9.flixster.com/movie/28/30/283091_det.jpg
1964,Klute,1971,8,27,26,1,96,0,3,2,1,66,3.7,1593,78,http://content6.flixster.com/movie/27/26/272620_det.jpg
1965,Repo Man,1984,7.9,37,36,1,97,0,4,4,0,100,3.4,5166,75,http://content8.flixster.com/movie/28/26/282606_det.jpg
1966,Metropolitan,1990,7.4,25,22,3,88,6.5,6,4,2,66,3.9,1143,83,http://content9.flixster.com/movie/10/88/49/10884911_det.jpg
1967,Labyrinth,1986,6,32,19,13,59,6.2,6,3,3,50,3.8,81222,85,http://content6.flixster.com/movie/10/84/45/10844548_det.jpg
1968,The Breakfast Club,1985,7.5,42,38,4,90,6.2,6,4,2,66,3.9,93109,90,http://content7.flixster.com/movie/68/89/80/6889801_det.jpg
1969,A Nightmare on Elm Street Part 2: Freddy's Revenge,1985,4.8,23,10,13,43,0,2,2,0,100,3,19841,55,http://content6.flixster.com/movie/10/95/40/10954016_det.jpg
1970,A Nightmare on Elm Street 3: Dream Warriors,1987,5.9,31,22,9,70,0,4,1,3,25,3.1,21954,68,http://content8.flixster.com/movie/10/95/40/10954014_det.jpg
1971,A Nightmare on Elm Street 4: The Dream Master,1988,5.3,25,14,11,56,0,4,2,2,50,3,19043,60,http://content6.flixster.com/movie/10/95/40/10954012_det.jpg
1972,A Nightmare on Elm Street: The Dream Child,1989,4.1,27,8,19,29,0,4,1,3,25,2.9,17837,56,http://content8.flixster.com/movie/10/95/40/10954010_det.jpg
1973,Freddy's Dead: The Final Nightmare,1991,3.9,25,5,20,20,0,4,3,1,75,3,12382,54,http://content8.flixster.com/movie/10/87/87/10878798_det.jpg
1974,Friday the 13th,1980,5.6,45,27,18,60,0,4,2,2,50,3.2,25534,66,http://content8.flixster.com/movie/10/87/23/10872306_det.jpg
1975,Friday the 13th Part 2,1981,4.4,30,10,20,33,0,1,0,1,0,3.1,13685,58,http://content6.flixster.com/movie/10/87/23/10872308_det.jpg
1976,Friday the 13th Part III,1982,3.5,22,3,19,13,0,0,0,0,0,0,0,0,http://content9.flixster.com/movie/10/87/23/10872307_det.jpg
1977,Friday the 13th: The Final Chapter,1984,4.3,21,5,16,23,0,0,0,0,0,0,0,0,http://content7.flixster.com/movie/10/87/23/10872321_det.jpg
1978,Friday the 13th: A New Beginning,1985,3.3,17,3,14,17,0,0,0,0,0,0,0,0,http://content8.flixster.com/movie/11/14/92/11149246_det.jpg
1979,Jason Lives: Friday the 13th Part VI,1986,5.1,24,13,11,54,0,0,0,0,0,0,0,0,http://content7.flixster.com/movie/11/14/92/11149245_det.jpg
1980,Friday the 13th Part VII: The New Blood,1988,4.5,16,4,12,25,0,0,0,0,0,0,0,0,http://content6.flixster.com/movie/11/14/92/11149248_det.jpg
1981,Friday the 13th Part VIII: Jason Takes Manhattan,1989,2.9,20,2,18,10,0,1,0,1,0,2.8,9749,45,http://content9.flixster.com/movie/11/14/92/11149247_det.jpg
1982,Halloween,2007,4.1,101,26,75,25,3.9,19,3,16,15,3.3,79946,64,http://content7.flixster.com/movie/10/92/20/10922093_det.jpg
1983,Halloween II,1981,4.3,30,8,22,26,4.4,5,1,4,20,3.3,16555,67,http://content9.flixster.com/movie/27/57/275791_det.jpg
1984,Halloween III: Season of the Witch,1982,4.2,15,5,10,33,0,2,1,1,50,2.2,7355,28,http://content7.flixster.com/movie/10/87/02/10870285_det.jpg
1985,Halloween 4: The Return of Michael Myers,1988,3.8,22,5,17,22,0,4,0,4,0,3.1,13190,61,http://content9.flixster.com/movie/28/53/285327_det.jpg
1986,Halloween 5,1989,3.6,21,3,18,14,0,2,1,1,50,3,11908,55,http://content9.flixster.com/movie/26/73/267307_det.jpg
1987,Prom Night,2008,2.8,60,5,55,8,2.4,9,1,8,11,3,51435,46,http://content9.flixster.com/movie/10/66/75/10667503_det.jpg
1988,Hello Mary Lou: Prom Night II,1987,4,8,3,5,37,0,0,0,0,0,0,0,0,http://content6.flixster.com/movie/20/86/04/2086048_det.jpg
1989,Prom Night III: The Last Kiss,1990,0,3,0,3,0,0,0,0,0,0,0,0,0,http://content8.flixster.com/movie/10/88/54/10885474_det.jpg
1990,Prom Night IV: Deliver Us from Evil,1992,2.1,5,0,5,0,0,0,0,0,0,0,0,0,http://content6.flixster.com/movie/10/89/46/10894616_det.jpg
1991,Bride of Chucky,1998,5.3,30,13,17,43,0,4,1,3,25,2.6,20874,52,http://content7.flixster.com/movie/27/67/276717_det.jpg
1992,Child's Play 2,1990,4.2,13,5,8,38,0,1,1,0,100,2.8,13499,52,http://content8.flixster.com/movie/27/38/273822_det.jpg
1993,Child's Play 3,1991,4.3,11,3,8,27,0,1,0,1,0,2.8,12064,47,http://content8.flixster.com/movie/27/49/274994_det.jpg
1994,Poltergeist,1982,7.1,49,42,7,85,0,4,3,1,75,3.4,15891,74,http://content7.flixster.com/movie/25/42/254297_det.jpg
1995,Poltergeist II: The Other Side,1986,4.7,17,7,10,41,0,1,0,1,0,0,0,0,http://content6.flixster.com/movie/10/88/23/10882352_det.jpg
1996,Poltergeist III,1988,3.6,14,2,12,14,0,0,0,0,0,0,0,0,http://content8.flixster.com/movie/10/86/93/10869346_det.jpg
1997,The Exorcist,1973,7.7,43,36,7,83,6.6,7,5,2,71,3.7,49968,83,http://content9.flixster.com/movie/28/02/280219_det.jpg
1998,Exorcist II: The Heretic,1977,3.6,17,4,13,23,0,0,0,0,0,0,0,0,http://content9.flixster.com/movie/27/11/271111_det.jpg
1999,The Exorcist III,1990,5.4,27,16,11,59,0,1,0,1,0,2.9,4879,55,http://content6.flixster.com/movie/11/15/20/11152092_det.jpg
2000,Lethal Weapon,1987,7.3,40,36,4,90,7.4,8,7,1,87,3.6,33975,81,http://content9.flixster.com/movie/11/12/88/11128835_det.jpg
2001,Lethal Weapon,1987,7.3,40,36,4,90,7.4,8,7,1,87,3.6,33975,81,http://content9.flixster.com/movie/11/12/88/11128835_det.jpg
2002,Lethal Weapon 3,1992,5.6,39,22,17,56,4.7,8,3,5,37,3.2,20151,68,http://content9.flixster.com/movie/11/12/88/11128831_det.jpg
2003,Gremlins,1984,6.8,41,32,9,78,5,5,2,3,40,3.4,31525,70,http://content9.flixster.com/movie/26/50/265023_det.jpg
2004,Gremlins 2: The New Batch,1990,6.4,34,22,12,64,6.4,6,4,2,66,3,18308,58,http://content8.flixster.com/movie/26/05/260594_det.jpg
2005,The Goonies,1985,5.9,39,25,14,64,0,3,2,1,66,3.8,89625,88,http://content7.flixster.com/movie/25/37/253701_det.jpg
2006,The Mask of Zorro,1998,7.1,66,54,12,81,6.5,13,10,3,76,3.3,31107,70,http://content8.flixster.com/movie/75/96/759614_det.jpg
2007,Polish Wedding,1998,4.9,35,15,20,42,5.5,9,4,5,44,3,896,51,http://content8.flixster.com/movie/26/41/264126_det.jpg
2008,"This World, Then the Fireworks",1997,3.7,5,1,4,20,0,0,0,0,0,0,0,0,http://content9.flixster.com/movie/70/62/75/7062759_det.jpg
2009,Soylent Green,1973,6,31,22,9,70,0,3,0,3,0,3.5,5747,71,http://content9.flixster.com/movie/25/44/254491_det.jpg
2010,Metropolis,1927,8.9,98,97,1,98,8.8,23,23,0,100,4.1,17640,90,http://content8.flixster.com/movie/10/93/38/10933866_det.jpg
2011,Back to the Future Part II,1989,6,40,26,14,65,4.2,6,2,4,33,3.5,73208,80,http://content7.flixster.com/movie/85/76/857629_det.jpg
2012,Back to the Future Part III,1990,6.3,38,27,11,71,5.5,7,3,4,42,3.4,66354,74,http://content8.flixster.com/movie/85/76/857602_det.jpg
2013,The Poseidon Adventure,1972,6.8,23,18,5,78,0,1,0,1,0,3.3,7876,72,http://content7.flixster.com/movie/25/66/256609_det.jpg
2014,Freaky Friday,2003,7,140,123,17,87,7,34,29,5,85,2.9,73112,60,http://content8.flixster.com/movie/55/05/69/5505698_det.jpg
2015,The AbsentMinded Professor,1961,7.2,20,16,4,80,0,2,2,0,100,3.2,1425,61,http://content9.flixster.com/movie/25/31/253123_det.jpg
2016,The Apple Dumpling Gang Rides Again,1979,0,3,0,3,0,0,0,0,0,0,0,0,0,http://content6.flixster.com/movie/25/15/251596_det.jpg
2017,Babes in Toyland,1934,8.4,12,12,0,100,0,2,2,0,100,3.6,865,78,http://content7.flixster.com/movie/29/10/291017_det.jpg
2018,Bambi,1942,8,38,34,4,89,0,4,4,0,100,3.4,39873,68,http://content9.flixster.com/movie/25/06/250691_det.jpg
2019,Shichinin no samurai,1954,9.2,49,49,0,100,8.6,10,10,0,100,4.5,29509,97,http://content7.flixster.com/movie/39/91/08/3991085_det.jpg
2020,Dangerous Liaisons,1988,7.7,27,25,2,92,6.5,6,5,1,83,3.7,11359,84,http://content6.flixster.com/movie/26/84/268496_det.jpg
2021,Dune,1984,6.1,26,16,10,61,0,2,0,2,0,3.4,17715,67,http://content7.flixster.com/movie/11/13/64/11136477_det.jpg
2022,The Last Temptation of Christ,1988,7.3,46,38,8,82,7.5,7,6,1,85,3.7,7365,83,http://content8.flixster.com/movie/27/03/270314_det.jpg
2023,The Godfather: Part III,1990,6.4,53,35,18,66,6.9,8,6,2,75,3.7,68556,79,http://content6.flixster.com/movie/11/12/76/11127688_det.jpg
2024,The Rapture,1991,6.5,24,16,8,66,0,2,1,1,50,3.2,627,61,http://content6.flixster.com/movie/10/36/23/10362392_det.jpg
2025,Lolita,1962,8,38,37,1,97,0,2,2,0,100,3.7,11593,80,http://content8.flixster.com/movie/30/09/300906_det.jpg
2026,Disturbing Behavior,1998,4.4,33,10,23,30,5.2,6,2,4,33,2.7,4794,43,http://content9.flixster.com/movie/10/91/75/10917563_det.jpg
2027,Jane Austen's Mafia!,1998,4,42,6,36,14,4.4,7,0,7,0,2.7,1995,47,http://content8.flixster.com/movie/10/56/10/10561030_det.jpg
2028,Saving Private Ryan,1998,8.2,92,84,8,91,8.1,19,17,2,89,4,139463,92,http://content8.flixster.com/movie/55/05/49/5505494_det.jpg
2029,Billy's Hollywood Screen Kiss,1998,6.5,20,13,7,65,0,4,0,4,0,3.4,686,59,http://content9.flixster.com/movie/27/45/274507_det.jpg
2030,Dong gong xi gong,1996,6.3,5,3,2,60,0,0,0,0,0,0,0,0,http://content7.flixster.com/movie/99/50/16/9950165_det.jpg
2031,The Million Dollar Duck,1971,3.5,5,0,5,0,0,1,0,1,0,0,0,0,http://content8.flixster.com/movie/25/17/251714_det.jpg
2032,The Barefoot Executive,1971,0,4,4,0,100,0,0,0,0,0,0,0,0,http://content7.flixster.com/movie/25/21/252113_det.jpg
2033,The Black Cauldron,1985,5.8,27,16,11,59,6.2,5,3,2,60,3.1,5461,53,http://content8.flixster.com/movie/25/63/256314_det.jpg
2034,The Black Hole,1979,5.1,26,11,15,42,0,3,2,1,66,3,2357,45,http://content7.flixster.com/movie/26/56/265625_det.jpg
2035,Blackbeard's Ghost,1968,5.6,9,7,2,77,0,1,1,0,100,3.3,1038,69,http://content8.flixster.com/movie/25/12/251298_det.jpg
2036,Blank Check,1994,2.6,7,1,6,14,0,0,0,0,0,0,0,0,http://content6.flixster.com/movie/26/16/261604_det.jpg
2037,Candleshoe,1977,0,1,1,0,100,0,0,0,0,0,0,0,0,http://content9.flixster.com/movie/31/06/310619_det.jpg
2038,The Cat from Outer Space,1978,0,4,1,3,25,0,0,0,0,0,0,0,0,http://content6.flixster.com/movie/25/35/253516_det.jpg
2039,Cheetah,1989,5.5,7,3,4,42,0,1,1,0,100,3.3,357,59,http://content9.flixster.com/movie/25/30/253015_det.jpg
2040,The Computer Wore Tennis Shoes,1969,5.6,5,3,2,60,0,0,0,0,0,0,0,0,http://content6.flixster.com/movie/10/94/21/10942176_det.jpg
2041,Condorman,1981,3.9,12,3,9,25,0,1,1,0,100,2.9,1334,49,http://content8.flixster.com/movie/26/60/266014_det.jpg
2042,D2: The Mighty Ducks,1994,3.8,13,2,11,15,0,1,0,1,0,2.9,13731,55,http://content6.flixster.com/movie/26/03/260324_det.jpg
2043,Darby O'Gill and the Little People,1959,6.9,13,13,0,100,0,1,1,0,100,3.5,2183,71,http://content8.flixster.com/movie/25/12/251206_det.jpg
2044,The Devil and Max Devlin,1981,3.9,8,1,7,12,0,0,0,0,0,0,0,0,http://content6.flixster.com/movie/10/88/51/10885128_det.jpg
2045,A Far Off Place,1993,4.9,9,3,6,33,0,2,0,2,0,3.3,2508,62,http://content7.flixster.com/movie/26/00/260001_det.jpg
2046,Flight of the Navigator,1986,5.7,7,5,2,71,0,0,0,0,0,0,0,0,http://content9.flixster.com/movie/25/42/254223_det.jpg
2047,The Gnome-Mobile,1967,0,1,1,0,100,0,1,1,0,100,3.4,654,62,http://content7.flixster.com/movie/10/88/31/10883141_det.jpg
2048,The Great Mouse Detective,1986,6.8,15,12,3,80,0,2,2,0,100,3.3,8687,70,http://content9.flixster.com/movie/25/12/251227_det.jpg
2049,The Happiest Millionaire,1967,0,4,2,2,50,0,1,0,1,0,3.8,694,78,http://content7.flixster.com/movie/10/90/10/10901049_det.jpg
2050,Herbie Goes Bananas,1980,0,4,1,3,25,0,1,1,0,100,2.9,2642,53,http://content6.flixster.com/movie/10/90/14/10901432_det.jpg
2051,Herbie Goes to Monte Carlo,1977,5,8,5,3,62,0,0,0,0,0,0,0,0,http://content7.flixster.com/movie/10/87/61/10876121_det.jpg
2052,Hocus Pocus,1993,4.1,21,6,15,28,0,3,0,3,0,3.1,21690,67,http://content9.flixster.com/movie/25/36/253607_det.jpg
2053,Honey I Blew Up the Kid,1992,4.9,16,7,9,43,0,2,1,1,50,2.5,10297,32,http://content9.flixster.com/movie/10/87/98/10879839_det.jpg
2054,"Honey, I Shrunk the Kids",1989,6.1,30,22,8,73,0,4,3,1,75,2.9,22644,47,http://content6.flixster.com/movie/10/87/98/10879840_det.jpg
2055,Hot Lead and Cold Feet,1978,0,1,1,0,100,0,0,0,0,0,0,0,0,http://content8.flixster.com/movie/25/20/252018_det.jpg
2056,In Search of the Castaways,1962,0,4,3,1,75,0,0,0,0,0,0,0,0,http://content9.flixster.com/movie/25/13/251327_det.jpg
2057,Homeward Bound: The Incredible Journey,1993,6.5,22,19,3,86,6.9,8,7,1,87,3.2,15019,66,http://content8.flixster.com/movie/10/91/53/10915370_det.jpg
2058,The Negotiator,1998,0,0,0,0,0,0,0,0,0,0,0,0,0,http://content7.flixster.com/movie/10/84/05/10840545_det.jpg
2059,The Parent Trap,1998,7,34,27,7,79,6.5,7,4,3,57,3.1,41455,67,http://content9.flixster.com/movie/10/88/10/10881003_det.jpg
2060,BASEketball,1998,5,49,20,29,40,4.5,13,3,10,23,3.2,19777,74,http://content7.flixster.com/movie/10/84/59/10845905_det.jpg
2061,Full Tilt Boogie,1997,0,0,0,0,0,0,0,0,0,0,0,0,0,http://content7.flixster.com/movie/10/89/35/10893537_det.jpg
2062,The Governess,1998,6.4,33,22,11,66,7,6,4,2,66,3.2,534,49,http://content9.flixster.com/movie/27/94/279427_det.jpg
2063,Le septième ciel,1997,5.3,7,4,3,57,0,1,1,0,100,3.4,192,62,http://content9.flixster.com/movie/10/17/86/10178627_det.jpg
2064,Roger & Me,1989,8.8,27,27,0,100,0,0,0,0,0,0,0,0,http://content9.flixster.com/movie/10/85/07/10850715_det.jpg
2065,The Purple Rose of Cairo,1985,7.7,29,26,3,89,0,0,0,0,0,0,0,0,http://content9.flixster.com/movie/25/86/258623_det.jpg
2066,Out of the Past,1947,8.6,25,24,1,96,8.6,5,5,0,100,4.2,2206,91,http://content8.flixster.com/movie/10/08/01/10080146_det.jpg
2067,Doctor Zhivago,1965,7.2,32,27,5,84,6,5,3,2,60,3.8,11535,85,http://content7.flixster.com/movie/88/17/87/8817873_det.jpg
2068,Fanny och Alexander,1982,8.9,33,33,0,100,8.4,11,11,0,100,4.4,5627,93,http://content8.flixster.com/movie/10/85/35/10853534_det.jpg
2069,The Trip to Bountiful,1985,7.2,7,7,0,100,0,1,1,0,100,4,434,82,http://content7.flixster.com/movie/25/68/256893_det.jpg
2070,Tender Mercies,1983,7.3,20,17,3,85,0,0,0,0,0,0,0,0,http://content6.flixster.com/movie/26/62/266228_det.jpg
2071,And the Band Played On,1993,7.3,8,8,0,100,0,0,0,0,0,0,0,0,http://content9.flixster.com/movie/10/88/42/10884243_det.jpg
2072,The 'burbs,1989,5.2,13,6,7,46,0,2,1,1,50,3.3,10248,68,http://content8.flixster.com/movie/55/12/57/5512574_det.jpg
2073,Fandango,1985,6.3,6,3,3,50,0,0,0,0,0,0,0,0,http://content7.flixster.com/movie/80/53/86/8053869_det.jpg
2074,Il portiere di notte,1974,5.6,20,13,7,65,0,4,1,3,25,3.6,1475,73,http://content8.flixster.com/movie/10/92/32/10923206_det.jpg
2075,Mephisto,1981,6.9,16,11,5,68,5.5,5,2,3,40,3.9,757,86,http://content7.flixster.com/movie/28/80/288005_det.jpg
2076,Blue Velvet,1986,8.4,33,30,3,90,0,4,2,2,50,4,25218,88,http://content8.flixster.com/movie/28/20/282022_det.jpg
2077,The Journey of Natty Gann,1985,6.7,13,12,1,92,0,3,3,0,100,3.5,1251,73,http://content8.flixster.com/movie/25/90/259006_det.jpg
2078,The Jungle Book,1967,7.3,27,24,3,88,0,2,1,1,50,3.5,35715,70,http://content7.flixster.com/movie/25/07/250701_det.jpg
2079,Kidnap,2008,0,0,0,0,0,0,0,0,0,0,0,0,0,http://content6.flixster.com/movie/10/88/41/10884176_det.jpg
2080,Lady and the Tramp,1955,7.4,31,27,4,87,0,4,1,3,25,3.5,37042,73,http://content7.flixster.com/movie/10/84/96/10849641_det.jpg
2081,The Little Mermaid,1989,8,51,46,5,90,7.3,7,6,1,85,3.6,80670,83,http://content8.flixster.com/movie/25/06/250622_det.jpg
2082,The Mighty Ducks,1992,3.8,25,2,23,8,3.2,5,0,5,0,3.1,14328,64,http://content7.flixster.com/movie/25/87/258701_det.jpg
2083,The Muppet Christmas Carol,1992,6,30,20,10,66,4.4,7,3,4,42,0,0,0,http://content8.flixster.com/movie/10/88/72/10887222_det.jpg
2084,Newsies,1992,4.5,23,7,16,30,3.6,7,1,6,14,3.8,10436,88,http://content7.flixster.com/movie/25/39/253905_det.jpg
2085,One Hundred and One Dalmatians,1961,8,37,36,1,97,7.6,5,5,0,100,3.3,29711,63,http://content7.flixster.com/movie/10/92/06/10920681_det.jpg
2086,One Magic Christmas,1985,5.4,9,5,4,55,0,1,0,1,0,3.4,844,66,http://content8.flixster.com/movie/25/31/253198_det.jpg
2087,Peter Pan,2003,6.8,132,100,32,75,6.3,33,23,10,69,3.3,47413,68,http://content7.flixster.com/movie/10/91/88/10918857_det.jpg
2088,Popeye,1980,5.8,27,15,12,55,0,4,2,2,50,2.6,6384,39,http://content9.flixster.com/movie/25/49/254991_det.jpg
2089,The Rescuers Down Under,1990,6,22,14,8,63,6.5,5,3,2,60,3.2,8757,62,http://content9.flixster.com/movie/25/13/251311_det.jpg
2090,The Rescuers,1977,6.6,25,21,4,84,0,3,3,0,100,3.2,7689,66,http://content9.flixster.com/movie/25/09/250903_det.jpg
2091,Race to Witch Mountain,2009,5.1,145,61,84,42,5.3,29,13,16,44,3.2,150558,50,http://content9.flixster.com/movie/10/91/55/10915591_det.jpg
2092,The Return of Jafar,1994,3.6,9,2,7,22,0,0,0,0,0,0,0,0,http://content7.flixster.com/movie/10/93/64/10936425_det.jpg
2093,Return to Oz,1985,5.7,20,11,9,55,0,3,1,2,33,3.1,14348,62,http://content7.flixster.com/movie/26/51/265105_det.jpg
2094,The Rocketeer,1991,5.8,50,30,20,60,5.8,9,5,4,55,2.9,8053,54,http://content8.flixster.com/movie/25/59/255906_det.jpg
2095,The Shaggy D.A.,1976,5.4,8,4,4,50,0,1,0,1,0,3.2,263,55,http://content6.flixster.com/movie/60/85/58/6085588_det.jpg
2096,Sleeping Beauty,1959,7.8,32,29,3,90,0,4,3,1,75,3.4,42607,75,http://content8.flixster.com/movie/30/64/306418_det.jpg
2097,Something Wicked This Way Comes,1983,6.1,23,13,10,56,0,4,3,1,75,3.4,2097,64,http://content9.flixster.com/movie/26/58/265895_det.jpg
2098,Son of Flubber,1963,6.2,6,5,1,83,0,0,0,0,0,0,0,0,http://content7.flixster.com/movie/25/22/252221_det.jpg
2099,Song of the South,1946,5.6,7,3,4,42,0,2,0,2,0,3.6,1559,77,http://content9.flixster.com/movie/21/77/83/2177835_det.jpg
2100,Splash,1984,6.9,35,32,3,91,5.6,5,3,2,60,3,12492,52,http://content8.flixster.com/movie/26/50/265002_det.jpg
2101,Squanto: A Warrior's Tale,1994,5.6,9,5,4,55,0,2,0,2,0,3.3,515,62,http://content6.flixster.com/movie/26/18/261816_det.jpg
2102,Steamboat Willie,1928,0,0,0,0,0,0,0,0,0,0,0,0,0,http://content7.flixster.com/movie/10/58/45/10584557_det.jpg
2103,Tall Tale,1995,5.5,9,4,5,44,0,1,1,0,100,0,0,0,http://content8.flixster.com/movie/10/90/45/10904586_det.jpg
2104,Tex,1982,6.9,11,9,2,81,0,3,2,1,66,3.5,695,66,http://content9.flixster.com/movie/26/63/266395_det.jpg
2105,TRON,1982,6,37,25,12,67,0,4,1,3,25,3.3,14666,69,http://content6.flixster.com/movie/10/91/41/10914152_det.jpg
2106,Swing Kids,1993,4.6,12,4,8,33,0,3,1,2,33,3.5,4819,79,http://content7.flixster.com/movie/10/92/09/10920937_det.jpg
2107,Halloween H20: 20 Years Later,1998,5.5,54,28,26,51,5.9,10,5,5,50,2.8,14935,57,http://content8.flixster.com/movie/10/88/13/10881306_det.jpg
2108,L.A. Story,1991,7.4,32,30,2,93,7.8,7,7,0,100,3.2,3117,70,http://content8.flixster.com/movie/26/57/265702_det.jpg
2109,The Jerk,1979,6.5,30,25,5,83,0,4,2,2,50,3.6,10847,83,http://content9.flixster.com/movie/27/59/275903_det.jpg
2110,Dead Men Don't Wear Plaid,1982,6.5,22,17,5,77,0,0,0,0,0,0,0,0,http://content6.flixster.com/movie/10/90/61/10906132_det.jpg
2111,The Man with Two Brains,1983,6,20,14,6,70,0,1,0,1,0,3,4360,57,http://content7.flixster.com/movie/10/92/03/10920301_det.jpg
2112,Grand Canyon,1991,6.9,24,18,6,75,0,2,2,0,100,3.4,1857,65,http://content6.flixster.com/movie/11/15/35/11153528_det.jpg
2113,Graveyard Shift,1990,3.8,8,1,7,12,0,0,0,0,0,0,0,0,http://content6.flixster.com/movie/27/73/277316_det.jpg
2114,The Outsiders,1983,6.1,31,20,11,64,4.7,7,2,5,28,3.6,24069,81,http://content6.flixster.com/movie/10/89/23/10892396_det.jpg
2115,Indiana Jones and the Temple of Doom,1984,7.2,59,50,9,84,6.5,7,4,3,57,3.7,87518,80,http://content8.flixster.com/movie/10/92/11/10921138_det.jpg
2116,The Lord of the Rings: The Return of the King,2003,8.6,239,225,14,94,8.6,43,42,1,97,3.7,288649,83,http://content7.flixster.com/movie/10/84/07/10840741_det.jpg
2117,Nineteen Eighty-Four,1984,6.4,14,11,3,78,0,1,1,0,100,3.5,17133,70,http://content7.flixster.com/movie/10/88/05/10880581_det.jpg
2118,The Dead Zone,2002,\N,\N,\N,\N,\N,\N,\N,\N,\N,\N,\N,\N,\N,\N
2119,Maximum Overdrive,1986,2.9,11,2,9,18,0,0,0,0,0,0,0,0,http://content7.flixster.com/movie/28/13/281313_det.jpg
2120,Needful Things,1993,4,22,6,16,27,0,3,0,3,0,3,2983,48,http://content6.flixster.com/movie/28/40/284092_det.jpg
2121,Cujo,1983,5.6,27,16,11,59,0,0,0,0,0,0,0,0,http://content9.flixster.com/movie/27/87/278791_det.jpg
2122,Children of the Corn,1984,4.1,22,8,14,36,0,0,0,0,0,0,0,0,http://content9.flixster.com/movie/10/91/84/10918483_det.jpg
2123,All Dogs Go to Heaven,1989,5.2,9,4,5,44,0,1,1,0,100,3.2,20551,60,http://content6.flixster.com/movie/10/87/86/10878600_det.jpg
2124,The Addams Family,1991,5.6,39,23,16,58,4.1,7,1,6,14,3.2,28704,65,http://content8.flixster.com/movie/26/64/266402_det.jpg
2125,Ever After,1998,7.5,61,55,6,90,6.8,17,13,4,76,3.5,71637,81,http://content7.flixster.com/movie/26/10/261017_det.jpg
2126,Snake Eyes,1998,5.2,64,26,38,40,4.9,14,6,8,42,2.8,8922,40,http://content9.flixster.com/movie/27/39/273915_det.jpg
2127,"First Love, Last Rites",1997,6.1,8,3,5,37,0,0,0,0,0,0,0,0,http://content8.flixster.com/movie/10/89/01/10890198_det.jpg
2128,Safe Men,1998,6,19,11,8,57,0,3,0,3,0,3.4,851,60,http://content9.flixster.com/movie/24/53/01/2453019_det.jpg
2129,Die Salzmänner von Tibet,1997,0,0,0,0,0,0,0,0,0,0,0,0,0,http://content9.flixster.com/movie/10/92/75/10927511_det.jpg
2130,Atlantic City,1980,8.7,19,19,0,100,0,0,0,0,0,0,0,0,http://content6.flixster.com/movie/27/24/272496_det.jpg
2131,Höstsonaten,1978,8,19,18,1,94,0,1,1,0,100,4.1,2226,90,http://content7.flixster.com/movie/26/49/264925_det.jpg
2132,Who's Afraid of Virginia Woolf?,1966,8.6,31,30,1,96,0,4,3,1,75,4.1,5164,91,http://content8.flixster.com/movie/11/14/16/11141682_det.jpg
2133,Adventures in Babysitting,1987,6.2,21,16,5,76,0,1,0,1,0,3.2,12565,64,http://content8.flixster.com/movie/25/41/254110_det.jpg
2134,Weird Science,1985,5.6,25,14,11,56,0,3,1,2,33,3.2,14712,69,http://content8.flixster.com/movie/26/37/263714_det.jpg
2135,Doctor Dolittle,1998,5.2,49,21,28,42,5.5,8,4,4,50,2.8,23847,46,http://content6.flixster.com/movie/11/15/12/11151232_det.jpg
2136,The Nutty Professor,1996,6,51,34,17,66,6.7,15,13,2,86,2.9,25286,50,http://content8.flixster.com/movie/25/91/259122_det.jpg
2137,Charlotte's Web,2006,7,142,111,31,78,6.9,35,25,10,71,3.3,39179,67,http://content9.flixster.com/movie/31/82/33/3182335_det.jpg
2138,Watership Down,1978,7,27,22,5,81,0,2,1,1,50,3.6,5277,82,http://content7.flixster.com/movie/11/15/28/11152877_det.jpg
2139,The Secret of NIMH,1982,6.8,18,17,1,94,6.5,5,4,1,80,3.5,7964,79,http://content6.flixster.com/movie/10/88/77/10887724_det.jpg
2140,The Dark Crystal,1982,6.1,30,21,9,70,0,2,1,1,50,3.6,35382,78,http://content8.flixster.com/movie/25/47/254714_det.jpg
2141,An American Tail,1986,6.2,24,15,9,62,4.8,6,2,4,33,3.3,13516,68,http://content8.flixster.com/movie/25/15/251502_det.jpg
2142,An American Tail: Fievel Goes West,1991,5.4,9,3,6,33,0,2,1,1,50,3.2,16427,58,http://content6.flixster.com/movie/25/31/253108_det.jpg
2143,Legend,1985,5.4,21,11,10,52,0,1,0,1,0,3.5,26271,73,http://content6.flixster.com/movie/25/40/254000_det.jpg
2144,Sixteen Candles,1984,7,31,27,4,87,6.2,5,3,2,60,3.7,44572,84,http://content8.flixster.com/movie/27/90/279006_det.jpg
2145,Pretty in Pink,1986,6.3,30,24,6,80,0,4,3,1,75,3.5,37255,81,http://content6.flixster.com/movie/10/91/49/10914992_det.jpg
2146,St. Elmo's Fire,1985,4.7,29,13,16,44,0,0,0,0,0,0,0,0,http://content9.flixster.com/movie/10/94/35/10943539_det.jpg
2147,The Clan of the Cave Bear,1986,3.7,8,1,7,12,0,1,0,1,0,2.9,1148,48,http://content8.flixster.com/movie/10/88/22/10882214_det.jpg
2148,House M.D.,2004,\N,\N,\N,\N,\N,\N,\N,\N,\N,\N,\N,\N,\N,\N
2149,House II: The Second Story,1987,3,9,0,9,0,0,0,0,0,0,0,0,0,http://content8.flixster.com/movie/26/13/261314_det.jpg
2150,The Gods Must Be Crazy,1980,7.4,19,18,1,94,0,1,1,0,100,3.5,7965,78,http://content7.flixster.com/movie/11/15/34/11153477_det.jpg
2151,The Gods Must Be Crazy II,1989,5.1,11,6,5,54,0,2,1,1,50,3.4,2600,69,http://content7.flixster.com/movie/10/90/47/10904733_det.jpg
2152,Air Bud: Golden Receiver,1998,4,17,1,16,5,0,3,0,3,0,2.7,7798,41,http://content6.flixster.com/movie/10/87/66/10876644_det.jpg
2154,How Stella Got Her Groove Back,1998,5.5,47,23,24,48,5.8,12,7,5,58,3.1,4439,72,http://content8.flixster.com/movie/10/88/71/10887130_det.jpg
2155,Slums of Beverly Hills,1998,6.9,58,46,12,79,7.3,13,12,1,92,3.3,1834,64,http://content6.flixster.com/movie/27/43/274320_det.jpg
2156,Il testimone dello sposo,1998,5.7,7,4,3,57,0,2,1,1,50,2.7,49,38,http://content7.flixster.com/movie/10/85/32/10853253_det.jpg
2157,La femme de chambre du Titanic,1997,6.5,16,13,3,81,0,1,1,0,100,0,0,0,http://content6.flixster.com/movie/10/92/19/10921924_det.jpg
2158,"Henry: Portrait of a Serial Killer, Part 2",1996,0,0,0,0,0,0,0,0,0,0,0,0,0,http://content9.flixster.com/movie/11/14/63/11146379_det.jpg
2159,Henry: Portrait of a Serial Killer,1986,7.3,41,36,5,87,6.5,7,6,1,85,3.6,2890,72,http://content7.flixster.com/movie/11/14/63/11146381_det.jpg
2160,Rosemary's Baby,1968,0,0,0,0,0,0,0,0,0,0,0,0,0,http://images.rottentomatoescdn.com/images/defaults/poster_default.gif
2161,The Neverending Story III,1994,0,3,1,2,33,0,0,0,0,0,0,0,0,http://content9.flixster.com/movie/10/88/07/10880743_det.jpg
2162,The Neverending Story II: The Next Chapter,1990,3.3,6,0,6,0,0,0,0,0,0,0,0,0,http://content7.flixster.com/movie/25/62/256297_det.jpg
2163,Attack of the Killer Tomatoes!,1978,3.9,11,3,8,27,0,0,0,0,0,0,0,0,http://content6.flixster.com/movie/10/92/32/10923244_det.jpg
2164,Surf Nazis Must Die,1987,0,4,0,4,0,0,0,0,0,0,0,0,0,http://content8.flixster.com/movie/27/80/278026_det.jpg
2165,Your Friends & Neighbors,1998,7,55,42,13,76,6.4,20,13,7,65,3.3,1418,60,http://content7.flixster.com/movie/10/93/56/10935653_det.jpg
2166,Return to Paradise,1998,6.6,44,31,13,70,6.8,11,8,3,72,3.5,1723,76,http://content7.flixster.com/movie/28/43/284397_det.jpg
2167,Blade,1998,5.7,83,46,37,55,4.6,24,7,17,29,3.6,87683,78,http://content6.flixster.com/movie/35/84/20/3584204_det.jpg
2168,Dance with Me,1998,5.4,40,19,21,47,5.2,11,5,6,45,3.2,7621,68,http://content9.flixster.com/movie/25/56/255603_det.jpg
2169,Dead Man on Campus,1998,3.6,34,5,29,14,2.8,11,0,11,0,2.7,3796,50,http://content9.flixster.com/movie/10/87/18/10871827_det.jpg
2170,Wrongfully Accused,1998,3.8,31,7,24,22,2.9,6,0,6,0,2.8,2483,56,http://content9.flixster.com/movie/10/92/01/10920195_det.jpg
2171,Next Stop Wonderland,1998,6.8,41,30,11,73,5.7,7,3,4,42,3.5,910,70,http://content7.flixster.com/movie/10/86/22/10862269_det.jpg
2172,Strike!,1998,6.8,12,8,4,66,0,3,1,2,33,3.5,2267,69,http://content9.flixster.com/movie/25/92/259223_det.jpg
2173,The Navigator: A Mediaeval Odyssey,1988,6.5,5,4,1,80,0,0,0,0,0,0,0,0,http://content6.flixster.com/movie/10/87/32/10873272_det.jpg
2174,Beetle Juice,1988,7,42,34,8,80,6.4,7,5,2,71,3.4,84134,77,http://content9.flixster.com/movie/45/46/63/4546639_det.jpg
2175,Deja Vu,2006,0,0,0,0,0,0,0,0,0,0,0,0,0,http://content6.flixster.com/movie/10/84/17/10841796_det.jpg
2176,Rope,1948,7.8,31,30,1,96,0,2,1,1,50,4,9199,89,http://content8.flixster.com/movie/25/62/256210_det.jpg
2177,Family Plot,1976,7,20,19,1,95,0,2,2,0,100,3.3,1981,57,http://content6.flixster.com/movie/10/88/55/10885532_det.jpg
2178,Frenzy,1972,7.4,30,26,4,86,0,2,2,0,100,3.6,3790,74,http://content6.flixster.com/movie/27/01/270104_det.jpg
2179,Topaz,1969,6.4,17,12,5,70,0,1,1,0,100,3,1779,39,http://content9.flixster.com/movie/26/00/260091_det.jpg
2180,Torn Curtain,1966,6.5,16,13,3,81,0,1,0,1,0,3.3,2910,55,http://content9.flixster.com/movie/25/86/258619_det.jpg
2181,Marnie,1964,6.8,19,16,3,84,0,1,0,1,0,0,0,0,http://content6.flixster.com/movie/25/65/256512_det.jpg
2182,The Wrong Man,1956,8.3,18,16,2,88,0,1,0,1,0,3.6,2616,72,http://content8.flixster.com/movie/10/88/80/10888034_det.jpg
2183,The Man Who Knew Too Much,1956,7.7,28,25,3,89,0,3,2,1,66,0,0,0,http://content8.flixster.com/movie/10/92/45/10924554_det.gif
2184,The Trouble with Harry,1955,7.4,19,17,2,89,0,1,1,0,100,3.6,3827,73,http://content9.flixster.com/movie/10/91/87/10918787_det.jpg
2185,I Confess,1953,7.2,20,17,3,85,0,3,2,1,66,3.6,2474,70,http://content7.flixster.com/movie/95/95/29/9595297_det.jpg
2186,Strangers on a Train,1951,8.7,40,39,1,97,7.3,5,4,1,80,4,9106,91,http://content9.flixster.com/movie/10/93/77/10937755_det.jpg
2187,Stage Fright,1950,7,16,14,2,87,0,3,2,1,66,3.4,2015,61,http://content8.flixster.com/movie/10/91/56/10915662_det.jpg
2188,54,1998,4.1,62,8,54,12,3.4,14,1,13,7,2.8,4129,45,http://content6.flixster.com/movie/27/08/270804_det.jpg
2189,I Married a Strange Person!,1997,6.1,9,7,2,77,0,1,1,0,100,3.8,688,80,http://content6.flixster.com/movie/31/02/310292_det.jpg
2190,Why Do Fools Fall in Love,1998,5.8,54,29,25,53,6.5,19,13,6,68,3.5,1989,73,http://content6.flixster.com/movie/10/92/01/10920176_det.jpg
2191,Keep the Aspidistra Flying,1997,7,21,18,3,85,0,4,4,0,100,3.2,753,50,http://content6.flixster.com/movie/10/89/29/10892908_det.jpg
2192,Regarde la mer,1997,7.3,8,8,0,100,0,2,2,0,100,3.4,370,61,http://content9.flixster.com/movie/28/97/289727_det.jpg
2193,Willow,1988,5.4,26,12,14,46,0,4,0,4,0,3.4,36518,76,http://content6.flixster.com/movie/10/53/47/10534748_det.jpg
2194,The Untouchables,1987,7.2,42,34,8,80,7.9,7,6,1,85,3.8,40677,87,http://content8.flixster.com/movie/27/92/279214_det.jpg
2195,Dirty Work,1998,3.9,30,5,25,16,3.5,7,0,7,0,3.1,3838,66,http://content7.flixster.com/movie/10/91/46/10914685_det.jpg
2196,Knock Off,1998,2.9,38,3,35,7,3.6,9,2,7,22,2.6,1992,32,http://content7.flixster.com/movie/27/91/279101_det.jpg
2197,Firelight,1997,5.2,13,6,7,46,0,3,2,1,66,3.8,672,81,http://content9.flixster.com/movie/10/45/86/10458659_det.jpg
2199,Griffin & Phoenix,2006,0,0,0,0,0,0,0,0,0,0,0,0,0,http://content9.flixster.com/movie/10/89/92/10899243_det.jpg
2200,Under Capricorn,1949,5.9,6,4,2,66,0,2,1,1,50,3,851,37,http://content6.flixster.com/movie/29/74/297492_det.jpg
2201,The Paradine Case,1947,6.2,8,6,2,75,0,1,1,0,100,3.2,1208,46,http://content6.flixster.com/movie/30/47/304708_det.jpg
2202,Lifeboat,1944,7.8,20,19,1,95,0,3,2,1,66,3.8,2621,84,http://content7.flixster.com/movie/11/15/13/11151377_det.jpg
2203,Shadow of a Doubt,1943,8.9,30,30,0,100,0,4,4,0,100,4,5376,89,http://content6.flixster.com/movie/10/89/08/10890840_det.jpg
2204,Saboteur,1942,6.7,14,11,3,78,0,1,0,1,0,3.6,2467,72,http://content7.flixster.com/movie/25/76/257625_det.jpg
2205,Mr. & Mrs. Smith,2005,6,202,116,86,57,5.6,39,18,21,46,3.4,230941,63,http://content8.flixster.com/movie/24/98/249802_det.jpg
2206,Guilty by Suspicion,1991,6.2,16,11,5,68,0,2,1,1,50,3.2,728,51,http://content8.flixster.com/movie/10/89/64/10896454_det.jpg
2207,Jamaica Inn,1939,5.5,10,7,3,70,0,1,0,1,0,3,1259,38,http://content6.flixster.com/movie/29/98/299800_det.jpg
2208,The Lady Vanishes,1938,8.3,33,32,1,96,0,3,3,0,100,4,4078,87,http://content8.flixster.com/movie/92/28/922862_det.jpg
2209,Young and Innocent,1937,7.5,13,13,0,100,0,2,2,0,100,3.4,889,61,http://content6.flixster.com/movie/95/36/953684_det.jpg
2210,Sabotage,1936,7.3,7,7,0,100,0,1,1,0,100,3.5,1459,68,http://content9.flixster.com/movie/24/84/79/2484791_det.jpg
2211,Secret Agent,1936,7.6,10,10,0,100,0,0,0,0,0,0,0,0,http://content8.flixster.com/movie/10/35/29/10352954_det.jpg
2212,The Man Who Knew Too Much,1956,7.7,28,25,3,89,0,3,2,1,66,0,0,0,http://content8.flixster.com/movie/10/92/45/10924554_det.gif
2214,Number Seventeen,1932,0,2,0,2,0,0,0,0,0,0,0,0,0,http://content8.flixster.com/movie/24/83/27/2483274_det.gif
2215,Rich and Strange,1931,6.4,10,7,3,70,0,1,1,0,100,0,0,0,http://content7.flixster.com/movie/71/88/718873_det.jpg
2216,The Skin Game,1931,0,3,0,3,0,0,2,0,2,0,2.7,145,27,http://content9.flixster.com/movie/10/85/41/10854159_det.jpg
2218,Juno and the Paycock,1930,5.1,7,4,3,57,0,2,0,2,0,0,0,0,http://content8.flixster.com/movie/24/89/81/2489814_det.gif
2219,A Perfect Murder,1998,6.2,49,27,22,55,6.2,14,8,6,57,3.1,9130,52,http://content9.flixster.com/movie/10/91/93/10919303_det.gif
2220,The Manxman,1929,0,2,2,0,100,0,1,1,0,100,3.1,502,37,http://content7.flixster.com/movie/30/66/306601_det.jpg
2221,Blackmail,1929,6.7,9,8,1,88,0,1,1,0,100,3.4,1310,63,http://content8.flixster.com/movie/11/13/96/11139670_det.jpg
2222,Champagne,1928,0,1,0,1,0,0,0,0,0,0,0,0,0,http://content7.flixster.com/movie/10/83/87/10838705_det.jpg
2223,The Farmer's Wife,1928,0,0,0,0,0,0,0,0,0,0,0,0,0,http://content6.flixster.com/movie/10/84/53/10845328_det.jpg
2225,Easy Virtue,2008,5.8,120,63,57,52,5.8,26,13,13,50,3.1,16900,48,http://content7.flixster.com/movie/10/86/91/10869105_det.jpg
2226,The Ring,2002,6.6,169,120,49,71,6.3,32,18,14,56,3,146246,50,http://content8.flixster.com/movie/10/86/94/10869458_det.jpg
2227,The Lodger,2009,3.6,23,4,19,17,2.5,6,0,6,0,2.9,1023,36,http://content8.flixster.com/movie/10/92/98/10929834_det.jpg
2229,The Pleasure Garden,1925,0,1,1,0,100,0,0,0,0,0,0,0,0,http://content8.flixster.com/movie/10/90/64/10906458_det.jpg
2231,Rounders,1998,6.2,76,49,27,64,5,19,8,11,42,3.7,21780,86,http://content8.flixster.com/movie/10/87/41/10874162_det.jpg
2232,Cube,1997,6.1,33,20,13,60,6,6,3,3,50,3.5,22869,75,http://content8.flixster.com/movie/26/85/268594_det.jpg
2233,Digging to China,1998,4.4,7,3,4,42,0,1,0,1,0,3.7,506,70,http://content6.flixster.com/movie/10/83/99/10839932_det.jpg
2234,Kinsey,2004,7.6,187,168,19,89,7.9,39,36,3,92,3.4,6162,72,http://content6.flixster.com/movie/10/94/53/10945324_det.jpg
2235,One Man's Hero,1999,4.8,8,3,5,37,0,1,0,1,0,3.1,305,48,http://content9.flixster.com/movie/10/87/98/10879803_det.jpg
2236,Simon Birch,1998,5.8,32,14,18,43,5.4,6,2,4,33,3.4,8747,76,http://content7.flixster.com/movie/25/50/255097_det.jpg
2237,Without Limits,1998,6.5,37,29,8,78,6.8,15,13,2,86,4,1947,88,http://content6.flixster.com/movie/25/48/254804_det.jpg
2238,Pasqualino Settebellezze,1975,8.2,9,8,1,88,0,1,1,0,100,4,557,87,http://content7.flixster.com/movie/11/13/90/11139021_det.jpg
2239,Travolti da un insolito destino nell'azzurro mare d'agosto,1974,5.9,16,11,5,68,0,2,2,0,100,3.7,857,77,http://content8.flixster.com/movie/11/13/01/11130142_det.jpg
2240,My Bodyguard,1980,6.5,25,21,4,84,0,4,3,1,75,3.4,1236,67,http://content9.flixster.com/movie/25/60/256015_det.jpg
2241,Class,1983,4.7,12,3,9,25,0,2,1,1,50,3,1523,47,http://content8.flixster.com/movie/27/39/273910_det.jpg
2242,"Grandview, U.S.A.",1984,0,1,0,1,0,0,0,0,0,0,0,0,0,http://content7.flixster.com/movie/59/97/32/5997325_det.jpg
2243,Broadcast News,1987,8.1,38,37,1,97,7.8,7,7,0,100,3.5,2524,71,http://content9.flixster.com/movie/10/87/82/10878247_det.jpg
2244,The Allnighter,1987,2.5,7,0,7,0,0,3,0,3,0,2.9,329,39,http://content6.flixster.com/movie/26/41/264196_det.jpg
2245,Working Girl,1988,6.7,36,30,6,83,7.2,7,6,1,85,3.1,6043,61,http://content6.flixster.com/movie/31/40/314096_det.jpg
2246,Stars and Bars,1988,0,1,1,0,100,0,0,0,0,0,0,0,0,http://content9.flixster.com/movie/92/87/09/9287099_det.gif
2247,Married to the Mob,1988,7.2,22,19,3,86,0,0,0,0,0,0,0,0,http://content9.flixster.com/movie/34/35/63/3435639_det.jpg
2248,Say Anything...,1989,8.1,38,38,0,100,7.9,6,6,0,100,3.6,20891,82,http://content8.flixster.com/movie/59/54/51/5954518_det.jpg
2249,My Blue Heaven,1990,5.5,16,11,5,68,0,1,1,0,100,3,2634,54,http://content8.flixster.com/movie/25/65/256502_det.jpg
2250,Men Don't Leave,1990,6.6,16,12,4,75,0,2,1,1,50,3.4,202,54,http://content9.flixster.com/movie/97/18/86/9718863_det.jpg
2251,The Cabinet of Dr. Ramirez,1991,\N,\N,\N,\N,\N,\N,\N,\N,\N,\N,\N,\N,\N,\N
2252,Heroes,2006,0,0,0,0,0,0,0,0,0,0,0,0,0,http://content8.flixster.com/movie/10/85/26/10852618_det.jpg
2253,Toys,1992,4.1,22,6,16,27,0,3,0,3,0,2.6,6312,39,http://content9.flixster.com/movie/10/87/80/10878095_det.jpg
2255,Young Doctors in Love,1982,4.2,6,0,6,0,0,1,0,1,0,2.7,366,33,http://content8.flixster.com/movie/27/43/274394_det.jpg
2256,Parasite,1982,2.2,5,0,5,0,0,0,0,0,0,0,0,0,http://content6.flixster.com/movie/10/86/97/10869728_det.jpg
2257,No Small Affair,1984,5.7,6,4,2,66,0,0,0,0,0,0,0,0,http://content6.flixster.com/movie/28/45/284592_det.jpg
2258,Shao Lin san shi liu fang,1978,0,1,0,1,0,0,0,0,0,0,0,0,0,http://content9.flixster.com/movie/11/12/46/11124615_det.jpg
2259,Blame It on Rio,1984,2.9,22,2,20,9,0,3,0,3,0,2.8,1097,36,http://content8.flixster.com/movie/27/23/272302_det.jpg
2260,Filth and Wisdom,2008,3.9,58,15,43,25,4.2,23,7,16,30,3,1070,42,http://content6.flixster.com/movie/10/86/05/10860500_det.jpg
2261,One Crazy Summer,1986,5.6,15,9,6,60,0,2,1,1,50,3.3,3309,62,http://content9.flixster.com/movie/25/79/257919_det.jpg
2262,Last Night,1998,7.2,49,41,8,83,7.1,9,7,2,77,3.8,1691,84,http://content9.flixster.com/movie/18/18/56/1818567_det.jpg
2263,The Seventh Sign,1988,3.7,16,3,13,18,0,1,0,1,0,3.1,3031,55,http://content9.flixster.com/movie/27/25/272507_det.jpg
2264,We're No Angels,1989,5.1,18,9,9,50,0,1,1,0,100,2.9,2176,43,http://content8.flixster.com/movie/26/25/262514_det.jpg
2265,Nothing But Trouble,1991,2.2,10,1,9,10,0,1,0,1,0,0,0,0,http://content9.flixster.com/movie/10/93/53/10935391_det.jpg
2266,The Butcher's Wife,1991,3.8,13,3,10,23,0,2,0,2,0,2.7,1218,30,http://content8.flixster.com/movie/26/15/261514_det.jpg
2267,Mortal Thoughts,1991,5.6,13,8,5,61,0,2,1,1,50,2.9,1404,33,http://content9.flixster.com/movie/27/64/276491_det.jpg
2268,A Few Good Men,1992,6.8,42,35,7,83,7.5,8,8,0,100,3.6,26934,83,http://content6.flixster.com/movie/28/17/281708_det.jpg
2269,Indecent Proposal,1993,4.7,35,13,22,37,0,3,1,2,33,2.9,7358,50,http://content8.flixster.com/movie/10/88/26/10882670_det.jpg
2270,A Century of Cinema,1994,\N,\N,\N,\N,\N,\N,\N,\N,\N,\N,\N,\N,\N,\N
2271,Permanent Midnight,1998,5.7,51,30,21,58,6.4,11,7,4,63,3.2,1302,55,http://content6.flixster.com/movie/10/91/85/10918516_det.jpg
2272,One True Thing,1998,7.2,60,53,7,88,6.7,18,15,3,83,3.4,2813,65,http://content9.flixster.com/movie/27/34/273411_det.jpg
2273,Rush Hour,1998,6,62,37,25,59,5.5,14,7,7,50,3.4,73231,79,http://content9.flixster.com/movie/10/86/18/10861899_det.jpg
2275,Six-String Samurai,1998,6,20,12,8,60,0,1,0,1,0,3.7,2140,75,http://content9.flixster.com/movie/25/85/258595_det.jpg
2276,A Soldier's Daughter Never Cries,1998,7,24,19,5,79,7.3,7,5,2,71,3.4,482,62,http://content8.flixster.com/movie/28/35/283598_det.jpg
2278,Ronin,1998,6.3,60,41,19,68,5.8,14,8,6,57,3.5,26379,76,http://content6.flixster.com/movie/26/94/269492_det.jpg
2279,Urban Legend,1998,4.3,48,10,38,20,4.1,12,2,10,16,2.7,15231,46,http://content6.flixster.com/movie/27/43/274304_det.jpg
2280,Clay Pigeons,1998,6.2,51,32,19,62,5,10,2,8,20,3.4,2336,67,http://content7.flixster.com/movie/10/93/49/10934953_det.jpg
2281,Snitch,1998,7,19,17,2,89,0,4,4,0,100,3.3,386,58,http://content6.flixster.com/movie/27/90/279024_det.jpg
2282,Pecker,1998,5.7,43,23,20,53,4.7,6,1,5,16,3.2,3201,63,http://content9.flixster.com/movie/10/03/99/10039927_det.jpg
2283,The Sheltering Sky,1990,5.2,22,10,12,45,5,7,3,4,42,3.8,1679,79,http://content7.flixster.com/movie/10/87/41/10874153_det.jpg
2284,Bandit Queen,1994,7.5,25,25,0,100,7.6,10,10,0,100,3.6,1049,72,http://content6.flixster.com/movie/30/97/309708_det.jpg
2285,If....,1968,7.9,30,29,1,96,0,4,3,1,75,4.1,2971,88,http://content6.flixster.com/movie/32/05/41/3205416_det.jpg
2286,The Fiendish Plot of Dr. Fu Manchu,1980,3.6,10,2,8,20,0,1,0,1,0,3,277,45,http://content6.flixster.com/movie/10/90/09/10900940_det.jpg
2287,Ils,2006,6,50,30,20,60,6,12,6,6,50,3.4,4393,62,http://content8.flixster.com/movie/10/91/34/10913458_det.jpg
2288,The Thing,1982,0,0,0,0,0,0,0,0,0,0,0,0,0,http://images.rottentomatoescdn.com/images/defaults/poster_default.gif
2289,The Player,1992,0,0,0,0,0,0,0,0,0,0,0,0,0,http://images.rottentomatoescdn.com/images/defaults/poster_default.gif
2290,Stardust Memories,1980,6.6,24,17,7,70,0,4,1,3,25,3.8,2789,80,http://content6.flixster.com/movie/26/09/260912_det.jpg
2291,Edward Scissorhands,1990,7.6,53,48,5,90,6.8,9,7,2,77,3.8,145994,88,http://content9.flixster.com/movie/10/92/33/10923351_det.jpg
2292,Overnight Delivery,1998,4.9,7,3,4,42,0,0,0,0,0,0,0,0,http://content9.flixster.com/movie/72/69/77/7269771_det.jpg
2293,Shadrach,1998,5.8,16,8,8,50,5,5,0,5,0,3.6,134,59,http://content7.flixster.com/movie/26/58/265825_det.jpg
2294,Antz,1998,7.7,86,82,4,95,7.5,24,23,1,95,2.9,33465,47,http://content8.flixster.com/movie/25/71/257118_det.jpg
2295,Impostor,2001,3.9,91,19,72,20,3.6,25,4,21,16,3,1418,46,http://content6.flixster.com/movie/10/86/93/10869340_det.jpg
2296,A Night at the Roxbury,1998,3.4,54,6,48,11,2.6,11,0,11,0,3.1,27913,67,http://content7.flixster.com/movie/25/48/254893_det.jpg
2297,What Dreams May Come,1998,5.7,66,36,30,54,5.8,16,9,7,56,3.6,31618,85,http://content6.flixster.com/movie/26/24/262404_det.jpg
2298,Strangeland,1998,2.3,16,1,15,6,0,2,0,2,0,3.5,4041,65,http://content9.flixster.com/movie/26/91/269119_det.jpg
2299,The Battle of the Sexes,1959,0,1,1,0,100,0,0,0,0,0,0,0,0,http://content8.flixster.com/movie/10/85/42/10854282_det.jpg
2300,The Producers,2005,5.8,150,76,74,50,5,36,10,26,27,3.1,31343,63,http://content7.flixster.com/movie/31/17/311717_det.jpg
2301,History of the World: Part I,1981,5.6,25,15,10,60,0,0,0,0,0,0,0,0,http://content6.flixster.com/movie/26/69/266900_det.jpg
2302,My Cousin Vinny,1992,6.9,38,33,5,86,7,8,6,2,75,0,0,0,http://content6.flixster.com/movie/26/78/267816_det.jpg
2303,Nashville,1975,8.6,39,37,2,94,9,5,5,0,100,4.1,3090,84,http://content6.flixster.com/movie/28/40/284024_det.jpg
2304,Love Is the Devil: Study for a Portrait of Francis Bacon,1998,0,0,0,0,0,0,0,0,0,0,0,0,0,http://content8.flixster.com/movie/10/84/61/10846182_det.jpg
2305,Slam,1998,6.8,21,13,8,61,7.2,8,5,3,62,3.9,549,80,http://content6.flixster.com/movie/10/87/44/10874408_det.jpg
2306,Holy Man,1998,3.6,49,6,43,12,3.8,12,1,11,8,2.4,3310,30,http://content6.flixster.com/movie/26/48/264896_det.jpg
2307,One Tough Cop,1998,4.2,20,5,15,25,4,6,1,5,16,2.8,405,28,http://content9.flixster.com/movie/10/87/67/10876715_det.jpg
2308,Detroit 9000,1973,5.4,6,1,5,16,0,2,0,2,0,2.9,572,48,http://content9.flixster.com/movie/28/19/281915_det.jpg
2310,The Mighty Ducks,1992,3.8,25,2,23,8,3.2,5,0,5,0,3.1,14328,64,http://content7.flixster.com/movie/25/87/258701_det.jpg
2311,2010,1984,5.7,25,16,9,64,0,2,2,0,100,3.2,5956,58,http://content7.flixster.com/movie/10/92/01/10920113_det.jpg
2312,Children of a Lesser God,1986,7.1,24,20,4,83,0,1,1,0,100,3.6,2089,76,http://content8.flixster.com/movie/27/05/270510_det.jpg
2313,The Elephant Man,1980,8.2,33,30,3,90,0,4,2,2,50,3.9,16869,90,http://content8.flixster.com/movie/10/86/50/10865070_det.jpg
2314,Beloved,1998,7.1,66,51,15,77,7.3,24,20,4,83,3.3,2521,68,http://content8.flixster.com/movie/26/97/269718_det.jpg
2315,Bride of Chucky,1998,5.3,30,13,17,43,0,4,1,3,25,2.6,20874,52,http://content7.flixster.com/movie/27/67/276717_det.jpg
2316,Practical Magic,1998,4.4,54,11,43,20,3.7,15,1,14,6,3.2,24912,73,http://content7.flixster.com/movie/10/88/77/10887761_det.jpg
2317,Life During Wartime,1997,5.6,11,6,5,54,0,1,0,1,0,0,0,0,http://content6.flixster.com/movie/10/85/12/10851272_det.jpg
2318,Happiness,1998,7.9,44,37,7,84,7.8,9,7,2,77,4,11088,88,http://content8.flixster.com/movie/28/63/286314_det.jpg
2319,Reach the Rock,1998,4.5,8,3,5,37,0,1,0,1,0,3.4,22,60,http://content6.flixster.com/movie/10/87/70/10877068_det.jpg
2320,Apt Pupil,1998,6,55,29,26,52,5.5,14,7,7,50,3.1,5334,57,http://content8.flixster.com/movie/27/24/272414_det.jpg
2321,Pleasantville,1998,7.5,82,70,12,85,6.9,22,16,6,72,3.3,22512,73,http://content7.flixster.com/movie/63/98/91/6398913_det.jpg
2322,Soldier,1998,3.5,50,5,45,10,3.6,15,2,13,13,2.8,5503,46,http://content9.flixster.com/movie/26/95/269595_det.jpg
2323,Valkyrie,2008,6,185,113,72,61,6,37,22,15,59,3.5,113378,66,http://content9.flixster.com/movie/10/86/48/10864803_det.jpg
2324,La vita è bella,1997,7.5,84,66,18,78,5.7,16,9,7,56,4.3,65601,96,http://content7.flixster.com/movie/53/81/55/5381553_det.jpg
2325,Orgazmo,1997,5.1,32,15,17,46,4.1,7,1,6,14,3.2,9287,66,http://content6.flixster.com/movie/10/54/78/10547824_det.jpg
2326,Shattered Image,1998,4.8,14,4,10,28,0,4,0,4,0,0,0,0,http://content6.flixster.com/movie/10/98/13/10981364_det.jpg
2327,Tales from the Darkside: The Movie,1990,4.5,14,5,9,35,0,3,1,2,33,3.1,2283,49,http://content7.flixster.com/movie/10/84/02/10840229_det.jpg
2328,Interview with the Vampire: The Vampire Chronicles,1994,5.8,45,26,19,57,4.6,10,4,6,40,3.7,77706,85,http://content6.flixster.com/movie/28/01/280124_det.jpg
2329,American History X,1998,7.2,72,60,12,83,6.6,21,15,6,71,4.2,140060,96,http://content9.flixster.com/movie/10/85/69/10856931_det.jpg
2330,Hands on a Hard Body: The Documentary,1997,7.1,19,16,3,84,6.8,6,6,0,100,4.1,320,89,http://content6.flixster.com/movie/26/62/266204_det.jpg
2331,Living Out Loud,1998,6.3,31,18,13,58,5.8,7,3,4,42,3.4,845,60,http://content6.flixster.com/movie/10/87/03/10870304_det.jpg
2332,Belly,1998,3.9,15,2,13,13,0,2,0,2,0,3.9,6432,86,http://content9.flixster.com/movie/10/91/60/10916003_det.jpg
2333,Gods and Monsters,1998,8.4,48,46,2,95,8.5,9,8,1,88,3.7,3109,80,http://content6.flixster.com/movie/10/89/49/10894936_det.jpg
2334,The Siege,1998,5.8,59,26,33,44,5,13,4,9,30,3.1,8405,56,http://content9.flixster.com/movie/28/38/283891_det.jpg
2335,The Waterboy,1998,4.6,72,23,49,31,3.8,17,4,13,23,3.4,79240,74,http://content7.flixster.com/movie/25/44/254405_det.jpg
2336,Elizabeth,1998,7.3,47,38,9,80,8.3,9,9,0,100,3.8,19341,86,http://content7.flixster.com/movie/10/83/89/10838937_det.jpg
2337,Velvet Goldmine,1998,6.5,38,21,17,55,5.7,5,1,4,20,3.7,10467,80,http://content9.flixster.com/movie/69/65/48/6965487_det.jpg
2338,I Still Know What You Did Last Summer,1998,3.3,53,4,49,7,3.9,11,2,9,18,2.6,19948,42,http://content7.flixster.com/movie/10/89/02/10890281_det.jpg
2339,I'll Be Home for Christmas,1998,3.9,40,7,33,17,3.5,16,2,14,12,2.6,3438,46,http://content7.flixster.com/movie/26/44/264429_det.jpg
2340,Meet Joe Black,1998,5.6,36,18,18,50,5.6,5,2,3,40,3.4,38972,80,http://content6.flixster.com/movie/26/64/266412_det.jpg
2341,Dancing at Lughnasa,1998,6.1,31,20,11,64,6.5,5,2,3,40,3.4,869,59,http://content8.flixster.com/movie/10/94/53/10945390_det.jpg
2342,Hard Core Logo,1996,6.4,12,8,4,66,0,4,4,0,100,0,0,0,http://content6.flixster.com/movie/51/27/99/5127996_det.jpg
2343,The Naked Man,1998,4.9,5,1,4,20,0,0,0,0,0,0,0,0,http://content6.flixster.com/movie/10/92/02/10920280_det.gif
2344,Runaway Train,1985,7.1,27,23,4,85,0,4,3,1,75,3.5,1615,71,http://content6.flixster.com/movie/27/34/273496_det.jpg
2345,Desert Bloom,1986,7,9,7,2,77,0,1,0,1,0,0,0,0,http://content6.flixster.com/movie/10/88/94/10889464_det.jpg
2346,The Stepford Wives,2004,4.7,163,43,120,26,4.9,37,11,26,29,2.6,14476,36,http://content6.flixster.com/movie/25/84/258412_det.jpg
2347,The Pope of Greenwich Village,1984,7.4,9,8,1,88,0,1,1,0,100,3.5,970,68,http://content8.flixster.com/movie/10/91/54/10915474_det.jpg
2348,Sid and Nancy,1986,7.3,31,28,3,90,7.4,7,6,1,85,3.5,6365,75,http://content6.flixster.com/movie/28/34/283412_det.jpg
2349,Mona Lisa Smile,2003,4.9,147,51,96,34,5.2,41,18,23,43,3.1,23577,61,http://content9.flixster.com/movie/25/59/255923_det.jpg
2350,Heart Condition,1990,3.3,7,0,7,0,0,2,0,2,0,2.9,842,43,http://content7.flixster.com/movie/89/73/70/8973709_det.jpg
2351,Le notti di Cabiria,1957,8.7,35,34,1,97,8.4,11,11,0,100,4.4,3465,94,http://content7.flixster.com/movie/29/88/298801_det.jpg
2352,The Big Chill,1983,6.1,31,21,10,67,5.5,6,3,3,50,3.6,4386,79,http://content7.flixster.com/movie/26/86/268601_det.jpg
2353,Enemy of the State,1998,6.4,81,57,24,70,6.2,20,13,7,65,3.5,34766,76,http://content9.flixster.com/movie/10/87/15/10871599_det.jpg
2354,The Rugrats Movie,1998,5.8,47,27,20,57,6.4,11,7,4,63,2.8,6870,42,http://content7.flixster.com/movie/11/13/75/11137533_det.jpg
2355,A Bug's Life,1998,7.9,80,73,7,91,7.5,18,17,1,94,3.3,64405,61,http://content9.flixster.com/movie/10/93/89/10938947_det.jpg
2356,Celebrity,1998,5.6,37,15,22,40,5.6,5,1,4,20,3,3241,42,http://content7.flixster.com/movie/27/63/276393_det.jpg
2357,Central do Brasil,1998,7.9,48,45,3,93,8.1,13,12,1,92,4.2,3839,93,http://content9.flixster.com/movie/10/87/55/10875583_det.jpg
2358,Savior,1998,6.8,8,5,3,62,0,2,1,1,50,3.7,947,78,http://content8.flixster.com/movie/27/46/274602_det.jpg
2359,Waking Ned,1998,7,57,47,10,82,7,13,11,2,84,3.6,4612,85,http://content8.flixster.com/movie/10/87/79/10877990_det.jpg
2360,Festen,1998,8,36,33,3,91,8.3,5,5,0,100,4.3,5434,95,http://content7.flixster.com/movie/28/06/35/2806353_det.jpg
2361,Pink Flamingos,1972,6.6,35,28,7,80,0,4,2,2,50,3.6,4901,74,http://content9.flixster.com/movie/11/15/26/11152651_det.jpg
2362,Glen or Glenda,1953,3.6,22,7,15,31,0,1,0,1,0,2.6,1851,35,http://content9.flixster.com/movie/11/15/29/11152907_det.gif
2363,Gojira,1954,7.6,57,53,4,92,7.5,17,15,2,88,4.1,2309,86,http://content7.flixster.com/movie/24/83/54/2483545_det.jpg
2364,Godzilla,1998,4.7,59,15,44,25,5.7,9,3,6,33,2.6,17658,38,http://content9.flixster.com/movie/25/99/259919_det.jpg
2365,Kingu Kongu tai Gojira,1962,4.4,11,4,7,36,0,1,0,1,0,3.1,2636,49,http://content9.flixster.com/movie/10/93/36/10933603_det.jpg
2366,King Kong,2005,7.7,242,202,40,83,7.6,39,30,9,76,2.8,207337,52,http://content8.flixster.com/movie/10/93/36/10933606_det.jpg
2367,King Kong,2005,7.7,242,202,40,83,7.6,39,30,9,76,2.8,207337,52,http://content8.flixster.com/movie/10/93/36/10933606_det.jpg
2368,King Kong Lives,1986,1.6,9,0,9,0,0,2,0,2,0,2.7,5069,37,http://content6.flixster.com/movie/10/93/36/10933604_det.jpg
2369,Desperately Seeking Susan,1985,6.7,23,20,3,86,0,3,3,0,100,2.8,3449,55,http://content9.flixster.com/movie/10/85/87/10858779_det.jpg
2370,The Emerald Forest,1985,7.2,15,13,2,86,0,0,0,0,0,0,0,0,http://content8.flixster.com/movie/10/87/04/10870434_det.jpg
2371,Fletch,1985,6.4,28,21,7,75,0,4,3,1,75,3.3,6895,78,http://content7.flixster.com/movie/25/49/254921_det.jpg
2372,Fletch Lives,1989,4.1,13,4,9,30,0,1,0,1,0,2.9,2636,53,http://content6.flixster.com/movie/10/22/09/10220968_det.jpg
2373,Red Sonja,2011,0,0,0,0,0,0,0,0,0,0,0,0,0,http://content6.flixster.com/movie/10/89/27/10892708_det.jpg
2374,Gung Ho,1986,5.3,14,6,8,42,0,1,0,1,0,3,1121,45,http://content8.flixster.com/movie/25/77/257706_det.jpg
2375,The Money Pit,1986,4.8,19,9,10,47,0,1,0,1,0,3,7189,59,http://content8.flixster.com/movie/10/88/20/10882090_det.jpg
2376,A View to a Kill,1985,4.8,41,16,25,39,3.6,5,0,5,0,3.1,12502,49,http://content7.flixster.com/movie/10/84/49/10844985_det.jpg
2377,Lifeforce,1985,5.4,14,8,6,57,0,0,0,0,0,0,0,0,http://content7.flixster.com/movie/27/01/270125_det.jpg
2378,Police Academy,1984,4.6,15,7,8,46,0,0,0,0,0,0,0,0,http://content9.flixster.com/movie/55/35/80/5535807_det.jpg
2379,Police Academy 2: Their First Assignment,1985,3.1,13,3,10,23,0,0,0,0,0,0,0,0,http://content6.flixster.com/movie/63/13/98/6313984_det.jpg
2380,Police Academy 3: Back in Training,1986,4.2,10,4,6,40,0,1,1,0,100,2.8,6533,49,http://content9.flixster.com/movie/10/92/26/10922667_det.jpg
2381,Police Academy 4: Citizens on Patrol,1987,2.4,18,0,18,0,0,3,0,3,0,2.7,6328,46,http://content6.flixster.com/movie/74/31/04/7431048_det.jpg
2382,Police Academy 5: Assignment: Miami Beach,1988,0,2,0,2,0,0,0,0,0,0,0,0,0,http://content9.flixster.com/movie/74/32/49/7432491_det.jpg
2383,Police Academy 6: City Under Siege,1989,1.2,7,0,7,0,0,0,0,0,0,0,0,0,http://content9.flixster.com/movie/10/87/13/10871319_det.jpg
2384,Babe: Pig in the City,1998,6.2,58,35,23,60,5.8,14,8,6,57,2.8,9741,45,http://content6.flixster.com/movie/10/88/34/10883432_det.jpg
2385,Home Fries,1998,4.8,35,11,24,31,4.4,6,1,5,16,2.5,4100,34,http://content8.flixster.com/movie/26/35/263598_det.jpg
2386,Ringmaster,1998,3,23,5,18,21,0,4,1,3,25,2.1,443,19,http://content9.flixster.com/movie/28/53/285323_det.jpg
2387,Very Bad Things,1998,5.6,50,22,28,44,5.1,12,3,9,25,3,5484,57,http://content9.flixster.com/movie/55/04/79/5504799_det.jpg
2388,Hamam,1997,6.3,16,13,3,81,6.4,5,3,2,60,3.7,781,75,http://content6.flixster.com/movie/10/88/94/10889472_det.jpg
2389,Psycho,1960,8.9,67,66,1,98,7.5,8,7,1,87,3.9,32475,90,http://content7.flixster.com/movie/68/89/78/6889781_det.jpg
2390,Little Voice,1998,7.2,35,29,6,82,7.3,7,5,2,71,3.4,2979,68,http://content7.flixster.com/movie/27/33/273305_det.jpg
2391,A Simple Plan,1998,8.1,51,46,5,90,8.2,8,7,1,87,3.4,7546,74,http://content8.flixster.com/movie/27/20/272022_det.jpg
2392,Jack Frost,1998,3.8,47,7,40,14,4,14,3,11,21,2.8,6973,48,http://content7.flixster.com/movie/45/04/450445_det.jpg
2393,Star Trek: Insurrection,1998,5.8,64,35,29,54,6.7,12,9,3,75,3.1,13225,53,http://content8.flixster.com/movie/10/88/85/10888598_det.jpg
2394,The Prince of Egypt,1998,7,82,64,18,78,6.7,25,18,7,72,3.1,16105,67,http://content6.flixster.com/movie/10/61/21/10612176_det.jpg
2395,Rushmore,1998,7.8,82,71,11,86,7.4,17,13,4,76,3.7,34168,91,http://content8.flixster.com/movie/10/84/17/10841706_det.jpg
2396,Shakespeare in Love,1998,8.1,101,94,7,93,8,25,23,2,92,3.3,30161,76,http://content9.flixster.com/movie/27/61/276127_det.jpg
2397,Mass Appeal,1984,0,2,2,0,100,0,0,0,0,0,0,0,0,http://content6.flixster.com/movie/19/57/91/1957912_det.jpg
2398,Miracle on 34th Street,1947,8,31,29,2,93,0,2,2,0,100,3.5,5409,81,http://content7.flixster.com/movie/29/05/290513_det.jpg
2399,Santa Claus,1985,4.1,17,3,14,17,0,1,0,1,0,3.1,2513,66,http://content7.flixster.com/movie/25/49/254909_det.jpg
2400,Prancer,1989,6,16,11,5,68,0,3,2,1,66,3,1515,53,http://content6.flixster.com/movie/25/12/251296_det.jpg
2401,Pale Rider,1985,7.3,24,22,2,91,0,4,3,1,75,3.6,8286,78,http://content9.flixster.com/movie/26/87/268795_det.jpg
2402,Rambo: First Blood Part II,1985,4.1,30,9,21,30,0,2,0,2,0,3.1,18865,63,http://content8.flixster.com/movie/11/13/69/11136978_det.jpg
2403,First Blood,1982,7.1,35,30,5,85,6.2,5,4,1,80,3.5,23595,81,http://content6.flixster.com/movie/11/13/69/11136980_det.jpg
2404,Rambo III,1988,4.6,28,10,18,35,0,4,2,2,50,2.9,16200,51,http://content6.flixster.com/movie/28/42/284216_det.jpg
2405,The Jewel of the Nile,1985,4.9,19,9,10,47,0,1,1,0,100,3,7338,45,http://content7.flixster.com/movie/25/81/258117_det.jpg
2406,Romancing the Stone,1984,7,42,36,6,85,0,4,1,3,25,3.2,14494,62,http://content6.flixster.com/movie/24/63/50/2463504_det.jpg
2407,Cocoon,1985,6.1,23,18,5,78,0,4,3,1,75,3.1,7543,55,http://content6.flixster.com/movie/25/91/259100_det.jpg
2408,Cocoon: The Return,1988,4.6,10,3,7,30,0,1,0,1,0,2.7,2029,37,http://content7.flixster.com/movie/26/09/260925_det.jpg
2409,Rocky II,1979,6.4,23,16,7,69,0,3,2,1,66,3.4,51625,79,http://content9.flixster.com/movie/10/65/79/10657999_det.jpg
2410,Rocky III,1982,5.4,29,18,11,62,0,2,1,1,50,3.3,48532,74,http://content7.flixster.com/movie/26/42/264213_det.jpg
2411,Rocky IV,1985,4.7,34,15,19,44,0,4,0,4,0,3.4,53876,79,http://content7.flixster.com/movie/26/13/261393_det.jpg
2412,Rocky V,1990,4,29,7,22,24,3.9,5,2,3,40,2.8,34216,53,http://content6.flixster.com/movie/26/67/266728_det.jpg
2413,Clue,1985,6.2,19,14,5,73,0,2,0,2,0,3.6,16850,85,http://content9.flixster.com/movie/10/84/07/10840775_det.jpg
2414,Young Sherlock Holmes,1985,5.6,19,12,7,63,0,1,1,0,100,3.3,2485,63,http://content8.flixster.com/movie/11/14/28/11142866_det.jpg
2415,Violets Are Blue...,1986,5.3,7,4,3,57,0,1,1,0,100,3.4,93,39,http://content7.flixster.com/movie/99/32/54/9932549_det.jpg
2416,Back to School,1986,6.8,24,21,3,87,0,3,3,0,100,2.9,3814,60,http://content6.flixster.com/movie/74/28/48/7428484_det.jpg
2417,Heartburn,1986,5.7,11,7,4,63,0,1,0,1,0,3.2,1466,52,http://content9.flixster.com/movie/27/30/273011_det.jpg
2418,Nothing in Common,1986,5.8,18,10,8,55,0,1,0,1,0,2.8,1198,38,http://content9.flixster.com/movie/26/21/262127_det.jpg
2419,Extremities,1986,5.9,7,4,3,57,0,0,0,0,0,0,0,0,http://content7.flixster.com/movie/27/74/277409_det.jpg
2420,The Karate Kid,1984,6.9,41,37,4,90,6.9,5,4,1,80,3.3,20688,71,http://content7.flixster.com/movie/11/12/21/11122169_det.jpg
2421,"The Karate Kid, Part II",1986,4.8,20,8,12,40,0,0,0,0,0,0,0,0,http://content9.flixster.com/movie/11/12/21/11122167_det.jpg
2422,"The Karate Kid, Part III",1989,4.1,17,4,13,23,0,2,0,2,0,2.8,9109,46,http://content8.flixster.com/movie/11/12/21/11122166_det.jpg
2423,Christmas Vacation,1989,6.2,34,21,13,61,6,5,2,3,40,3.5,21650,83,http://content9.flixster.com/movie/11/13/24/11132419_det.jpg
2424,You've Got Mail,1998,6.2,75,51,24,68,6.4,20,15,5,75,3.1,60706,70,http://content9.flixster.com/movie/25/38/253811_det.jpg
2425,The General,1926,8.9,38,35,3,92,0,4,2,2,50,4.4,3785,93,http://content6.flixster.com/movie/10/84/02/10840232_det.jpg
2426,The Theory of Flight,1998,5.6,19,10,9,52,5.1,5,1,4,20,3.5,345,63,http://content7.flixster.com/movie/10/88/46/10884673_det.jpg
2427,The Thin Red Line,1998,7.1,80,63,17,78,7.5,22,21,1,95,3.4,27248,75,http://content7.flixster.com/movie/10/86/75/10867513_det.jpg
2428,The Faculty,1998,5.6,37,19,18,51,0,3,0,3,0,2.9,14071,55,http://content8.flixster.com/movie/27/10/271018_det.jpg
2429,Mighty Joe Young,1998,5.8,42,22,20,52,7.2,5,4,1,80,2.8,10755,48,http://content6.flixster.com/movie/59/50/68/5950684_det.jpg
2430,Mighty Joe Young,1998,5.8,42,22,20,52,7.2,5,4,1,80,2.8,10755,48,http://content6.flixster.com/movie/59/50/68/5950684_det.jpg
2431,Patch Adams,1998,4,55,13,42,23,3.8,16,4,12,25,3.3,20869,77,http://content9.flixster.com/movie/26/67/266723_det.jpg
2432,Stepmom,1998,5.1,53,23,30,43,5.3,17,8,9,47,3.3,22696,75,http://content8.flixster.com/movie/25/55/255514_det.jpg
2433,A Civil Action,1998,6.4,66,40,26,60,5.8,13,7,6,53,3.1,3573,53,http://content6.flixster.com/movie/25/60/256024_det.jpg
2434,Down in the Delta,1998,6.8,22,17,5,77,7.4,6,5,1,83,3.6,434,68,http://content8.flixster.com/movie/10/88/75/10887554_det.jpg
2435,Hurlyburly,1998,5.9,34,20,14,58,5.2,6,2,4,33,3.2,1455,56,http://content6.flixster.com/movie/27/49/274920_det.jpg
2436,Tea with Mussolini,1999,6.4,33,22,11,66,6.3,6,3,3,50,3.5,1769,72,http://content9.flixster.com/movie/25/77/257719_det.jpg
2437,Wilde,1997,\N,\N,\N,\N,\N,\N,\N,\N,\N,\N,\N,\N,\N,\N
2439,Affliction,1997,7.6,44,38,6,86,8.8,7,7,0,100,3.4,1078,69,http://content6.flixster.com/movie/28/23/282312_det.jpg
2440,Another Day in Paradise,1998,5.7,46,26,20,56,6.1,12,7,5,58,3.2,1703,57,http://content8.flixster.com/movie/28/72/287214_det.jpg
2441,The Hi-Lo Country,1998,5.4,34,19,15,55,4.9,15,6,9,40,3.1,620,43,http://content7.flixster.com/movie/28/32/283293_det.jpg
2442,Hilary and Jackie,1998,7.5,43,38,5,88,7.9,13,12,1,92,3.7,1702,81,http://content7.flixster.com/movie/28/50/285029_det.jpg
2443,Playing by Heart,1998,6,51,32,19,62,6,12,6,6,50,3.6,5334,76,http://content6.flixster.com/movie/26/79/267924_det.jpg
2444,24 7: Twenty Four Seven,1997,5.7,20,7,13,35,5.6,5,1,4,20,3.9,451,84,http://content8.flixster.com/movie/10/87/22/10872274_det.jpg
2445,At First Sight,1999,5.2,36,12,24,33,5.4,6,1,5,16,2.9,2599,48,http://content9.flixster.com/movie/10/88/64/10886407_det.jpg
2446,Requiem for a Dream,2000,7.4,127,99,28,77,6.6,32,21,11,65,4.1,103666,93,http://content9.flixster.com/movie/29/00/290095_det.jpg
2447,Varsity Blues,1999,5,51,20,31,39,5,13,5,8,38,3.2,17053,75,http://content8.flixster.com/movie/26/83/268322_det.jpg
2448,Virus,1999,3.2,44,4,40,9,2.8,13,1,12,7,2.4,2719,26,http://content8.flixster.com/movie/10/92/06/10920690_det.jpg
2449,The Garbage Pail Kids Movie,1987,1.9,11,0,11,0,0,1,0,1,0,2.6,1589,37,http://content6.flixster.com/movie/25/52/255220_det.jpg
2450,Howard the Duck,1986,2.5,32,5,27,15,0,3,0,3,0,2.6,7309,43,http://content6.flixster.com/movie/10/86/80/10868032_det.jpg
2451,The Ninth Gate,1999,4.9,85,35,50,41,4,24,6,18,25,3.2,23993,60,http://content8.flixster.com/movie/26/73/267302_det.jpg
2452,The Gate II: Trespassers,1990,0,0,0,0,0,0,0,0,0,0,0,0,0,http://content7.flixster.com/movie/10/83/87/10838773_det.jpg
2453,The Boy Who Could Fly,1986,5.9,16,11,5,68,0,1,1,0,100,3.2,1754,63,http://content8.flixster.com/movie/26/06/260626_det.jpg
2454,The Fly,1986,8,44,40,4,90,0,3,1,2,33,3.3,14099,74,http://content7.flixster.com/movie/11/15/27/11152781_det.jpg
2455,The Fly,1986,8,44,40,4,90,0,3,1,2,33,3.3,14099,74,http://content7.flixster.com/movie/11/15/27/11152781_det.jpg
2456,The Fly II,1989,4.4,15,4,11,26,0,0,0,0,0,0,0,0,http://content8.flixster.com/movie/55/37/20/5537202_det.jpg
2457,Running Scared,2006,4.5,128,51,77,39,4.4,31,10,21,32,3.6,35992,77,http://content8.flixster.com/movie/31/27/312798_det.jpg
2458,Armed and Dangerous,1986,3,7,1,6,14,0,0,0,0,0,0,0,0,http://content7.flixster.com/movie/26/07/260713_det.jpg
2459,The Texas Chainsaw Massacre,2003,4.8,152,55,97,36,4.2,33,6,27,18,3.2,36030,67,http://content7.flixster.com/movie/11/13/31/11133149_det.jpg
2460,The Texas Chainsaw Massacre 2,1986,4.6,21,9,12,42,0,2,0,2,0,2.9,8495,51,http://content8.flixster.com/movie/11/13/31/11133146_det.jpg
2461,Leatherface: Texas Chainsaw Massacre III,1990,3.4,14,2,12,14,0,1,0,1,0,2.9,6411,52,http://content6.flixster.com/movie/11/13/31/11133160_det.jpg
2462,The Return of the Texas Chainsaw Massacre,1994,3.2,28,4,24,14,0,4,0,4,0,2.4,5539,34,http://content6.flixster.com/movie/11/13/31/11133148_det.jpg
2463,Ruthless People,1986,6.7,21,19,2,90,0,1,1,0,100,3.1,3852,62,http://content6.flixster.com/movie/26/87/268720_det.jpg
2464,Trick 'r Treat,2007,7.5,20,17,3,85,0,1,1,0,100,3.5,15410,67,http://content8.flixster.com/movie/10/85/55/10855534_det.jpg
2465,Deadly Friend,1986,3.7,6,0,6,0,0,0,0,0,0,0,0,0,http://content6.flixster.com/movie/10/89/00/10890048_det.jpg
2466,Belizaire the Cajun,1986,6.2,6,4,2,66,0,1,1,0,100,3.6,147,63,http://content7.flixster.com/movie/10/02/08/10020865_det.jpg
2467,Der Name der Rose,1986,6.2,18,13,5,72,0,1,0,1,0,3.6,8830,83,http://content6.flixster.com/movie/10/87/20/10872096_det.jpg
2468,Jumpin' Jack Flash,1986,3.9,18,5,13,27,0,1,0,1,0,2.8,4253,55,http://content6.flixster.com/movie/26/81/268196_det.jpg
2469,Peggy Sue Got Married,1986,6.8,24,21,3,87,6.8,7,5,2,71,2.9,5428,47,http://content9.flixster.com/movie/10/88/36/10883627_det.jpg
2470,Crocodile Dundee,1986,6.6,26,23,3,88,0,2,1,1,50,3,11828,55,http://content7.flixster.com/movie/25/53/255309_det.jpg
2471,'Crocodile' Dundee II,1988,3.6,21,3,18,14,0,0,0,0,0,0,0,0,http://content8.flixster.com/movie/25/68/256818_det.jpg
2472,Tough Guys Don't Dance,1987,4.9,18,7,11,38,0,4,2,2,50,3.3,251,49,http://content7.flixster.com/movie/10/27/21/10272101_det.jpg
2473,Soul Man,1986,3,22,3,19,13,0,4,1,3,25,2.6,1023,37,http://content9.flixster.com/movie/10/92/10/10921031_det.jpg
2474,The Color of Money,1986,7.3,34,31,3,91,6.8,8,6,2,75,3.3,8226,65,http://content7.flixster.com/movie/26/80/268025_det.jpg
2475,52 Pick-Up,1986,5.8,10,5,5,50,0,1,1,0,100,3.1,248,48,http://content9.flixster.com/movie/74/16/65/7416651_det.jpg
2476,Heartbreak Ridge,1986,6.7,13,11,2,84,0,1,1,0,100,3.5,4368,73,http://content6.flixster.com/movie/26/87/268724_det.jpg
2477,Firewalker,1986,3,10,0,10,0,0,4,0,4,0,2.8,1109,41,http://content7.flixster.com/movie/25/99/259913_det.jpg
2478,¡Three Amigos!,1986,5.2,17,9,8,52,0,1,0,1,0,3.1,12978,65,http://content7.flixster.com/movie/25/45/254593_det.jpg
2479,Gloria,1999,4.1,27,5,22,18,5.1,6,1,5,16,2.7,660,31,http://content8.flixster.com/movie/28/25/282502_det.jpg
2480,Nettoyage à sec,1997,6.6,15,12,3,80,0,2,2,0,100,3.1,198,46,http://content7.flixster.com/movie/29/00/290097_det.jpg
2481,My Name Is Joe,1998,7.3,23,20,3,86,8.1,5,5,0,100,3.8,1146,81,http://content8.flixster.com/movie/10/92/00/10920026_det.jpg
2482,Still Crazy,1998,6.5,25,18,7,72,7,6,4,2,66,3.8,1495,81,http://content7.flixster.com/movie/27/17/271701_det.jpg
2483,El día de la bestia,1995,6.7,9,7,2,77,0,0,0,0,0,0,0,0,http://content8.flixster.com/movie/10/88/29/10882962_det.jpg
2485,She's All That,1999,4.9,55,21,34,38,4.8,12,3,9,25,3,53730,60,http://content9.flixster.com/movie/25/70/257015_det.jpg
2486,The 24 Hour Woman,1999,5.8,14,8,6,57,0,4,3,1,75,3.4,50,50,http://content7.flixster.com/movie/10/85/18/10851889_det.jpg
2487,"Blood, Guts, Bullets and Octane",1998,5.4,22,10,12,45,0,3,0,3,0,2.9,645,40,http://content6.flixster.com/movie/10/94/87/10948704_det.jpg
2488,Peeping Tom,1960,8.2,31,29,2,93,7.2,7,5,2,71,4,3195,85,http://content7.flixster.com/movie/10/93/89/10938985_det.gif
2489,Spanish Fly,1976,\N,\N,\N,\N,\N,\N,\N,\N,\N,\N,\N,\N,\N,\N
2490,Payback,1999,5.8,70,36,34,51,5,19,8,11,42,3.2,12940,67,http://content8.flixster.com/movie/26/99/269918_det.jpg
2491,Simply Irresistible,1999,4,29,4,25,13,4.9,5,1,4,20,2.9,6203,55,http://content9.flixster.com/movie/10/93/06/10930671_det.jpg
2492,20 Dates,1998,4.8,31,12,19,38,3.1,10,0,10,0,0,0,0,http://content6.flixster.com/movie/50/89/30/5089308_det.jpg
2493,Comedian Harmonists,1997,7,35,28,7,80,7.3,11,9,2,81,3.8,302,84,http://content6.flixster.com/movie/27/39/273912_det.jpg
2494,Last Days,2005,5.9,111,64,47,57,6,35,23,12,65,3.1,5692,53,http://content8.flixster.com/movie/97/93/84/9793842_det.jpg
2495,La planète sauvage,1973,7.1,22,19,3,86,0,2,1,1,50,4,2423,86,http://content8.flixster.com/movie/10/94/96/10949678_det.jpg
2496,Blast from the Past,1999,6.1,35,21,14,60,6.7,5,4,1,80,2.9,12330,54,http://content7.flixster.com/movie/25/55/255505_det.jpg
2497,Message in a Bottle,1999,5.2,35,11,24,31,6,5,3,2,60,3.2,17649,67,http://content8.flixster.com/movie/25/52/255222_det.jpg
2498,My Favorite Martian,1963,\N,\N,\N,\N,\N,\N,\N,\N,\N,\N,\N,\N,\N,\N
2499,"God Said, 'Ha!'",1998,6.9,21,18,3,85,7.6,5,5,0,100,3.4,398,67,http://content8.flixster.com/movie/10/92/08/10920822_det.jpg
2500,Jawbreaker,1999,3.3,57,4,53,7,3,19,0,19,0,2.8,8386,54,http://content9.flixster.com/movie/27/40/274003_det.jpg
2501,October Sky,1999,7.6,70,63,7,90,7.2,14,12,2,85,3.6,12678,84,http://content9.flixster.com/movie/10/90/79/10907951_det.jpg
2502,Office Space,1999,6.8,88,70,18,79,6.4,24,17,7,70,4,78802,92,http://content6.flixster.com/movie/26/77/267704_det.jpg
2503,Sib,1998,7,20,16,4,80,8.2,5,5,0,100,3.7,409,77,http://content6.flixster.com/movie/54/93/28/5493284_det.jpg
2504,200 Cigarettes,1999,4.5,57,17,40,29,3.9,19,5,14,26,3,5146,54,http://content9.flixster.com/movie/27/52/275211_det.jpg
2505,8MM,1999,4.2,78,17,61,21,3.1,21,2,19,9,3,14973,56,http://content6.flixster.com/movie/27/13/271392_det.jpg
2506,The Other Sister,1999,4.7,48,14,34,29,4.6,13,4,9,30,3.3,8954,68,http://content9.flixster.com/movie/10/85/05/10850507_det.jpg
2507,Breakfast of Champions,1999,4.2,44,11,33,25,3.4,13,1,12,7,2.5,1509,31,http://content6.flixster.com/movie/10/88/32/10883264_det.jpg
2508,The Break-Up,2006,5,187,62,125,33,4.5,40,8,32,20,3.1,107481,52,http://content8.flixster.com/movie/10/89/28/10892870_det.jpg
2509,Eight Days a Week,1997,3.8,9,2,7,22,0,0,0,0,0,0,0,0,http://content9.flixster.com/movie/10/89/50/10895035_det.jpg
2510,Just the Ticket,1999,4.5,10,2,8,20,0,3,0,3,0,3,410,41,http://content8.flixster.com/movie/10/87/62/10876210_det.jpg
2511,The Long Goodbye,1973,8.2,24,23,1,95,0,2,2,0,100,4,2667,88,http://content8.flixster.com/movie/27/12/271202_det.jpg
2512,Narayama-bushi kô,1983,8.2,9,9,0,100,0,1,1,0,100,4.3,634,91,http://content9.flixster.com/movie/54/85/56/5485567_det.jpg
2513,Pet Sematary,1989,5.2,18,9,9,50,0,0,0,0,0,0,0,0,http://content9.flixster.com/movie/10/89/14/10891447_det.jpg
2514,Pet Sematary II,1992,4,16,5,11,31,0,0,0,0,0,0,0,0,http://content9.flixster.com/movie/27/33/273307_det.jpg
2515,Children of the Corn II: The Final Sacrifice,1992,2.3,8,2,6,25,0,1,0,1,0,2.8,2650,39,http://content6.flixster.com/movie/10/91/84/10918488_det.jpg
2516,Children of the Corn III: Urban Harvest,1995,0,1,0,1,0,0,0,0,0,0,0,0,0,http://content8.flixster.com/movie/10/91/84/10918482_det.jpg
2517,Christine,1983,5.7,21,14,7,66,0,4,1,3,25,3.2,10394,63,http://content7.flixster.com/movie/27/27/272713_det.jpg
2518,Night Shift,1982,6.4,19,17,2,89,0,2,1,1,50,3.2,1720,55,http://content7.flixster.com/movie/27/12/271213_det.jpg
2519,House on Haunted Hill,1999,4.4,53,13,40,24,3.5,11,2,9,18,2.9,13288,49,http://content9.flixster.com/movie/10/83/95/10839519_det.jpg
2520,Airport,1970,5.9,13,9,4,69,0,1,0,1,0,3.1,2253,48,http://content8.flixster.com/movie/25/28/252814_det.jpg
2521,Airport 1975,1974,4.8,12,4,8,33,0,1,0,1,0,2.9,1688,36,http://content8.flixster.com/movie/10/86/72/10867214_det.jpg
2522,Airport '77,1977,0,0,0,0,0,0,0,0,0,0,0,0,0,http://images.rottentomatoescdn.com/images/defaults/poster_default.gif
2523,Rollercoaster,1977,6,6,3,3,50,0,0,0,0,0,0,0,0,http://content9.flixster.com/movie/26/40/264019_det.jpg
2524,The Towering Inferno,1974,6.4,19,15,4,78,0,1,1,0,100,3.3,4474,67,http://content6.flixster.com/movie/10/91/66/10916636_det.gif
2525,Albino Alligator,1996,5.5,17,8,9,47,5.4,6,2,4,33,3,1198,42,http://content8.flixster.com/movie/10/83/84/10838426_det.jpg
2526,Meteor,1979,3.6,11,1,10,9,0,0,0,0,0,0,0,0,http://content9.flixster.com/movie/98/66/17/9866171_det.jpg
2527,Westworld,1973,7.1,30,27,3,90,0,3,3,0,100,3.5,4334,68,http://content6.flixster.com/movie/26/56/265600_det.jpg
2528,Logan's Run,1976,6.2,27,19,8,70,0,3,2,1,66,3.3,9250,65,http://content8.flixster.com/movie/26/47/264710_det.jpg
2529,Planet of the Apes,1968,7.4,44,39,5,88,5.5,5,3,2,60,3.4,12844,80,http://content7.flixster.com/movie/11/14/82/11148265_det.jpg
2530,Beneath the Planet of the Apes,1970,5.3,22,9,13,40,0,1,0,1,0,3,4261,46,http://content7.flixster.com/movie/10/94/47/10944737_det.jpg
2531,Battle for the Planet of the Apes,1973,4.7,24,9,15,37,0,2,0,2,0,2.9,3262,38,http://content9.flixster.com/movie/10/94/47/10944739_det.jpg
2532,Conquest of the Planet of the Apes,1972,5.5,18,8,10,44,0,2,1,1,50,3,3697,49,http://content6.flixster.com/movie/10/94/47/10944736_det.jpg
2533,Escape from the Planet of the Apes,1971,5.7,23,18,5,78,0,2,2,0,100,3,3852,49,http://content9.flixster.com/movie/10/94/47/10944735_det.jpg
2534,Avalanche Alley,2001,0,0,0,0,0,0,0,0,0,0,0,0,0,http://content8.flixster.com/movie/10/19/87/10198766_det.jpg
2535,10.5,2004,0,0,0,0,0,0,0,0,0,0,0,0,0,http://content9.flixster.com/movie/10/92/16/10921679_det.jpg
2536,The Concorde... Airport '79,1979,4.3,5,1,4,20,0,2,1,1,50,2.5,369,23,http://content6.flixster.com/movie/10/86/72/10867212_det.jpg
2537,Beyond the Poseidon Adventure,1979,0,2,0,2,0,0,1,0,1,0,2.7,1212,33,http://content6.flixster.com/movie/10/93/20/10932028_det.jpg
2538,Dancemaker,1998,7.9,10,9,1,90,0,2,2,0,100,0,0,0,http://content9.flixster.com/movie/10/94/54/10945419_det.jpg
2539,Analyze This,1999,6.4,101,69,32,68,6,22,14,8,63,3.1,15881,57,http://content6.flixster.com/movie/27/09/270996_det.jpg
2540,The Corruptor,1999,5.3,46,22,24,47,5.7,15,8,7,53,3,2255,43,http://content7.flixster.com/movie/27/57/275717_det.jpg
2541,Cruel Intentions,1999,5.3,76,36,40,47,4.7,24,9,15,37,3.4,56824,79,http://content8.flixster.com/movie/11/12/58/11125862_det.jpg
2542,"Lock, Stock and Two Smoking Barrels",1998,6.8,51,37,14,72,5.9,14,8,6,57,4,81696,92,http://content6.flixster.com/movie/10/51/33/10513304_det.jpg
2543,Six Ways to Sunday,1997,4.8,10,4,6,40,0,1,0,1,0,3.3,459,58,http://content6.flixster.com/movie/27/80/278092_det.jpg
2544,L'école de la chair,1998,6.1,18,13,5,72,0,4,4,0,100,3.5,272,59,http://content9.flixster.com/movie/28/37/283715_det.jpg
2545,Relax... It's Just Sex,1998,5.9,16,8,8,50,0,3,2,1,66,3.4,732,64,http://content7.flixster.com/movie/28/36/283605_det.jpg
2546,The Deep End of the Ocean,1999,5.8,33,14,19,42,5.2,7,1,6,14,3.2,2998,62,http://content9.flixster.com/movie/26/23/262315_det.jpg
2548,The Rage: Carrie 2,1999,0,0,0,0,0,0,0,0,0,0,0,0,0,http://content9.flixster.com/movie/10/84/85/10848535_det.jpg
2549,Wing Commander,1999,2.8,46,5,41,10,2.2,11,0,11,0,2.2,2768,26,http://content6.flixster.com/movie/11/11/98/11119824_det.jpg
2550,The Haunting,1999,3.7,87,15,72,17,3.1,24,3,21,12,2.7,10812,42,http://content7.flixster.com/movie/10/81/95/10819505_det.jpg
2551,Dead Ringers,1988,7.7,35,29,6,82,5.7,6,3,3,50,3.6,4690,80,http://content6.flixster.com/movie/28/49/284996_det.jpg
2552,My Boyfriend's Back,1993,3.4,10,1,9,10,0,2,0,2,0,2.7,1035,43,http://content7.flixster.com/movie/26/21/262125_det.jpg
2553,Village of the Damned,1995,4,30,9,21,30,4.2,5,2,3,40,2.7,4194,36,http://content6.flixster.com/movie/11/15/07/11150724_det.jpg
2554,Children of the Damned,1964,5.6,12,9,3,75,0,0,0,0,0,0,0,0,http://content6.flixster.com/movie/46/78/04/4678048_det.jpg
2555,Baby Geniuses,1999,1.9,43,1,42,2,2.1,10,0,10,0,2.5,8215,32,http://content7.flixster.com/movie/10/09/74/10097481_det.jpg
2556,Telling You,1998,5.6,5,1,4,20,0,0,0,0,0,0,0,0,http://content7.flixster.com/movie/28/18/281817_det.jpg
2557,Seul contre tous,1998,7.7,20,17,3,85,0,2,2,0,100,3.9,1587,82,http://content8.flixster.com/movie/10/92/06/10920666_det.jpg
2558,Forces of Nature,1999,5.3,63,29,34,46,4.7,18,6,12,33,2.6,7489,37,http://content8.flixster.com/movie/26/02/260294_det.jpg
2559,The King and I,1956,8.2,19,19,0,100,0,1,1,0,100,3.6,12939,79,http://content9.flixster.com/movie/10/93/55/10935535_det.jpg
2560,Ravenous,1999,5.5,36,14,22,38,5.2,6,2,4,33,3.6,4588,78,http://content6.flixster.com/movie/27/15/271516_det.jpg
2561,True Crime,1999,6,38,20,18,52,6.8,6,5,1,83,3.2,2873,51,http://content6.flixster.com/movie/27/47/274704_det.jpg
2562,Bandits,2001,6.1,136,86,50,63,5.9,34,20,14,58,3.1,9238,56,http://content8.flixster.com/movie/25/90/259014_det.jpg
2563,Dangerous Beauty,1998,6.4,26,18,8,69,6.8,7,5,2,71,4.1,2764,87,http://content9.flixster.com/movie/10/88/40/10884011_det.jpg
2565,The King and I,1956,8.2,19,19,0,100,0,1,1,0,100,3.6,12939,79,http://content9.flixster.com/movie/10/93/55/10935535_det.jpg
2566,Doug's 1st Movie,1999,4.6,32,8,24,25,4.4,9,3,6,33,2.9,1446,43,http://content9.flixster.com/movie/10/92/34/10923411_det.jpg
2567,Edtv,1999,6.3,42,26,16,61,6.2,7,3,4,42,2.6,8130,31,http://content8.flixster.com/movie/26/08/260802_det.jpg
2568,The Mod Squad,1999,3,51,2,49,3,3.4,13,1,12,7,2.4,1890,21,http://content7.flixster.com/movie/10/90/66/10906641_det.jpg
2569,Among Giants,1998,5.5,19,11,8,57,0,4,2,2,50,3.2,111,33,http://content9.flixster.com/movie/88/17/07/8817071_det.jpg
2570,A Walk on the Moon,1999,6.7,35,25,10,71,6.6,6,4,2,66,3.4,2848,67,http://content8.flixster.com/movie/26/82/268206_det.jpg
2571,The Matrix,1999,7.4,125,108,17,86,6.2,28,19,9,67,3.6,207333,81,http://content7.flixster.com/movie/16/90/52/1690525_det.jpg
2572,10 Things I Hate About You,1999,6,58,34,24,58,6.3,12,7,5,58,3.3,207830,69,http://content8.flixster.com/movie/11/15/34/11153458_det.jpg
2573,Tango,1998,6.8,20,14,6,70,8.5,5,4,1,80,3.9,767,82,http://content9.flixster.com/movie/10/88/99/10889971_det.jpg
2574,The Out-of-Towners,1999,5,34,8,26,23,4.9,5,1,4,20,2.6,2186,33,http://content6.flixster.com/movie/26/24/262496_det.jpg
2575,La vie rêvée des anges,1998,7.6,42,39,3,92,8,13,13,0,100,3.9,1181,83,http://content8.flixster.com/movie/10/89/39/10893934_det.jpg
2576,"Love, etc.",1996,0,4,2,2,50,0,1,1,0,100,3.2,217,54,http://content6.flixster.com/movie/30/78/307828_det.jpg
2577,Metroland,1997,6.4,27,17,10,62,0,4,3,1,75,3.3,1014,55,http://content6.flixster.com/movie/10/07/07/10070744_det.jpg
2578,The Sticky Fingers of Time,1997,6.2,5,4,1,80,0,2,2,0,100,3,247,48,http://content8.flixster.com/movie/30/88/308802_det.jpg
2579,Following,1998,7.1,21,16,5,76,0,3,1,2,33,3.8,7121,85,http://content6.flixster.com/movie/27/19/271928_det.jpg
2580,Go,1999,7.6,72,66,6,91,7,19,15,4,78,3.2,8608,72,http://content9.flixster.com/movie/96/21/35/9621359_det.jpg
2581,Never Been Kissed,1999,5.7,79,44,35,55,5.4,25,12,13,48,3.3,53088,70,http://content8.flixster.com/movie/26/46/264622_det.jpg
2582,Shuang long hui,1992,5.1,37,16,21,43,4.5,7,3,4,42,3.1,3144,55,http://content9.flixster.com/movie/26/13/261391_det.jpg
2583,Cookie's Fortune,1999,7.5,55,47,8,85,7.4,12,11,1,91,3.2,1364,57,http://content7.flixster.com/movie/26/33/263325_det.jpg
2584,Foolish Wives,1922,9,7,7,0,100,0,0,0,0,0,0,0,0,http://content6.flixster.com/movie/10/93/43/10934300_det.jpg
2585,Los amantes del Círculo Polar,1998,7,23,19,4,82,0,4,4,0,100,4.3,3613,92,http://content6.flixster.com/movie/20/53/11/2053116_det.jpg
2586,Goodbye Lover,1998,4.7,33,10,23,30,3.6,10,1,9,10,2.9,457,35,http://content7.flixster.com/movie/27/57/275729_det.jpg
2587,Waking Life,2001,7.4,137,109,28,79,7.6,32,26,6,81,4,17715,87,http://content6.flixster.com/movie/26/70/267000_det.jpg
2589,Friends & Lovers,1999,0,0,0,0,0,0,0,0,0,0,0,0,0,http://content8.flixster.com/movie/10/87/56/10875646_det.jpg
2590,Hideous Kinky,1998,5.9,34,21,13,61,0,4,3,1,75,3.3,2069,56,http://content7.flixster.com/movie/27/38/273809_det.jpg
2591,Jeanne et le garçon formidable,1998,5.8,5,3,2,60,0,2,2,0,100,3.3,323,55,http://content9.flixster.com/movie/11/14/85/11148555_det.jpg
2593,Il mostro,1994,5.8,10,4,6,40,0,1,0,1,0,3.8,1005,78,http://content6.flixster.com/movie/10/89/45/10894520_det.jpg
2594,Abre los ojos,1997,7.4,45,38,7,84,6.9,8,6,2,75,3.9,11790,85,http://content9.flixster.com/movie/11/12/75/11127527_det.jpg
2595,Fotoamator,1998,\N,\N,\N,\N,\N,\N,\N,\N,\N,\N,\N,\N,\N,\N
2596,SLC Punk!,1998,5.6,31,19,12,61,6.2,5,3,2,60,3.8,9837,89,http://content7.flixster.com/movie/26/96/269621_det.jpg
2597,Lost & Found,1999,3.6,52,7,45,13,2.8,18,0,18,0,2.5,1416,30,http://content9.flixster.com/movie/11/15/13/11151339_det.jpg
2598,Pushing Tin,1999,5.6,65,32,33,49,5.5,16,8,8,50,2.9,5381,43,http://content8.flixster.com/movie/27/16/271610_det.jpg
2599,Election,1999,7.8,101,93,8,92,7.7,23,21,2,91,3.3,11134,72,http://content9.flixster.com/movie/28/43/284319_det.jpg
2600,eXistenZ,1999,6.7,62,44,18,70,5.7,10,5,5,50,3.2,10592,65,http://content7.flixster.com/movie/26/87/268709_det.jpg
2601,A Little Bit of Soul,1998,0,4,2,2,50,0,0,0,0,0,0,0,0,http://content9.flixster.com/movie/10/87/32/10873203_det.jpg
2602,Xing xing wang,1977,0,0,0,0,0,0,0,0,0,0,0,0,0,http://content6.flixster.com/movie/10/85/66/10856648_det.jpg
2603,Revolutionary Road,2008,6.7,194,133,61,68,6.9,36,25,11,69,3.5,46044,70,http://content8.flixster.com/movie/10/88/40/10884042_det.jpg
2604,Let It Come Down: The Life of Paul Bowles,1998,0,3,3,0,100,0,2,2,0,100,3,172,45,http://content9.flixster.com/movie/30/68/306815_det.jpg
2605,Entrapment,1999,5.2,80,30,50,37,4.7,18,7,11,38,3,17343,57,http://content8.flixster.com/movie/26/39/263902_det.jpg
2606,Idle Hands,1999,3.4,53,8,45,15,3,17,1,16,5,2.9,8232,57,http://content8.flixster.com/movie/10/87/43/10874314_det.jpg
2607,Get Real,1998,6.4,45,35,10,77,6.4,13,10,3,76,3.8,2164,79,http://content9.flixster.com/movie/27/09/270907_det.jpg
2609,Bian Lian,1996,7.4,18,16,2,88,7.7,5,5,0,100,4.1,775,88,http://content8.flixster.com/movie/29/36/293698_det.jpg
2610,Three Seasons,1999,6.7,30,24,6,80,0,4,4,0,100,0,0,0,http://content6.flixster.com/movie/12/80/57/1280576_det.jpg
2611,The Winslow Boy,1999,7.9,35,34,1,97,8.2,6,6,0,100,3.6,768,70,http://content6.flixster.com/movie/25/19/251912_det.jpg
2612,Mildred Pierce,1945,7.6,30,26,4,86,0,2,2,0,100,4.1,2165,90,http://content7.flixster.com/movie/29/97/299713_det.jpg
2613,Night of the Comet,1984,6.5,20,17,3,85,0,2,2,0,100,3.3,2733,57,http://content8.flixster.com/movie/14/81/67/1481678_det.jpg
2614,Chopping Mall,1986,4.4,5,2,3,40,0,0,0,0,0,0,0,0,http://content8.flixster.com/movie/10/86/43/10864342_det.jpg
2615,My Science Project,1985,3.2,5,1,4,20,0,0,0,0,0,0,0,0,http://content8.flixster.com/movie/26/60/266022_det.jpg
2616,Dick Tracy,1990,5.7,43,28,15,65,4.6,8,3,5,37,2.8,10803,44,http://content7.flixster.com/movie/10/86/72/10867225_det.jpg
2617,The Mummy,1999,5.7,81,44,37,54,5.1,17,7,10,41,3.4,79634,75,http://content9.flixster.com/movie/55/05/83/5505839_det.jpg
2618,The Castle,1997,6.9,33,29,4,87,6.6,6,5,1,83,4.1,3419,91,http://content9.flixster.com/movie/26/92/269291_det.jpg
2619,Mascara,1987,0,0,0,0,0,0,0,0,0,0,0,0,0,http://content8.flixster.com/movie/10/89/46/10894674_det.jpg
2620,This Is My Father,1998,6.7,27,20,7,74,6,5,4,1,80,3.9,442,79,http://content9.flixster.com/movie/10/91/81/10918183_det.jpg
2621,Tian yu,1998,8,24,23,1,95,9,5,5,0,100,3.8,593,81,http://content9.flixster.com/movie/27/62/276223_det.jpg
2622,A Midsummer Night's Dream,1999,0,0,0,0,0,0,0,0,0,0,0,0,0,http://images.rottentomatoescdn.com/images/defaults/poster_default.gif
2623,Trippin',1999,4.2,12,1,11,8,0,4,0,4,0,3.8,73,62,http://content6.flixster.com/movie/10/84/77/10847728_det.jpg
2624,Wandâfuru raifu,1998,6.9,22,18,4,81,0,4,4,0,100,4.1,1840,90,http://content8.flixster.com/movie/29/55/295522_det.jpg
2625,Hak hap,1996,4.9,28,14,14,50,0,1,0,1,0,0,0,0,http://content7.flixster.com/movie/28/46/284617_det.jpg
2626,Edge of Seventeen,1998,0,0,0,0,0,0,0,0,0,0,0,0,0,http://content9.flixster.com/movie/10/85/21/10852115_det.jpg
2627,The Endurance: Shackleton's Legendary Antarctic Expedition,2000,7.7,65,62,3,95,7.9,24,24,0,100,3.8,415,79,http://content7.flixster.com/movie/25/13/251325_det.jpg
2628,Star Wars: Episode I - The Phantom Menace,1999,0,0,0,0,0,0,0,0,0,0,0,0,0,http://content9.flixster.com/movie/10/80/46/10804663_det.jpg
2629,The Love Letter,1999,0,0,0,0,0,0,0,0,0,0,0,0,0,http://content8.flixster.com/movie/10/98/41/10984126_det.jpg
2630,Besieged,1998,7,46,34,12,73,6.7,12,7,5,58,3.7,762,80,http://content8.flixster.com/movie/27/79/277914_det.jpg
2631,Frogs for Snakes,1998,4.4,10,3,7,30,0,2,0,2,0,3.4,141,50,http://content9.flixster.com/movie/10/98/26/10982667_det.jpg
2632,Rekopis znaleziony w Saragossie,1965,7.3,10,9,1,90,0,2,2,0,100,4.2,509,90,http://content7.flixster.com/movie/29/89/298913_det.jpg
2633,The Mummy,1999,5.7,81,44,37,54,5.1,17,7,10,41,3.4,79634,75,http://content9.flixster.com/movie/55/05/83/5505839_det.jpg
2634,The Mummy,1999,5.7,81,44,37,54,5.1,17,7,10,41,3.4,79634,75,http://content9.flixster.com/movie/55/05/83/5505839_det.jpg
2635,The Mummy's Curse,1944,6.2,7,4,3,57,0,0,0,0,0,0,0,0,http://content9.flixster.com/movie/52/44/11/5244119_det.jpg
2636,The Mummy's Ghost,1944,0,4,2,2,50,0,0,0,0,0,0,0,0,http://content8.flixster.com/movie/52/44/37/5244370_det.jpg
2637,The Mummy's Hand,1940,6.1,7,5,2,71,0,0,0,0,0,0,0,0,http://content8.flixster.com/movie/52/44/31/5244318_det.jpg
2638,The Mummy: Tomb of the Dragon Emperor,2008,3.7,161,21,140,13,3.7,32,3,29,9,3,79989,40,http://content8.flixster.com/movie/10/87/58/10875846_det.jpg
2639,Mommie Dearest,1981,5.6,30,17,13,56,4.8,5,2,3,40,3.6,3417,78,http://content8.flixster.com/movie/25/48/254822_det.jpg
2640,Superman,1978,8,52,49,3,94,7.4,6,5,1,83,3.5,39510,77,http://content7.flixster.com/movie/10/86/72/10867249_det.jpg
2641,Superman II,1980,7.4,41,36,5,87,8.4,5,5,0,100,3.2,30072,66,http://content9.flixster.com/movie/25/68/256815_det.jpg
2642,Superman III,1983,4.4,40,9,31,22,0,3,0,3,0,2.7,17727,39,http://content6.flixster.com/movie/26/36/263604_det.jpg
2643,Superman IV: The Quest for Peace,1987,2.8,30,3,27,10,3.2,5,1,4,20,2.5,13076,30,http://content8.flixster.com/movie/26/26/262698_det.jpg
2644,Dracula,1931,7.7,42,39,3,92,7.7,6,6,0,100,3.6,8598,76,http://content9.flixster.com/movie/29/22/292203_det.jpg
2646,House of Dracula,1945,5.7,7,4,3,57,0,1,0,1,0,3.1,1009,41,http://content8.flixster.com/movie/10/88/76/10887610_det.jpg
2647,House of Frankenstein,1944,5.6,10,6,4,60,0,0,0,0,0,0,0,0,http://content7.flixster.com/movie/34/10/20/3410205_det.jpg
2648,Frankenstein,1931,8.5,38,38,0,100,7.8,5,5,0,100,3.6,7211,81,http://content8.flixster.com/movie/28/83/288310_det.jpg
2649,Son of Frankenstein,1939,7.3,18,17,1,94,0,2,2,0,100,0,0,0,http://content6.flixster.com/movie/34/10/21/3410212_det.jpg
2650,The Ghost of Frankenstein,1942,6.3,8,7,1,87,0,0,0,0,0,0,0,0,http://content7.flixster.com/movie/10/86/19/10861913_det.jpg
2651,Frankenstein Meets the Wolf Man,1943,5.2,10,3,7,30,0,0,0,0,0,0,0,0,http://content9.flixster.com/movie/10/95/43/10954335_det.jpg
2652,The Curse of Frankenstein,1957,7.6,7,7,0,100,0,0,0,0,0,0,0,0,http://content8.flixster.com/movie/30/20/302002_det.jpg
2653,Son of Dracula,1943,\N,\N,\N,\N,\N,\N,\N,\N,\N,\N,\N,\N,\N,\N
2654,The Wolf Man,1941,7.7,31,29,2,93,0,3,2,1,66,3.7,2541,77,http://content7.flixster.com/movie/10/95/43/10954333_det.jpg
2655,Howling II: Stirba - Werewolf Bitch,1985,3.1,6,1,5,16,0,1,0,1,0,2.5,1403,27,http://content6.flixster.com/movie/26/98/269892_det.jpg
2656,Tarantula,1955,6.3,11,10,1,90,0,0,0,0,0,0,0,0,http://content8.flixster.com/movie/53/46/01/5346010_det.jpg
2657,The Rocky Horror Picture Show,1975,6.5,35,27,8,77,0,3,0,3,0,3.6,49873,85,http://content9.flixster.com/movie/10/86/90/10869035_det.jpg
2659,It Came from Hollywood,1982,0,0,0,0,0,0,0,0,0,0,0,0,0,http://content9.flixster.com/movie/26/44/264411_det.jpg
2660,The Thing from Another World,1951,7.7,26,23,3,88,0,2,1,1,50,3.6,2130,71,http://content6.flixster.com/movie/28/58/285828_det.jpg
2661,It Came from Outer Space,1953,6.8,26,21,5,80,0,3,2,1,66,3.1,796,51,http://content7.flixster.com/movie/25/13/251313_det.jpg
2662,War of the Worlds,2005,7,244,178,66,72,6.7,42,28,14,66,2.9,162092,45,http://content8.flixster.com/movie/10/86/82/10868202_det.jpg
2663,It Came from Beneath the Sea,1955,6,7,5,2,71,0,0,0,0,0,0,0,0,http://content9.flixster.com/movie/10/87/84/10878439_det.jpg
2664,Invasion of the Body Snatchers,1956,8.9,36,36,0,100,0,2,2,0,100,3.6,3820,81,http://content8.flixster.com/movie/10/95/44/10954478_det.jpg
2665,Earth vs. the Flying Saucers,1956,5.7,13,9,4,69,0,0,0,0,0,0,0,0,http://content6.flixster.com/movie/28/63/286324_det.jpg
2666,It Conquered the World,1956,5.6,5,4,1,80,0,0,0,0,0,0,0,0,http://content9.flixster.com/movie/54/38/31/5438315_det.jpg
2667,The Mole People,1956,0,4,1,3,25,0,0,0,0,0,0,0,0,http://content9.flixster.com/movie/84/00/67/8400679_det.jpg
2668,Swamp Thing,1982,5.8,26,18,8,69,0,3,1,2,33,2.7,3423,34,http://content6.flixster.com/movie/10/90/44/10904464_det.jpg
2669,Pork Chop Hill,1959,0,4,4,0,100,0,0,0,0,0,0,0,0,http://content6.flixster.com/movie/29/88/298892_det.jpg
2670,Run Silent Run Deep,1958,7,7,7,0,100,0,0,0,0,0,0,0,0,http://content8.flixster.com/movie/29/23/292326_det.jpg
2671,Notting Hill,1999,7.1,97,80,17,82,6.8,28,21,7,75,3.3,85951,74,http://content9.flixster.com/movie/25/41/254107_det.jpg
2672,The Thirteenth Floor,1999,4.5,61,17,44,27,3.8,18,3,15,16,3,5631,61,http://content6.flixster.com/movie/10/87/41/10874152_det.jpg
2673,Mia aioniotita kai mia mera,1998,7.2,21,20,1,95,7.2,6,5,1,83,4.3,1029,91,http://content9.flixster.com/movie/91/04/04/9104047_det.jpg
2674,The Loss of Sexual Innocence,1999,4.8,29,13,16,44,7,5,4,1,80,3.3,449,60,http://content7.flixster.com/movie/10/94/29/10942945_det.gif
2675,The Man with Rain in His Shoes,1998,4.8,21,6,15,28,0,3,1,2,33,3.3,477,55,http://content9.flixster.com/movie/10/87/83/10878363_det.jpg
2676,Instinct,1999,4.3,66,18,48,27,3.7,15,3,12,20,3.2,4403,67,http://content6.flixster.com/movie/27/40/274000_det.jpg
2677,Buena Vista Social Club,1999,7.5,41,37,4,90,8.2,7,6,1,85,4,2963,88,http://content8.flixster.com/movie/10/89/19/10891962_det.jpg
2678,Desert Blue,1998,5.1,18,7,11,38,0,4,1,3,25,3.2,414,49,http://content6.flixster.com/movie/28/24/282492_det.jpg
2679,Finding North,1998,4.7,9,4,5,44,0,1,0,1,0,2.9,277,33,http://content7.flixster.com/movie/30/65/306525_det.jpg
2681,Free Enterprise,1998,\N,\N,\N,\N,\N,\N,\N,\N,\N,\N,\N,\N,\N,\N
2682,Limbo,1999,7,39,28,11,71,6.9,6,3,3,50,3.5,169,75,http://content6.flixster.com/movie/10/85/55/10855592_det.jpg
2683,Austin Powers: The Spy Who Shagged Me,1999,6,85,44,41,51,5.6,20,11,9,55,3.3,70870,73,http://content9.flixster.com/movie/10/86/89/10868999_det.jpg
2685,Le nain rouge,1998,\N,\N,\N,\N,\N,\N,\N,\N,\N,\N,\N,\N,\N,\N
2686,Le violon rouge,1998,7.1,39,28,11,71,7.4,6,5,1,83,3.9,7025,91,http://content7.flixster.com/movie/10/84/36/10843629_det.jpg
2687,Tarzan,1999,7.6,101,89,12,88,7.3,27,23,4,85,3.2,30231,63,http://content9.flixster.com/movie/25/12/251223_det.jpg
2688,The General's Daughter,1999,4.3,87,19,68,21,3.5,23,3,20,13,3,6034,55,http://content6.flixster.com/movie/28/45/284516_det.jpg
2689,Get Smart's Bruce and Lloyd Out of Control,2008,0,2,1,1,50,0,0,0,0,0,0,0,0,http://content9.flixster.com/movie/10/85/85/10858579_det.jpg
2690,An Ideal Husband,1999,7.4,63,54,9,85,7.4,15,14,1,93,3.4,2877,66,http://content9.flixster.com/movie/25/54/255491_det.jpg
2691,La leggenda del pianista sull'oceano,1998,6.2,35,19,16,54,6,5,2,3,40,4.2,5983,92,http://content9.flixster.com/movie/11/12/68/11126807_det.jpg
2692,Lola rennt,1998,7.7,78,72,6,92,7.5,20,19,1,95,3.8,33702,88,http://content7.flixster.com/movie/26/72/267225_det.jpg
2693,Trekkies,1997,7.3,41,35,6,85,6.9,6,4,2,66,3.4,1371,67,http://content9.flixster.com/movie/26/63/266319_det.jpg
2694,Big Daddy,1999,0,0,0,0,0,0,0,0,0,0,0,0,0,http://content6.flixster.com/movie/10/85/17/10851764_det.jpg
2695,The Lost Boys,1987,6.3,40,30,10,75,0,4,2,2,50,3.7,48695,85,http://content7.flixster.com/movie/10/93/70/10937097_det.jpg
2696,Le dîner de cons,1998,6.8,44,32,12,72,7.7,11,10,1,90,4.1,5214,90,http://content6.flixster.com/movie/10/91/04/10910436_det.jpg
2697,My Son the Fanatic,1997,6.9,27,21,6,77,7.4,6,4,2,66,3.5,322,73,http://content7.flixster.com/movie/28/13/281325_det.jpg
2699,Arachnophobia,1990,6.6,26,22,4,84,0,2,2,0,100,2.8,10804,43,http://content8.flixster.com/movie/25/87/258794_det.jpg
2700,South Park: Bigger Longer & Uncut,1999,7,92,74,18,80,6.7,24,20,4,83,3.7,46689,86,http://content8.flixster.com/movie/11/12/93/11129370_det.jpg
2701,Wild Wild West,1999,3.9,102,21,81,20,3.7,24,4,20,16,2.7,31689,39,http://content8.flixster.com/movie/11/15/28/11152830_det.jpg
2702,Summer of Sam,1999,0,0,0,0,0,0,0,0,0,0,0,0,0,http://content9.flixster.com/movie/10/88/16/10881687_det.jpg
2703,Broken Vessels,1998,5.7,14,9,5,64,0,3,2,1,66,0,0,0,http://content6.flixster.com/movie/28/27/282796_det.jpg
2704,Les amants du Pont-Neuf,1991,7.1,14,11,3,78,0,2,2,0,100,4,1699,86,http://content9.flixster.com/movie/10/87/69/10876955_det.jpg
2705,"Fin août, début septembre",1998,6.7,22,18,4,81,7.6,7,7,0,100,3.5,332,61,http://content8.flixster.com/movie/10/88/53/10885374_det.jpg
2706,American Pie,1999,5.7,115,67,48,58,5.5,25,13,12,52,3.4,203348,63,http://content8.flixster.com/movie/11/12/27/11122778_det.jpg
2707,Arlington Road,1999,6.1,86,52,34,60,5.7,19,9,10,47,3.3,6430,72,http://content6.flixster.com/movie/27/14/271400_det.jpg
2708,Conte d'automne,1998,7.8,32,30,2,93,8.3,11,11,0,100,3.8,273,81,http://content6.flixster.com/movie/10/91/18/10911872_det.jpg
2709,Muppets from Space,1999,6.2,53,33,20,62,5.6,20,10,10,50,3,4740,55,http://content7.flixster.com/movie/10/87/15/10871517_det.jpg
2710,The Blair Witch Project,1999,7.5,125,106,19,84,7.2,28,25,3,89,2.5,23900,47,http://content8.flixster.com/movie/10/91/56/10915602_det.jpg
2711,My Life So Far,1999,6.3,25,18,7,72,6.2,5,3,2,60,3.1,618,41,http://content9.flixster.com/movie/26/06/260603_det.jpg
2712,Eyes Wide Shut,1999,7.3,119,93,26,78,6.7,26,18,8,69,2.9,26285,66,http://content6.flixster.com/movie/55/09/34/5509348_det.jpg
2713,Lake Placid,1999,5,68,26,42,38,4,17,4,13,23,2.6,12183,40,http://content7.flixster.com/movie/20/49/88/2049881_det.jpg
2714,The Wood,1999,6,56,34,22,60,5.7,17,10,7,58,3.9,6421,90,http://content7.flixster.com/movie/26/79/267909_det.jpg
2715,The Velocity of Gary* *(Not His Real Name),1998,4.1,17,4,13,23,0,1,0,1,0,3.1,516,49,http://content8.flixster.com/movie/27/56/275698_det.jpg
2716,Ghost Busters,1984,7.6,46,43,3,93,6.2,5,3,2,60,3.6,65639,81,http://content8.flixster.com/movie/26/34/263418_det.jpg
2717,Ghostbusters II,1989,5.2,34,18,16,52,5.4,5,3,2,60,3.2,30085,62,http://content7.flixster.com/movie/25/96/259625_det.jpg
2718,Drop Dead Gorgeous,1999,\N,\N,\N,\N,\N,\N,\N,\N,\N,\N,\N,\N,\N,\N
2719,The Haunting,1999,3.7,87,15,72,17,3.1,24,3,21,12,2.7,10812,42,http://content7.flixster.com/movie/10/81/95/10819505_det.jpg
2720,Inspector Gadget,1999,4,61,13,48,21,3.9,21,4,17,19,2.3,11127,26,http://content8.flixster.com/movie/10/87/99/10879942_det.jpg
2721,Trick,1999,6.8,22,17,5,77,6.8,6,4,2,66,3.7,1364,80,http://content8.flixster.com/movie/10/89/90/10899058_det.gif
2722,Deep Blue Sea,1999,5.7,89,51,38,57,5.8,22,14,8,63,2.8,26286,44,http://content7.flixster.com/movie/27/10/271021_det.jpg
2723,Mystery Men,1999,5.7,100,60,40,60,5.7,28,17,11,60,2.8,14333,52,http://content6.flixster.com/movie/25/66/256628_det.jpg
2724,Runaway Bride,1999,5.3,82,37,45,45,4.8,27,10,17,37,3,48629,57,http://content9.flixster.com/movie/10/84/58/10845851_det.jpg
2725,Twin Falls Idaho,1999,7.3,44,34,10,77,7.6,7,6,1,85,3.8,751,82,http://content7.flixster.com/movie/28/03/280317_det.jpg
2726,The Killing,1956,8.3,26,25,1,96,0,3,3,0,100,4,5595,90,http://content7.flixster.com/movie/29/43/294317_det.jpg
2727,Killer's Kiss,1955,6.8,17,14,3,82,0,3,3,0,100,3.3,2112,56,http://content8.flixster.com/movie/28/77/287714_det.jpg
2728,Spartacus,1960,8.1,45,43,2,95,0,4,3,1,75,3.7,25019,79,http://content7.flixster.com/movie/25/94/259493_det.jpg
2729,Lolita,1962,8,38,37,1,97,0,2,2,0,100,3.7,11593,80,http://content8.flixster.com/movie/30/09/300906_det.jpg
2730,Barry Lyndon,1975,7.8,49,46,3,93,7.5,7,7,0,100,4.1,12262,90,http://content8.flixster.com/movie/26/20/262022_det.jpg
2731,Les quatre cents coups,1959,9.3,48,48,0,100,8.8,8,8,0,100,4.4,9787,95,http://content6.flixster.com/movie/93/87/90/9387900_det.jpg
2732,Jules et Jim,1962,8.9,31,30,1,96,0,4,4,0,100,4.2,6006,89,http://content9.flixster.com/movie/10/85/31/10853127_det.jpg
2733,Vibes,1988,2.8,7,0,7,0,0,1,0,1,0,3.3,404,59,http://content6.flixster.com/movie/10/90/48/10904840_det.jpg
2734,The Mosquito Coast,1986,6.4,20,15,5,75,0,1,0,1,0,3.2,3391,55,http://content7.flixster.com/movie/26/00/260025_det.jpg
2735,The Golden Child,1986,3.9,19,5,14,26,0,2,1,1,50,2.9,9053,49,http://content6.flixster.com/movie/25/60/256000_det.jpg
2736,Brighton Beach Memoirs,1986,5.7,9,6,3,66,0,1,0,1,0,3.4,596,69,http://content8.flixster.com/movie/31/07/310718_det.jpg
2737,The Assassination of Jesse James by the Coward Robert Ford,2007,7.1,162,121,41,74,6.6,36,22,14,61,3.7,57534,73,http://content8.flixster.com/movie/10/93/78/10937894_det.jpg
2738,Crimes of the Heart,1986,7.6,14,14,0,100,0,1,1,0,100,3.3,602,53,http://content9.flixster.com/movie/25/87/258799_det.jpg
2739,The Color Purple,1985,6.7,24,21,3,87,0,1,1,0,100,3.9,30970,93,http://content9.flixster.com/movie/10/93/85/10938559_det.jpg
2741,No Mercy,1986,3.4,13,2,11,15,4.4,5,2,3,40,2.8,740,32,http://content8.flixster.com/movie/10/92/75/10927586_det.jpg
2742,Tenue de soirée,1986,0,4,3,1,75,0,1,1,0,100,3.8,345,75,http://content8.flixster.com/movie/11/12/67/11126790_det.jpg
2743,Native Son,1986,6,9,5,4,55,0,4,1,3,25,3.4,71,61,http://content6.flixster.com/movie/10/84/88/10848836_det.jpg
2744,Otello,1992,\N,\N,\N,\N,\N,\N,\N,\N,\N,\N,\N,\N,\N,\N
2745,The Mission,1986,6.4,16,11,5,68,0,2,1,1,50,3.8,11307,83,http://content8.flixster.com/movie/10/91/81/10918186_det.jpg
2746,The Little Shop of Horrors,1960,6.2,11,10,1,90,0,0,0,0,0,0,0,0,http://content9.flixster.com/movie/10/84/01/10840135_det.jpg
2747,The Little Shop of Horrors,1960,6.2,11,10,1,90,0,0,0,0,0,0,0,0,http://content9.flixster.com/movie/10/84/01/10840135_det.jpg
2748,Allan Quatermain and the Lost City of Gold,1986,0,3,2,1,66,0,0,0,0,0,0,0,0,http://content7.flixster.com/movie/26/39/263925_det.jpg
2749,The Morning After,1986,5.8,15,11,4,73,0,1,1,0,100,2.9,557,33,http://content8.flixster.com/movie/10/89/04/10890474_det.jpg
2750,Radio Days,1987,7.9,21,20,1,95,0,1,1,0,100,3.8,3253,82,http://content9.flixster.com/movie/25/82/258223_det.jpg
2751,From the Hip,1987,4.7,6,1,5,16,0,1,0,1,0,3.2,411,59,http://content6.flixster.com/movie/26/28/262808_det.jpg
2752,Outrageous Fortune,1987,5,20,10,10,50,5,5,2,3,40,3,1206,54,http://content6.flixster.com/movie/27/11/271108_det.jpg
2753,The Bedroom Window,1987,6,14,12,2,85,0,0,0,0,0,0,0,0,http://content9.flixster.com/movie/10/88/16/10881655_det.jpg
2754,Deadtime Stories,1986,0,3,0,3,0,0,0,0,0,0,0,0,0,http://content7.flixster.com/movie/37/14/58/3714585_det.jpg
2755,Light of Day,1987,5.2,12,7,5,58,0,1,1,0,100,3.1,311,41,http://content7.flixster.com/movie/90/71/22/9071221_det.jpg
2756,Wanted: Dead or Alive,1986,4.1,8,2,6,25,0,1,0,1,0,2.9,934,43,http://content7.flixster.com/movie/11/13/07/11130785_det.jpg
2757,Frances,1982,7.6,15,14,1,93,0,1,1,0,100,3.8,713,78,http://content9.flixster.com/movie/28/50/285091_det.jpg
2758,Plenty,1985,7.3,7,5,2,71,0,1,1,0,100,3.4,613,54,http://content7.flixster.com/movie/28/40/284021_det.jpg
2759,Dick,1999,6.3,70,49,21,70,6.6,26,19,7,73,2.7,3840,45,http://content6.flixster.com/movie/25/93/259320_det.jpg
2761,The Iron Giant,1999,8,111,108,3,97,7.7,31,30,1,96,3.3,17836,72,http://content8.flixster.com/movie/10/93/88/10938822_det.jpg
2762,The Sixth Sense,1999,7.4,126,107,19,84,6.8,28,22,6,78,3.8,100968,87,http://content8.flixster.com/movie/25/38/253818_det.jpg
2763,The Thomas Crown Affair,1999,6.4,88,59,29,67,6.6,25,18,7,72,3.3,15699,71,http://content8.flixster.com/movie/26/71/267198_det.jpg
2764,The Thomas Crown Affair,1999,6.4,88,59,29,67,6.6,25,18,7,72,3.3,15699,71,http://content8.flixster.com/movie/26/71/267198_det.jpg
2765,The Acid House,1998,5.8,19,9,10,47,0,2,1,1,50,3.5,2715,68,http://content8.flixster.com/movie/28/89/288918_det.jpg
2766,The Adventures of Sebastian Cole,1998,5.7,22,9,13,40,6.6,5,4,1,80,0,0,0,http://content8.flixster.com/movie/31/11/311110_det.jpg
2767,Illuminata,1998,5.6,23,9,14,39,5.5,7,3,4,42,3.4,320,64,http://content8.flixster.com/movie/27/56/275614_det.jpg
2768,Stiff Upper Lips,1998,4.8,7,2,5,28,0,0,0,0,0,0,0,0,http://content7.flixster.com/movie/10/88/75/10887501_det.jpg
2769,The Whole Ten Yards,2004,2.8,116,5,111,4,3.3,31,2,29,6,3,11437,51,http://content8.flixster.com/movie/55/37/07/5537078_det.jpg
2770,Bowfinger,1999,7.1,107,85,22,79,7.3,26,23,3,88,2.8,8721,49,http://content8.flixster.com/movie/55/09/68/5509686_det.jpg
2771,Brokedown Palace,1999,4.7,34,10,24,29,6,5,3,2,60,3.2,4980,66,http://content9.flixster.com/movie/25/95/259523_det.jpg
2772,Detroit Rock City,1999,5.4,36,17,19,47,4.6,5,1,4,20,3.5,9815,80,http://content9.flixster.com/movie/11/15/17/11151771_det.jpg
2773,Alice et Martin,1998,6.3,42,26,16,61,6.6,13,10,3,76,3.4,246,51,http://content7.flixster.com/movie/10/14/06/10140645_det.jpg
2774,Better Than Chocolate,1999,5.8,21,8,13,38,0,4,1,3,25,3.8,3884,78,http://content8.flixster.com/movie/10/89/25/10892522_det.jpg
2775,Gegen die Wand,2004,0,0,0,0,0,0,0,0,0,0,0,0,0,http://content8.flixster.com/movie/10/88/57/10885794_det.jpg
2776,"Marcello Mastroianni: mi ricordo, sì, io mi ricordo",1997,7.8,7,7,0,100,0,1,1,0,100,3,175,48,http://content9.flixster.com/movie/11/12/42/11124239_det.jpg
2777,Cobra,1986,2.5,14,1,13,7,0,3,1,2,33,2.7,5821,43,http://content7.flixster.com/movie/27/54/275401_det.jpg
2778,Never Talk to Strangers,1995,3.6,20,3,17,15,5,5,2,3,40,2.8,1191,41,http://content7.flixster.com/movie/10/91/88/10918861_det.jpg
2779,Heaven Can Wait,1943,7.8,9,8,1,88,0,0,0,0,0,0,0,0,http://content6.flixster.com/movie/28/70/287004_det.jpg
2780,The Raven,1963,6.4,9,8,1,88,0,0,0,0,0,0,0,0,http://content6.flixster.com/movie/10/84/02/10840228_det.jpg
2781,The Tingler,1959,5.9,14,10,4,71,0,0,0,0,0,0,0,0,http://content9.flixster.com/movie/10/93/55/10935575_det.jpg
2782,Pit and the Pendulum,1961,6.4,14,11,3,78,0,0,0,0,0,0,0,0,http://content6.flixster.com/movie/10/93/87/10938728_det.jpg
2783,The Tomb of Ligeia,1964,6.4,6,5,1,83,0,0,0,0,0,0,0,0,http://content8.flixster.com/movie/10/87/58/10875838_det.jpg
2784,The Masque of the Red Death,1964,5.9,12,7,5,58,0,0,0,0,0,0,0,0,http://content7.flixster.com/movie/10/84/01/10840125_det.jpg
2785,Tales of Terror,1962,6.1,10,6,4,60,0,0,0,0,0,0,0,0,http://content9.flixster.com/movie/10/93/55/10935515_det.jpg
2786,Haunted Honeymoon,1986,3.5,8,2,6,25,0,0,0,0,0,0,0,0,http://content6.flixster.com/movie/10/89/43/10894380_det.jpg
2787,Cat's Eye,1985,5.5,23,15,8,65,0,3,2,1,66,3.1,5931,52,http://content9.flixster.com/movie/25/76/257699_det.jpg
2788,And Now for Something Completely Different,1971,6.9,19,17,2,89,0,2,1,1,50,3.8,16003,85,http://content6.flixster.com/movie/10/93/78/10937840_det.jpg
2789,Damien: Omen II,1978,0,0,0,0,0,0,0,0,0,0,0,0,0,http://images.rottentomatoescdn.com/images/defaults/poster_default.gif
2790,Earth: Final Conflict,1997,\N,\N,\N,\N,\N,\N,\N,\N,\N,\N,\N,\N,\N,\N
2791,Airplane!,1980,8.3,49,48,1,97,7.8,5,5,0,100,3.6,31137,85,http://content6.flixster.com/movie/10/86/76/10867612_det.jpg
2792,Airplane II: The Sequel,1982,5.2,18,7,11,38,0,1,0,1,0,2.9,10524,52,http://content7.flixster.com/movie/25/57/255793_det.jpg
2793,An American Werewolf in Paris,1997,3.7,25,2,23,8,4.5,6,1,5,16,2.8,10235,38,http://content7.flixster.com/movie/10/85/06/10850689_det.jpg
2794,European Vacation,1985,4.8,20,8,12,40,0,0,0,0,0,0,0,0,http://content9.flixster.com/movie/25/78/257823_det.jpg
2795,Vacation,1983,7.3,34,32,2,94,0,3,3,0,100,3.5,11330,80,http://content6.flixster.com/movie/27/14/271424_det.jpg
2796,Funny Farm,1988,5.2,17,11,6,64,0,1,1,0,100,2.9,2927,51,http://content9.flixster.com/movie/10/95/43/10954319_det.jpg
2797,Big,1988,7.9,52,50,2,96,6.8,5,4,1,80,3.4,33658,73,http://content9.flixster.com/movie/10/83/88/10838839_det.jpg
2798,Problem Child 2,1991,2.6,12,2,10,16,0,1,0,1,0,0,0,0,http://content7.flixster.com/movie/24/82/39/2482393_det.jpg
2799,Problem Child 2,1991,2.6,12,2,10,16,0,1,0,1,0,0,0,0,http://content7.flixster.com/movie/24/82/39/2482393_det.jpg
2800,Little Nemo: Adventures in Slumberland,1989,0,0,0,0,0,0,0,0,0,0,0,0,0,http://content9.flixster.com/movie/29/40/294019_det.jpg
2801,Oscar and Lucinda,1997,6.6,31,20,11,64,7.8,7,6,1,85,0,0,0,http://content7.flixster.com/movie/27/55/275505_det.jpg
2802,Tequila Sunrise,1988,5.1,18,9,9,50,0,3,0,3,0,2.9,3959,44,http://content7.flixster.com/movie/27/06/270697_det.jpg
2803,The Pelican Brief,1993,5.5,47,25,22,53,5.5,7,3,4,42,3.2,12632,62,http://content8.flixster.com/movie/10/91/79/10917978_det.jpg
2804,A Christmas Story,1983,8.3,43,38,5,88,0,3,2,1,66,3.7,23109,82,http://content6.flixster.com/movie/10/93/70/10937040_det.jpg
2805,Mickey Blue Eyes,1999,5.4,72,32,40,44,5.1,22,8,14,36,2.7,6320,39,http://content7.flixster.com/movie/26/13/261301_det.jpg
2806,Teaching Mrs. Tingle,1999,4,68,13,55,19,4,24,5,19,20,2.5,4339,34,http://content8.flixster.com/movie/26/66/266698_det.jpg
2807,Universal Soldier: The Return,1999,2.8,51,3,48,5,3.6,17,3,14,17,2.4,4533,35,http://content8.flixster.com/movie/11/14/54/11145414_det.jpg
2808,Universal Soldier,1992,4.2,23,5,18,21,4.3,7,2,5,28,2.8,9415,48,http://content9.flixster.com/movie/11/14/54/11145415_det.jpg
2809,Love Stinks,1999,3.5,47,9,38,19,3.8,16,3,13,18,3.2,1225,66,http://content6.flixster.com/movie/27/25/272528_det.jpg
2810,Perfect Blue,1998,6.4,22,14,8,63,0,2,1,1,50,3.9,4350,86,http://content8.flixster.com/movie/28/66/286610_det.jpg
2811,With Friends Like These...,1998,5.4,14,7,7,50,4.7,5,2,3,40,2.6,46,33,http://content7.flixster.com/movie/10/89/19/10891933_det.jpg
2812,In Too Deep,1999,4.9,55,20,35,36,5.8,20,10,10,50,3.6,1315,76,http://content7.flixster.com/movie/27/19/271909_det.jpg
2813,The Source,1999,0,0,0,0,0,0,0,0,0,0,0,0,0,http://content7.flixster.com/movie/10/88/47/10884793_det.jpg
2814,The Vampire Bat,1933,0,4,2,2,50,0,0,0,0,0,0,0,0,http://content6.flixster.com/movie/10/28/56/10285636_det.jpg
2815,Iron Eagle,1986,3.6,5,2,3,40,0,0,0,0,0,0,0,0,http://content9.flixster.com/movie/25/86/258699_det.jpg
2816,Iron Eagle II,1988,0,1,0,1,0,0,0,0,0,0,0,0,0,http://content8.flixster.com/movie/21/00/21/2100214_det.jpg
2817,Aces: Iron Eagle III,1992,2.2,6,0,6,0,0,1,0,1,0,2.5,1084,27,http://content9.flixster.com/movie/10/88/33/10883351_det.jpg
2818,Iron Eagle IV,1995,0,0,0,0,0,0,0,0,0,0,0,0,0,http://content6.flixster.com/movie/26/25/262504_det.jpg
2819,Three Days of the Condor,1975,7,37,32,5,86,0,4,2,2,50,3.8,3200,83,http://content9.flixster.com/movie/26/72/267291_det.jpg
2820,Hamlet,1996,8.2,54,51,3,94,7.2,14,11,3,78,3.8,5816,86,http://content7.flixster.com/movie/10/94/26/10942625_det.jpg
2821,Male and Female,1919,0,0,0,0,0,0,0,0,0,0,0,0,0,http://content6.flixster.com/movie/10/84/74/10847448_det.jpg
2822,Medicine Man,1992,3.9,18,4,14,22,0,2,0,2,0,2.9,3697,51,http://content8.flixster.com/movie/25/62/256214_det.jpg
2823,"Die Spinnen, 1. Teil - Der Goldene See",1919,0,3,3,0,100,0,0,0,0,0,0,0,0,http://content7.flixster.com/movie/10/88/31/10883105_det.jpg
2824,On the Ropes,1999,7.6,13,12,1,92,0,3,3,0,100,3.3,155,63,http://content6.flixster.com/movie/30/55/305516_det.jpg
2825,Ring Around the Rosie,2006,0,3,0,3,0,0,0,0,0,0,0,0,0,http://content6.flixster.com/movie/10/93/59/10935900_det.jpg
2826,The 13th Warrior,1999,4.6,86,28,58,32,4.9,18,7,11,38,3.2,24204,66,http://content7.flixster.com/movie/10/87/23/10872325_det.jpg
2827,The Astronaut's Wife,1999,4.2,57,9,48,15,4.6,18,5,13,27,2.8,11206,42,http://content9.flixster.com/movie/27/36/273627_det.jpg
2829,The Muse,1999,5.9,76,39,37,51,5.6,23,10,13,43,2.6,1169,29,http://content6.flixster.com/movie/26/39/263996_det.jpg
2830,Bure baruta,1998,7.8,13,11,2,84,0,4,4,0,100,3.8,311,78,http://content9.flixster.com/movie/14/81/25/1481255_det.jpg
2831,A Dog of Flanders,1999,4.5,23,4,19,17,0,3,0,3,0,3.7,259,76,http://content7.flixster.com/movie/10/88/37/10883709_det.jpg
2832,The Lost Son,1999,0,3,2,1,66,0,0,0,0,0,0,0,0,http://content6.flixster.com/movie/85/73/81/8573816_det.jpg
2833,Lucie Aubrac,1997,7,22,17,5,77,7,7,5,2,71,3.6,169,67,http://content8.flixster.com/movie/10/94/29/10942906_det.jpg
2834,"Martha - Meet Frank, Daniel and Laurence",1998,5.1,8,3,5,37,0,1,0,1,0,3.3,1423,59,http://content7.flixster.com/movie/10/88/40/10884009_det.jpg
2835,Chill Factor,1999,3.3,72,5,67,6,3,23,0,23,0,2.7,2079,36,http://content9.flixster.com/movie/10/89/85/10898575_det.gif
2836,Outside Providence,1999,5.6,74,37,37,50,6.2,24,15,9,62,3.2,1355,60,http://content8.flixster.com/movie/26/89/268914_det.jpg
2837,Bedrooms and Hallways,1998,6.3,13,9,4,69,0,1,1,0,100,3.6,615,70,http://content6.flixster.com/movie/45/37/453700_det.jpg
2839,West Beyrouth (À l'abri les enfants),1998,7.2,15,14,1,93,0,1,1,0,100,4.3,382,92,http://content8.flixster.com/movie/10/88/50/10885030_det.jpg
2840,Stigmata,1999,4,88,19,69,21,3.2,24,3,21,12,3.1,12281,65,http://content6.flixster.com/movie/12/87/29/1287292_det.jpg
2841,Stir of Echoes,1999,6.4,103,69,34,66,6.4,25,18,7,72,3.4,14833,69,http://content8.flixster.com/movie/11/12/40/11124030_det.gif
2842,Best Laid Plans,1999,5.8,20,9,11,45,0,4,2,2,50,3.1,1229,43,http://content6.flixster.com/movie/28/14/281492_det.jpg
2843,"Crna macka, beli macor",1998,6.9,18,16,2,88,0,2,2,0,100,4.4,6471,94,http://content7.flixster.com/movie/10/83/83/10838389_det.jpg
2844,The Minus Man,1999,5.9,34,20,14,58,6.7,8,6,2,75,3,1065,43,http://content7.flixster.com/movie/27/49/274997_det.jpg
2845,Whiteboyz,1999,4,15,2,13,13,0,3,0,3,0,2.6,58,27,http://content7.flixster.com/movie/10/87/95/10879541_det.jpg
2846,Koneko monogatari,1986,6.6,9,7,2,77,0,0,0,0,0,0,0,0,http://content8.flixster.com/movie/11/15/03/11150394_det.jpg
2847,Only Angels Have Wings,1939,8.4,11,11,0,100,0,1,1,0,100,3.8,1509,78,http://content7.flixster.com/movie/29/52/295293_det.jpg
2848,Othello,1995,6.3,38,26,12,68,6.1,11,7,4,63,3.3,2018,66,http://content6.flixster.com/movie/10/92/98/10929892_det.jpg
2849,Queens Logic,1991,5.2,7,3,4,42,0,2,0,2,0,2.9,360,29,http://content8.flixster.com/movie/31/10/311094_det.jpg
2850,Wayne's World,1992,6.8,45,38,7,84,6.4,7,5,2,71,3.4,45784,80,http://content7.flixster.com/movie/59/51/42/5951425_det.jpg
2851,Saturn 3,1980,3.8,7,1,6,14,0,1,0,1,0,0,0,0,http://content9.flixster.com/movie/27/50/275019_det.jpg
2852,A Soldier's Story,1984,7.2,16,14,2,87,0,2,0,2,0,3.7,1759,80,http://content6.flixster.com/movie/25/74/257496_det.jpg
2853,Communion,1976,0,3,2,1,66,0,0,0,0,0,0,0,0,http://content9.flixster.com/movie/27/88/278819_det.jpg
2854,The Forgotten,1973,0,4,0,4,0,0,0,0,0,0,0,0,0,http://content6.flixster.com/movie/10/90/56/10905636_det.jpg
2855,The Power of Nightmares: The Rise of the Politics of Fear,2004,8.1,7,6,1,85,8,5,4,1,80,4.5,575,96,http://content6.flixster.com/movie/10/89/72/10897244_det.jpg
2856,I Saw What You Did,1965,0,1,0,1,0,0,0,0,0,0,0,0,0,http://content6.flixster.com/movie/30/80/308092_det.jpg
2857,Yellow Submarine,1968,7.6,36,34,2,94,7.2,8,7,1,87,3.6,7369,82,http://content6.flixster.com/movie/10/93/36/10933636_det.jpg
2858,American Beauty,1999,8,151,134,17,88,7.8,32,29,3,90,3.8,115181,90,http://content9.flixster.com/movie/55/05/64/5505643_det.jpg
2859,Stop Making Sense,1984,8.8,29,28,1,96,0,3,3,0,100,4.4,1700,95,http://content9.flixster.com/movie/10/91/02/10910247_det.jpg
2860,Blue Streak,1999,4.8,68,24,44,35,4.4,20,6,14,30,3,13413,65,http://content8.flixster.com/movie/10/86/76/10867638_det.jpg
2861,For Love of the Game,1999,6.3,55,35,20,63,6,8,4,4,50,3.3,6328,74,http://content9.flixster.com/movie/25/61/256191_det.jpg
2862,Caligola,1979,2.9,28,6,22,21,0,3,0,3,0,2.8,3230,42,http://content6.flixster.com/movie/28/57/285700_det.jpg
2863,A Hard Day's Night,1964,8.2,72,72,0,100,7.9,22,22,0,100,3.9,9274,87,http://content8.flixster.com/movie/25/09/250902_det.jpg
2864,American Splendor,2003,8.3,178,167,11,93,8.6,42,42,0,100,3.7,9157,85,http://content9.flixster.com/movie/10/85/16/10851667_det.jpg
2865,Sugar Town,1999,6.2,24,16,8,66,5.9,6,3,3,50,3,177,41,http://content6.flixster.com/movie/31/01/69/3101692_det.jpg
2866,The Buddy Holly Story,1978,7.3,15,15,0,100,0,0,0,0,0,0,0,0,http://content8.flixster.com/movie/25/85/258502_det.jpg
2867,Fright Night,1985,7.3,27,25,2,92,0,3,2,1,66,3.3,7746,70,http://content8.flixster.com/movie/10/91/56/10915658_det.jpg
2868,Fright Night Part 2,1988,4.7,6,2,4,33,0,0,0,0,0,0,0,0,http://content7.flixster.com/movie/10/91/56/10915657_det.jpg
2869,La séparation,1994,\N,\N,\N,\N,\N,\N,\N,\N,\N,\N,\N,\N,\N,\N
2870,Barefoot in the Park,1967,6.4,13,11,2,84,0,1,0,1,0,3.7,3074,77,http://content6.flixster.com/movie/10/88/84/10888420_det.jpg
2871,Deliverance,1972,8.5,50,47,3,94,5.8,5,2,3,40,3.6,10182,79,http://content7.flixster.com/movie/26/75/267521_det.jpg
2872,Excalibur,1981,7.3,25,20,5,80,0,3,1,2,33,3.4,11195,74,http://content9.flixster.com/movie/26/79/267991_det.jpg
2873,Lulu on the Bridge,1998,3.6,8,0,8,0,0,1,0,1,0,0,0,0,http://content7.flixster.com/movie/10/87/69/10876949_det.jpg
2874,The Pajama Game,1957,7.4,10,9,1,90,0,0,0,0,0,0,0,0,http://content7.flixster.com/movie/95/84/10/9584109_det.jpg
2875,Sommersby,1993,5.9,23,14,9,60,7,6,5,1,83,3.1,2582,55,http://content8.flixster.com/movie/25/92/259218_det.jpg
2876,Thumbelina,1994,5.2,8,2,6,25,0,2,1,1,50,3.1,9634,64,http://content8.flixster.com/movie/11/14/33/11143398_det.jpg
2877,Tommy,1975,7.1,15,13,2,86,0,1,1,0,100,3.4,5178,71,http://content6.flixster.com/movie/25/56/255628_det.jpg
2878,Hell Night,1981,4.5,6,3,3,50,0,1,0,1,0,3,927,45,http://content9.flixster.com/movie/27/07/270799_det.jpg
2879,Fei ying gai wak,1991,6.4,32,22,10,68,6.5,13,11,2,84,3.2,3303,65,http://content8.flixster.com/movie/10/87/95/10879542_det.jpg
2880,Long xiong hu di,1987,6.6,8,6,2,75,0,0,0,0,0,0,0,0,http://content8.flixster.com/movie/11/15/20/11152098_det.jpg
2881,Double Jeopardy,1999,4.4,83,21,62,25,4.1,21,4,17,19,3.2,12512,68,http://content6.flixster.com/movie/26/97/269724_det.jpg
2882,Jakob the Liar,1999,4.7,71,21,50,29,4.9,22,7,15,31,3.2,3128,63,http://content6.flixster.com/movie/26/15/261596_det.jpg
2883,Mumford,1999,5.9,76,42,34,55,6.7,21,14,7,66,3.2,1155,62,http://content7.flixster.com/movie/10/86/70/10867013_det.jpg
2884,Dog Park,1998,4.5,24,8,16,33,4.6,5,1,4,20,2.7,600,30,http://content7.flixster.com/movie/48/44/46/4844465_det.jpg
2885,Guinevere,1999,6.8,33,28,5,84,7.9,8,8,0,100,3,490,45,http://content9.flixster.com/movie/28/18/281823_det.jpg
2886,The Adventures of Elmo in Grouchland,1999,6.7,42,32,10,76,6.3,11,7,4,63,3.2,1136,60,http://content8.flixster.com/movie/25/14/251406_det.jpg
2887,Simon Sez,1999,1.9,18,0,18,0,2.4,5,0,5,0,2.2,603,21,http://content8.flixster.com/movie/26/52/265298_det.jpg
2888,She Drives Me Crazy,2007,\N,\N,\N,\N,\N,\N,\N,\N,\N,\N,\N,\N,\N,\N
2889,"Mystery, Alaska",1999,4.9,78,29,49,37,5.1,26,11,15,42,3.2,4196,66,http://content6.flixster.com/movie/26/75/267504_det.jpg
2890,Three Kings,1999,7.8,126,118,8,93,7.5,28,25,3,89,3.3,21498,70,http://content8.flixster.com/movie/26/78/267806_det.jpg
2891,"Happy, Texas",1999,6.7,50,41,9,82,7.4,11,11,0,100,3.1,1535,53,http://content6.flixster.com/movie/10/88/50/10885052_det.jpg
2892,New Rose Hotel,1998,4.2,16,3,13,18,0,2,0,2,0,2.9,682,40,http://content8.flixster.com/movie/10/87/04/10870498_det.jpg
2893,Plunkett & Macleane,1999,4.7,27,7,20,25,4.4,7,1,6,14,3.3,1388,66,http://content7.flixster.com/movie/27/81/278109_det.jpg
2894,Romance,1999,5.1,31,14,17,45,5.2,8,4,4,50,3,1725,46,http://content7.flixster.com/movie/28/58/285813_det.jpg
2895,Napoleon and Samantha,1972,0,3,2,1,66,0,0,0,0,0,0,0,0,http://content6.flixster.com/movie/10/92/47/10924780_det.jpg
2896,Alvarez Kelly,1966,0,3,2,1,66,0,0,0,0,0,0,0,0,http://content7.flixster.com/movie/10/90/21/10902169_det.jpg
2897,E la nave va,1983,6.8,9,8,1,88,0,2,1,1,50,0,0,0,http://content8.flixster.com/movie/10/88/28/10882818_det.jpg
2898,The Dark Half,1993,5.8,17,10,7,58,0,3,0,3,0,3,2007,43,http://content9.flixster.com/movie/27/95/279515_det.jpg
2899,Gulliver's Travels,1939,6.6,10,7,3,70,0,0,0,0,0,0,0,0,http://content6.flixster.com/movie/11/13/27/11132708_det.jpg
2900,Monkey Shines,1988,5.4,26,13,13,50,5.4,5,2,3,40,2.9,1393,41,http://content8.flixster.com/movie/28/06/280606_det.jpg
2901,Phantasm,1979,6.2,35,22,13,62,0,3,3,0,100,3.4,4777,68,http://content9.flixster.com/movie/26/97/269727_det.jpg
2902,American Psycho II: All American Girl,2002,3.1,9,1,8,11,0,0,0,0,0,0,0,0,http://content6.flixster.com/movie/10/92/96/10929652_det.jpg
2903,Psycho III,1986,5.2,17,10,7,58,0,4,2,2,50,2.6,2593,31,http://content6.flixster.com/movie/10/87/89/10878988_det.jpg
2904,Singin' in the Rain,1952,9.2,44,44,0,100,8.8,9,9,0,100,3.9,28033,91,http://content7.flixster.com/movie/10/93/77/10937761_det.jpg
2905,Tsubaki Sanjûrô,1962,8.3,15,15,0,100,0,1,1,0,100,4.2,4523,94,http://content7.flixster.com/movie/39/91/11/3991117_det.jpg
2906,Random Hearts,1999,4,87,13,74,14,4.1,26,4,22,15,2.7,2118,28,http://content9.flixster.com/movie/10/88/83/10888351_det.jpg
2907,Superstar,1999,4.5,72,24,48,33,4.1,21,6,15,28,2.9,11034,63,http://content7.flixster.com/movie/10/84/02/10840237_det.jpg
2908,Boys Don't Cry,1999,7.9,73,64,9,87,7.9,22,19,3,86,3.7,16491,85,http://content8.flixster.com/movie/10/89/13/10891334_det.jpg
2910,L'ennui,1998,5.5,13,7,6,53,0,2,1,1,50,3,60,50,http://content7.flixster.com/movie/10/92/41/10924117_det.jpg
2911,El abuelo,1998,\N,\N,\N,\N,\N,\N,\N,\N,\N,\N,\N,\N,\N,\N
2912,The Limey,1999,7.4,79,72,7,91,7.7,24,23,1,95,3.6,4089,76,http://content9.flixster.com/movie/27/28/272899_det.jpg
2913,The Mating Habits of the Earthbound Human,1999,4.3,12,4,8,33,0,1,0,1,0,3.5,709,72,http://content7.flixster.com/movie/10/90/03/10900365_det.jpg
2914,The Haunting of Molly Hartley,2008,2.9,34,1,33,2,3.8,8,1,7,12,2.6,18564,23,http://content8.flixster.com/movie/10/87/77/10877710_det.jpg
2915,Risky Business,1983,7.4,43,42,1,97,7.7,6,6,0,100,3.2,11638,61,http://content9.flixster.com/movie/26/90/269091_det.jpg
2916,Total Recall,1990,7.2,42,34,8,80,6.8,8,6,2,75,3.3,25031,70,http://content9.flixster.com/movie/28/47/284795_det.jpg
2917,Body Heat,1981,8,36,35,1,97,8.4,5,5,0,100,3.5,2581,74,http://content9.flixster.com/movie/26/85/268519_det.jpg
2918,Ferris Bueller's Day Off,1986,7.4,46,37,9,80,0,4,1,3,25,3.8,77618,89,http://content8.flixster.com/movie/45/46/59/4546598_det.jpg
2919,The Year of Living Dangerously,1982,7.4,25,22,3,88,0,1,0,1,0,3.5,2161,73,http://content6.flixster.com/movie/10/88/57/10885704_det.jpg
2920,Les enfants du paradis,1945,9,21,20,1,95,8.6,5,5,0,100,4.4,2292,94,http://content6.flixster.com/movie/29/61/296100_det.jpg
2921,High Plains Drifter,1973,7.7,23,22,1,95,0,3,2,1,66,3.7,6781,83,http://content9.flixster.com/movie/26/80/268023_det.jpg
2922,Hang 'Em High,1968,6.5,14,13,1,92,0,1,1,0,100,3.5,5541,71,http://content9.flixster.com/movie/25/66/256603_det.jpg
2923,Handle with Care,1977,0,4,4,0,100,0,0,0,0,0,0,0,0,http://content7.flixster.com/movie/10/95/65/10956529_det.jpg
2924,Jui kuen II,1994,7,74,61,13,82,7.1,24,20,4,83,3.6,7905,83,http://content7.flixster.com/movie/10/93/12/10931221_det.jpg
2925,Il conformista,1970,8.8,40,40,0,100,8.4,9,9,0,100,4.3,2418,92,http://content9.flixster.com/movie/31/35/313515_det.jpg
2926,Hairspray,2007,7.7,205,186,19,90,8,41,40,1,97,3.9,382832,84,http://content6.flixster.com/movie/87/30/58/8730580_det.jpg
2927,Brief Encounter,1945,8.1,29,25,4,86,0,3,2,1,66,4.2,3485,91,http://content8.flixster.com/movie/10/91/79/10917982_det.jpg
2928,The Razor's Edge,1984,5.4,15,8,7,53,0,1,0,1,0,3.7,879,77,http://content9.flixster.com/movie/25/71/257127_det.jpg
2929,Trois couleurs: Rouge,1994,8.5,40,40,0,100,8.2,10,10,0,100,4.2,9557,94,http://content7.flixster.com/movie/10/87/54/10875473_det.jpg
2930,Return with Honor,1998,\N,\N,\N,\N,\N,\N,\N,\N,\N,\N,\N,\N,\N,\N
2931,Dom za vesanje,1988,7.1,5,5,0,100,0,2,2,0,100,4.5,2705,96,http://content8.flixster.com/movie/10/86/20/10862022_det.jpg
2932,Days of Heaven,1978,7.9,36,33,3,91,7.3,7,5,2,71,4.2,4575,89,http://content9.flixster.com/movie/10/88/61/10886175_det.jpg
2933,Le feu follet,1963,7.7,10,9,1,90,0,3,3,0,100,4.3,616,90,http://content6.flixster.com/movie/10/92/43/10924388_det.jpg
2934,El amor brujo,1986,0,2,2,0,100,0,0,0,0,0,0,0,0,http://content9.flixster.com/movie/11/14/27/11142735_det.jpg
2935,The Lady Eve,1941,8.6,28,28,0,100,0,4,4,0,100,4.1,2031,89,http://content8.flixster.com/movie/28/70/287010_det.jpg
2936,Sullivan's Travels,1941,8.7,29,29,0,100,0,2,2,0,100,4.2,2289,90,http://content7.flixster.com/movie/29/34/293401_det.jpg
2937,The Palm Beach Story,1942,8.6,21,21,0,100,0,3,3,0,100,3.9,975,83,http://content8.flixster.com/movie/10/88/25/10882522_det.jpg
2938,Hombre mirando al sudeste,1986,0,4,4,0,100,0,0,0,0,0,0,0,0,http://content8.flixster.com/movie/10/89/08/10890874_det.jpg
2939,Niagara,1953,6.2,10,8,2,80,0,0,0,0,0,0,0,0,http://content6.flixster.com/movie/10/85/38/10853848_det.jpg
2940,Gilda,1946,7.7,15,14,1,93,0,0,0,0,0,0,0,0,http://content8.flixster.com/movie/10/90/09/10900998_det.jpg
2941,South Pacific,1958,6.7,8,7,1,87,0,0,0,0,0,0,0,0,http://content9.flixster.com/movie/29/07/290707_det.jpg
2942,Flashdance,1983,4.7,34,10,24,29,4.6,5,1,4,20,3.2,16331,63,http://content8.flixster.com/movie/55/36/59/5536594_det.jpg
2943,Indochine,1992,6.3,17,12,5,70,0,2,1,1,50,3.9,1905,84,http://content8.flixster.com/movie/25/80/258014_det.jpg
2944,The Dirty Dozen,1967,7.9,21,20,1,95,0,2,2,0,100,3.8,7219,86,http://content8.flixster.com/movie/10/93/77/10937770_det.jpg
2945,Mike's Murder,1984,0,4,2,2,50,0,0,0,0,0,0,0,0,http://content8.flixster.com/movie/10/91/93/10919302_det.jpg
2946,Help!,1965,7.3,22,20,2,90,0,2,1,1,50,3.8,5947,85,http://content8.flixster.com/movie/10/93/69/10936982_det.jpg
2947,Goldfinger,1964,8.4,48,46,2,95,7.9,6,5,1,83,3.6,22155,83,http://content7.flixster.com/movie/26/38/263829_det.jpg
2948,From Russia with Love,1963,7.9,45,43,2,95,7.8,5,5,0,100,3.6,17619,79,http://content6.flixster.com/movie/10/93/43/10934304_det.jpg
2949,Dr. No,1962,7.6,42,41,1,97,0,4,4,0,100,3.5,19811,78,http://content9.flixster.com/movie/25/69/256991_det.jpg
2950,The Blue Lagoon,1980,2.7,17,2,15,11,0,4,1,3,25,2.8,7063,55,http://content8.flixster.com/movie/10/92/42/10924290_det.jpg
2951,Per un pugno di dollari,1964,8.1,35,34,1,97,0,3,3,0,100,3.8,21677,87,http://content6.flixster.com/movie/26/94/269416_det.jpg
2952,Sydney,1996,6.9,32,26,6,81,7.1,11,9,2,81,3.7,3180,81,http://content8.flixster.com/movie/27/33/273322_det.jpg
2953,Home Alone 2: Lost in New York,1992,3.6,24,5,19,20,0,2,1,1,50,3,41991,62,http://content9.flixster.com/movie/25/40/254003_det.jpg
2954,Penitentiary,1979,0,1,0,1,0,0,0,0,0,0,0,0,0,http://content7.flixster.com/movie/10/85/19/10851985_det.jpg
2955,Penitentiary II,1982,0,1,0,1,0,0,0,0,0,0,0,0,0,http://content7.flixster.com/movie/27/74/277425_det.jpg
2956,Someone to Watch Over Me,1987,6.2,17,14,3,82,0,1,0,1,0,3,863,38,http://content9.flixster.com/movie/11/13/30/11133063_det.gif
2958,Naturally Native,1998,0,0,0,0,0,0,0,0,0,0,0,0,0,http://content8.flixster.com/movie/10/89/27/10892702_det.jpg
2959,Fight Club,1999,7.3,149,120,29,80,5.9,27,17,10,62,4.2,268913,95,http://content9.flixster.com/movie/10/93/45/10934563_det.jpg
2960,Beefcake,1998,5.4,7,4,3,57,0,2,1,1,50,3.4,279,63,http://content8.flixster.com/movie/29/56/295698_det.jpg
2961,The Story of Us,1999,4.5,81,23,58,28,4.1,25,4,21,16,3,5089,57,http://content8.flixster.com/movie/26/82/268222_det.jpg
2962,Fever Pitch,2005,6.2,172,110,62,63,6,38,19,19,50,3,14004,62,http://content7.flixster.com/movie/24/97/249737_det.jpg
2963,Joe the King,1999,6,24,15,9,62,5.8,5,1,4,20,3.5,396,67,http://content7.flixster.com/movie/27/87/278717_det.jpg
2964,Julien Donkey-Boy,1999,4.6,33,8,25,24,5.4,6,3,3,50,3.6,1576,73,http://content7.flixster.com/movie/27/52/275297_det.jpg
2965,The Omega Code,1999,3,24,2,22,8,4.2,6,2,4,33,2.6,796,40,http://content6.flixster.com/movie/10/88/66/10886660_det.jpg
2966,The Straight Story,1999,8.1,86,82,4,95,8,26,25,1,96,4,7407,89,http://content8.flixster.com/movie/10/92/38/10923814_det.jpg
2967,The Bad Seed,1956,7.6,15,13,2,86,0,0,0,0,0,0,0,0,http://content7.flixster.com/movie/95/83/60/9583605_det.jpg
2968,Time Bandits,1981,8,36,34,2,94,6.9,5,4,1,80,3.5,9753,74,http://content6.flixster.com/movie/26/30/263020_det.jpg
2969,Un homme et une femme,1966,6.3,12,9,3,75,0,3,1,2,33,4,1548,86,http://content7.flixster.com/movie/28/66/286617_det.jpg
2970,Fitzcarraldo,1982,7.6,22,18,4,81,0,3,2,1,66,4.3,4213,93,http://content9.flixster.com/movie/26/08/260815_det.jpg
2971,All That Jazz,1979,7.4,30,26,4,86,0,4,2,2,50,3.9,3397,84,http://content6.flixster.com/movie/26/82/268220_det.jpg
2972,Hong gao liang,1987,7.6,7,7,0,100,0,1,1,0,100,0,0,0,http://content8.flixster.com/movie/10/89/86/10898682_det.jpg
2973,Crimes and Misdemeanors,1989,7.9,38,35,3,92,7.3,5,4,1,80,4,6179,90,http://content8.flixster.com/movie/31/07/310710_det.jpg
2974,The Vampire Bat,1933,0,4,2,2,50,0,0,0,0,0,0,0,0,http://content6.flixster.com/movie/10/28/56/10285636_det.jpg
2975,The Best Man,2005,0,1,1,0,100,0,0,0,0,0,0,0,0,http://content8.flixster.com/movie/36/71/69/3671694_det.jpg
2976,Bringing Out the Dead,1999,6.7,105,75,30,71,6.6,25,18,7,72,3.2,7444,65,http://content6.flixster.com/movie/28/40/284016_det.jpg
2977,Crazy in Alabama,1999,4.5,55,17,38,30,4.7,20,6,14,30,3.1,1384,55,http://content8.flixster.com/movie/10/86/90/10869026_det.jpg
2978,Three to Tango,1999,4.3,64,18,46,28,4.5,18,7,11,38,2.7,3780,46,http://content6.flixster.com/movie/26/20/262016_det.jpg
2979,Body Shots,1999,4,28,3,25,10,5.5,6,2,4,33,2.5,624,27,http://content8.flixster.com/movie/27/31/273110_det.jpg
2981,Brother Can You Spare a Dime,1975,0,0,0,0,0,0,0,0,0,0,0,0,0,http://content8.flixster.com/movie/26/32/263206_det.jpg
2982,The Guardian,2006,5.2,143,54,89,37,5.2,34,11,23,32,3.7,58919,83,http://content8.flixster.com/movie/10/89/81/10898122_det.jpg
2983,The Ipcress File,1965,7.7,23,23,0,100,0,3,3,0,100,3.8,1386,83,http://content6.flixster.com/movie/10/90/55/10905548_det.jpg
2984,On Any Sunday,1971,0,3,2,1,66,0,1,1,0,100,4.4,129,91,http://content8.flixster.com/movie/10/85/75/10857538_det.jpg
2985,RoboCop,1987,7.7,42,37,5,88,7.3,7,6,1,85,3.1,18381,71,http://content7.flixster.com/movie/29/03/290309_det.jpg
2986,RoboCop 2,1990,4.5,31,11,20,35,4,5,1,4,20,2.7,9580,38,http://content8.flixster.com/movie/28/41/284122_det.jpg
2987,Who Framed Roger Rabbit,1988,8.3,42,41,1,97,7.7,8,7,1,87,3.5,33318,75,http://content7.flixster.com/movie/95/59/48/9559485_det.jpg
2988,Melvin and Howard,1980,8.2,16,16,0,100,0,1,1,0,100,3.4,453,61,http://content9.flixster.com/movie/28/52/285295_det.jpg
2989,For Your Eyes Only,1981,6.2,35,25,10,71,6,5,3,2,60,3.3,10042,64,http://content6.flixster.com/movie/25/84/258424_det.jpg
2990,Licence to Kill,1989,5.8,35,25,10,71,5.5,8,4,4,50,3.1,12088,56,http://content8.flixster.com/movie/10/93/36/10933610_det.gif
2991,Live and Let Die,1973,5.9,36,23,13,63,4.1,6,1,5,16,3.3,13025,66,http://content8.flixster.com/movie/25/91/259118_det.jpg
2992,Rawhead Rex,1986,4.4,5,2,3,40,0,0,0,0,0,0,0,0,http://content9.flixster.com/movie/10/91/76/10917659_det.jpg
2993,Thunderball,1965,7,33,30,3,90,6.2,5,4,1,80,3.4,12807,70,http://content9.flixster.com/movie/25/80/258019_det.jpg
2994,City Lights,1931,9,37,37,0,100,8.8,8,8,0,100,4.3,7937,94,http://content7.flixster.com/movie/10/19/23/10192349_det.jpg
2995,House on Haunted Hill,1999,4.4,53,13,40,24,3.5,11,2,9,18,2.9,13288,49,http://content9.flixster.com/movie/10/83/95/10839519_det.jpg
2996,Music of the Heart,1999,6.6,75,51,24,68,6.1,19,12,7,63,3.5,3231,68,http://content7.flixster.com/movie/10/93/80/10938041_det.jpg
2997,Being John Malkovich,1999,8,116,107,9,92,7.7,26,24,2,92,3.6,52443,85,http://content6.flixster.com/movie/10/89/21/10892184_det.jpg
2998,Dreaming of Joseph Lees,1999,4.8,13,4,9,30,0,4,3,1,75,3.5,62,58,http://content8.flixster.com/movie/10/83/96/10839662_det.jpg
2999,Man of the Century,1999,6.6,16,12,4,75,5.7,5,2,3,40,3.7,246,74,http://content7.flixster.com/movie/28/41/284197_det.jpg
3000,Mononoke-hime,1997,7.7,83,77,6,92,7.7,24,23,1,95,4.1,44616,94,http://content9.flixster.com/movie/25/42/254295_det.jpg
3001,The Suburbans,1999,3,10,0,10,0,0,2,0,2,0,2.5,700,23,http://content9.flixster.com/movie/27/85/278515_det.jpg
3002,Mein liebster Feind - Klaus Kinski,1999,7,24,19,5,79,6.8,5,4,1,80,4,1638,90,http://content6.flixster.com/movie/30/23/302320_det.jpg
3003,Train de vie,1998,6.4,18,12,6,66,0,4,2,2,50,4.3,854,93,http://content8.flixster.com/movie/10/89/39/10893906_det.jpg
3004,The Bachelor,1999,3.5,66,6,60,9,3.4,20,1,19,5,2.5,3470,34,http://content8.flixster.com/movie/10/95/40/10954042_det.jpg
3005,The Bone Collector,1999,4.7,84,23,61,27,4.7,23,7,16,30,3.3,26317,68,http://content7.flixster.com/movie/10/88/63/10886301_det.jpg
3006,Inside Man,2006,7.3,195,168,27,86,7.5,40,35,5,87,3.7,84980,81,http://content9.flixster.com/movie/10/89/84/10898419_det.jpg
3007,American Movie,1999,8.3,46,43,3,93,8.9,7,7,0,100,4,3544,87,http://content6.flixster.com/movie/27/00/270020_det.jpg
3008,Last Night,1998,7.2,49,41,8,83,7.1,9,7,2,77,3.8,1691,84,http://content9.flixster.com/movie/18/18/56/1818567_det.jpg
3010,Rosetta,1999,7.2,22,19,3,86,8.7,5,5,0,100,3.9,880,82,http://content6.flixster.com/movie/54/93/24/5493240_det.jpg
3011,"They Shoot Horses, Don't They?",1969,7.3,23,19,4,82,0,3,3,0,100,3.9,1522,87,http://content9.flixster.com/movie/26/64/266419_det.jpg
3012,Battling Butler,1926,6,5,4,1,80,0,1,0,1,0,3.7,249,75,http://content9.flixster.com/movie/52/46/97/5246979_det.jpg
3013,Bride of Re-Animator,1990,5.2,15,7,8,46,0,3,1,2,33,3.1,1904,51,http://content7.flixster.com/movie/10/93/47/10934777_det.jpg
3014,Bustin' Loose,1981,0,4,3,1,75,0,0,0,0,0,0,0,0,http://content9.flixster.com/movie/28/11/281127_det.jpg
3015,Coma,1978,6.6,21,16,5,76,0,3,1,2,33,3.2,1526,55,http://content8.flixster.com/movie/26/01/260198_det.jpg
3016,Creepshow,1982,6,27,18,9,66,0,4,2,2,50,3.3,6768,67,http://content8.flixster.com/movie/27/00/270002_det.jpg
3017,Creepshow 2,1987,3.7,19,5,14,26,0,4,2,2,50,3,3260,49,http://content9.flixster.com/movie/27/25/272519_det.jpg
3018,Re-Animator,1985,7.7,38,35,3,92,0,4,3,1,75,3.6,7434,78,http://content9.flixster.com/movie/10/93/47/10934779_det.jpg
3019,Drugstore Cowboy,1989,8,27,27,0,100,9,6,6,0,100,3.7,4507,82,http://content7.flixster.com/movie/10/88/51/10885189_det.jpg
3020,Falling Down,1993,6.6,44,33,11,75,6.4,8,5,3,62,3.5,19292,79,http://content9.flixster.com/movie/10/88/45/10884595_det.jpg
3021,The Funhouse,1981,5.6,12,7,5,58,0,0,0,0,0,0,0,0,http://content9.flixster.com/movie/10/88/31/10883171_det.jpg
3022,The General,1926,8.9,38,35,3,92,0,4,2,2,50,4.4,3785,93,http://content6.flixster.com/movie/10/84/02/10840232_det.jpg
3024,Piranha,1978,6.4,22,15,7,68,0,0,0,0,0,0,0,0,http://content9.flixster.com/movie/11/14/65/11146503_det.jpg
3025,Rough Night in Jericho,1967,0,3,1,2,33,0,1,0,1,0,3.1,322,34,http://content9.flixster.com/movie/10/90/04/10900455_det.jpg
3026,Slaughterhouse-Five,1972,7.4,13,10,3,76,0,0,0,0,0,0,0,0,http://content6.flixster.com/movie/11/12/35/11123560_det.jpg
3027,Slaughterhouse-Five,1972,7.4,13,10,3,76,0,0,0,0,0,0,0,0,http://content6.flixster.com/movie/11/12/35/11123560_det.jpg
3028,The Taming of the Shrew,1967,0,0,0,0,0,0,0,0,0,0,0,0,0,http://content9.flixster.com/movie/10/85/11/10851111_det.jpg
3029,Nighthawks,1981,6.2,14,10,4,71,0,2,2,0,100,3.1,1535,52,http://content6.flixster.com/movie/49/60/04/4960044_det.jpg
3030,Yôjinbô,1961,8.8,34,33,1,97,8,5,4,1,80,4.4,10522,96,http://content8.flixster.com/movie/39/91/10/3991102_det.jpg
3031,Repo! The Genetic Opera,2008,4.5,54,18,36,33,3.6,14,2,12,14,3.7,8433,74,http://content7.flixster.com/movie/10/89/20/10892029_det.jpg
3032,The Omega Man,1971,5.6,32,19,13,59,0,4,2,2,50,3.3,5147,56,http://content8.flixster.com/movie/25/61/256198_det.jpg
3033,Spaceballs,1987,6.3,23,15,8,65,0,1,0,1,0,3.5,54973,80,http://content9.flixster.com/movie/55/05/03/5505039_det.jpg
3034,Robin Hood: Prince of Thieves,1991,5.2,27,15,12,55,0,2,1,1,50,3.4,30722,72,http://content6.flixster.com/movie/10/93/73/10937328_det.jpg
3035,Mister Roberts,1955,7.5,17,17,0,100,0,0,0,0,0,0,0,0,http://content6.flixster.com/movie/10/84/07/10840784_det.jpg
3036,La guerre du feu,1981,7,14,11,3,78,0,1,1,0,100,3.5,2238,71,http://content7.flixster.com/movie/10/87/63/10876345_det.jpg
3037,Little Big Man,1970,7.9,25,24,1,96,0,2,2,0,100,3.8,3720,84,http://content8.flixster.com/movie/10/91/68/10916850_det.jpg
3038,A Face in the Crowd,1957,7.8,21,19,2,90,0,3,3,0,100,4.2,1221,93,http://content8.flixster.com/movie/10/86/72/10867226_det.jpg
3039,Trading Places,1983,7.2,36,32,4,88,6.8,5,4,1,80,3.5,12785,82,http://content6.flixster.com/movie/26/71/267100_det.jpg
3040,Meatballs,1979,6.2,28,20,8,71,0,3,2,1,66,3,3676,54,http://content8.flixster.com/movie/55/06/08/5506086_det.jpg
3041,Meatballs Part II,1984,0,0,0,0,0,0,0,0,0,0,0,0,0,http://content8.flixster.com/movie/92/54/86/9254862_det.jpg
3042,Meatballs III: Summer Job,1986,0,0,0,0,0,0,0,0,0,0,0,0,0,http://content9.flixster.com/movie/92/37/51/9237511_det.jpg
3043,Meatballs 4,1992,0,2,0,2,0,0,0,0,0,0,0,0,0,http://content9.flixster.com/movie/41/80/01/4180019_det.jpg
3044,Dead Again,1991,7.3,37,31,6,83,7,5,3,2,60,3.6,2979,75,http://content6.flixster.com/movie/28/51/285100_det.jpg
3045,Peter's Friends,1992,6.3,25,19,6,76,0,2,1,1,50,3.6,1706,73,http://content6.flixster.com/movie/34/33/73/3433732_det.jpg
3046,The Incredibly True Adventure of Two Girls in Love,1995,6.5,9,6,3,66,0,3,1,2,33,3.5,1299,70,http://content7.flixster.com/movie/10/86/36/10863645_det.jpg
3047,Experience Preferred... But Not Essential,1982,\N,\N,\N,\N,\N,\N,\N,\N,\N,\N,\N,\N,\N,\N
3048,Under the Rainbow,1981,0,4,0,4,0,0,2,0,2,0,3.1,194,46,http://content7.flixster.com/movie/11/12/61/11126121_det.jpg
3049,How I Won the War,1967,5.7,12,7,5,58,0,4,0,4,0,3.3,537,58,http://content8.flixster.com/movie/20/77/77/2077770_det.jpg
3050,Light It Up,1999,4.9,47,18,29,38,5.3,17,8,9,47,3.6,1219,76,http://content9.flixster.com/movie/43/88/27/4388279_det.jpg
3051,Anywhere But Here,1999,6.4,86,55,31,63,6.7,23,15,8,65,3,4760,52,http://content7.flixster.com/movie/26/62/266217_det.jpg
3052,Dogma,1999,6.3,126,85,41,67,5.8,28,14,14,50,3.6,61754,84,http://content9.flixster.com/movie/26/81/268119_det.jpg
3053,Joan of Arc,1999,4.5,72,22,50,30,3.4,21,1,20,4,3.1,8110,57,http://content6.flixster.com/movie/10/88/57/10885720_det.jpg
3054,Pokémon: The First Movie,1999,3.6,75,11,64,14,3.7,22,3,19,13,2.8,10617,55,http://content7.flixster.com/movie/10/86/71/10867197_det.jpg
3055,Felicia's Journey,1999,7.4,40,35,5,87,7.8,8,8,0,100,3.4,694,66,http://content8.flixster.com/movie/26/34/263494_det.jpg
3056,Oxygen,1999,6.5,10,7,3,70,0,0,0,0,0,0,0,0,http://content6.flixster.com/movie/27/85/278592_det.jpg
3057,Where's Marlowe?,1998,4.4,11,2,9,18,0,3,0,3,0,3,183,46,http://content9.flixster.com/movie/28/37/283707_det.jpg
3058,Planet of the Apes,1968,7.4,44,39,5,88,5.5,5,3,2,60,3.4,12844,80,http://content7.flixster.com/movie/11/14/82/11148265_det.jpg
3060,The Commitments,1991,7.5,38,34,4,89,6.5,9,7,2,77,3.7,4765,88,http://content7.flixster.com/movie/27/88/278801_det.jpg
3061,Holiday Inn,1942,7.1,20,20,0,100,0,3,3,0,100,4,3215,87,http://content9.flixster.com/movie/34/35/98/3435987_det.jpg
3062,The Longest Day,1962,7.5,12,11,1,91,0,0,0,0,0,0,0,0,http://content6.flixster.com/movie/10/93/55/10935544_det.jpg
3063,Poison Ivy,1992,5,26,11,15,42,4.2,6,1,5,16,2.7,5842,40,http://content9.flixster.com/movie/97/12/79/9712795_det.jpg
3064,Poison Ivy: The New Seduction,1997,0,3,0,3,0,0,0,0,0,0,0,0,0,http://content7.flixster.com/movie/27/01/270113_det.jpg
3065,Nothing to Lose,1997,5.1,23,6,17,26,5.7,5,1,4,20,3.1,5245,67,http://content7.flixster.com/movie/10/45/21/10452197_det.jpg
3066,Tora! Tora! Tora!,1970,6.3,17,12,5,70,0,2,1,1,50,3.6,3254,79,http://content7.flixster.com/movie/25/34/253497_det.jpg
3067,Mujeres al borde de un ataque de nervios,1988,7.6,26,23,3,88,0,4,4,0,100,4,6254,88,http://content9.flixster.com/movie/10/87/03/10870371_det.jpg
3068,The Verdict,1982,7.8,24,23,1,95,0,3,2,1,66,3.8,2332,85,http://content8.flixster.com/movie/10/92/11/10921162_det.jpg
3069,The Effect of Gamma Rays on Man-in-the-Moon Marigolds,1972,0,0,0,0,0,0,0,0,0,0,0,0,0,http://content9.flixster.com/movie/90/32/00/9032007_det.jpg
3070,The Adventures of Buckaroo Banzai Across the 8th Dimension,1984,6.4,34,23,11,67,0,3,2,1,66,3.4,3969,69,http://content6.flixster.com/movie/10/90/58/10905812_det.jpg
3071,Stand and Deliver,1988,6,14,9,5,64,0,1,0,1,0,3.6,2645,78,http://content8.flixster.com/movie/25/52/255202_det.jpg
3072,Moonstruck,1987,7.7,36,33,3,91,7.3,6,5,1,83,3.4,7943,77,http://content8.flixster.com/movie/10/85/77/10857754_det.jpg
3073,The Sandpiper,1965,0,0,0,0,0,0,0,0,0,0,0,0,0,http://content6.flixster.com/movie/10/84/56/10845660_det.jpg
3074,Jeremiah Johnson,1972,7.1,14,13,1,92,0,2,2,0,100,3.9,3595,85,http://content9.flixster.com/movie/25/42/254207_det.jpg
3075,Repulsion,1965,8.8,44,44,0,100,8.3,6,6,0,100,4,4466,87,http://content8.flixster.com/movie/28/63/286318_det.jpg
3076,Irma la Douce,1963,7.4,13,11,2,84,0,2,1,1,50,3.7,1630,76,http://content9.flixster.com/movie/28/67/286707_det.jpg
3077,42: Forty Two Up,1998,7.8,31,28,3,90,7.8,8,7,1,87,4,803,88,http://content8.flixster.com/movie/30/54/305414_det.jpg
3078,Liberty Heights,1999,7.3,45,39,6,86,7.8,11,11,0,100,3.4,1048,71,http://content7.flixster.com/movie/10/89/17/10891709_det.jpg
3079,Mansfield Park,1999,6.9,66,50,16,75,6.3,18,10,8,55,3.6,6288,77,http://content9.flixster.com/movie/25/40/254095_det.jpg
3081,Sleepy Hollow,1999,6.3,124,84,40,67,6.2,30,20,10,66,3.5,93949,79,http://content9.flixster.com/movie/26/69/266927_det.jpg
3082,The World Is Not Enough,1999,0,1,0,1,0,0,0,0,0,0,0,0,0,http://content7.flixster.com/movie/10/84/81/10848193_det.jpg
3083,Todo sobre mi madre,1999,8,80,78,2,97,8,23,22,1,95,4.2,16912,93,http://content7.flixster.com/movie/10/95/09/10950921_det.jpg
3085,La morte vivante,1982,0,2,1,1,50,0,0,0,0,0,0,0,0,http://content9.flixster.com/movie/30/18/301823_det.jpg
3086,Babes in Toyland,1934,8.4,12,12,0,100,0,2,2,0,100,3.6,865,78,http://content7.flixster.com/movie/29/10/291017_det.jpg
3087,Scrooged,1988,5.8,38,24,14,63,3.8,6,1,5,16,3.3,11201,68,http://content7.flixster.com/movie/26/58/265829_det.jpg
3088,Last Chance Harvey,2008,6.2,146,102,44,69,6.1,27,19,8,70,3.2,14302,52,http://content7.flixster.com/movie/10/88/88/10888825_det.jpg
3089,Ladri di biciclette,1948,8.8,47,45,2,95,8.8,7,7,0,100,4.3,8603,94,http://content8.flixster.com/movie/10/44/04/10440426_det.jpg
3090,Matewan,1987,8.3,17,17,0,100,0,0,0,0,0,0,0,0,http://content9.flixster.com/movie/25/59/255991_det.jpg
3091,Kagemusha,1980,7.5,19,16,3,84,0,2,1,1,50,4.2,4005,91,http://content6.flixster.com/movie/10/93/41/10934152_det.jpg
3092,Chûshingura,1962,0,1,0,1,0,0,0,0,0,0,0,0,0,http://content9.flixster.com/movie/31/05/310511_det.jpg
3093,McCabe & Mrs. Miller,1971,8.4,35,31,4,88,6.3,5,3,2,60,4,2372,85,http://content7.flixster.com/movie/26/96/269601_det.jpg
3094,Maurice,1987,7,10,9,1,90,0,1,1,0,100,3.9,2148,82,http://content8.flixster.com/movie/10/93/47/10934714_det.jpg
3095,The Grapes of Wrath,1940,8.9,36,36,0,100,8,5,5,0,100,3.8,4868,85,http://content9.flixster.com/movie/10/85/60/10856083_det.jpg
3096,My Man Godfrey,1936,8.4,26,26,0,100,8,6,6,0,100,4.1,1791,90,http://content7.flixster.com/movie/31/11/311193_det.jpg
3097,The Shop Around the Corner,1940,8.4,20,20,0,100,0,4,4,0,100,4.1,3559,89,http://content9.flixster.com/movie/29/15/291523_det.jpg
3098,The Natural,1984,7,31,25,6,80,5.8,5,2,3,40,3.7,6978,86,http://content6.flixster.com/movie/10/86/72/10867252_det.jpg
3099,Shampoo,1975,6.1,28,17,11,60,5,5,1,4,20,3.2,1397,52,http://content6.flixster.com/movie/27/21/272120_det.jpg
3100,A River Runs Through It,1992,6.8,38,31,7,81,7.4,9,8,1,88,3.5,13036,79,http://content7.flixster.com/movie/25/60/256009_det.jpg
3101,Fatal Attraction,1987,6.8,42,34,8,80,6.7,7,5,2,71,3.2,8130,67,http://content7.flixster.com/movie/10/84/99/10849901_det.jpg
3102,Jagged Edge,1985,6.7,26,22,4,84,6.2,5,3,2,60,3.2,969,54,http://content7.flixster.com/movie/27/65/276525_det.jpg
3103,Stanley & Iris,1989,4,14,4,10,28,0,4,1,3,25,3.1,683,44,http://content6.flixster.com/movie/10/86/38/10863876_det.jpg
3104,Midnight Run,1988,7.7,26,25,1,96,0,2,1,1,50,3.6,5155,82,http://content7.flixster.com/movie/28/22/282293_det.jpg
3105,Awakenings,1990,6.7,28,25,3,89,0,1,1,0,100,3.6,10377,85,http://content6.flixster.com/movie/10/64/14/10641424_det.jpg
3106,Come See the Paradise,1990,5.5,9,6,3,66,0,2,1,1,50,3.5,180,61,http://content7.flixster.com/movie/10/79/86/10798665_det.jpg
3107,Backdraft,1991,6,39,28,11,71,4.4,7,3,4,42,3.3,17142,73,http://content9.flixster.com/movie/56/82/34/5682347_det.jpg
3108,The Fisher King,1991,7,50,43,7,86,6.8,8,6,2,75,3.6,8960,83,http://content6.flixster.com/movie/26/82/268204_det.jpg
3109,Frozen River,2008,7.3,125,109,16,87,7.9,26,24,2,92,3.2,9338,71,http://content6.flixster.com/movie/10/93/37/10933756_det.jpg
3110,North Country,2005,6.7,166,114,52,68,6.8,38,26,12,68,3.5,14739,72,http://content8.flixster.com/movie/25/03/250394_det.jpg
3111,Places in the Heart,1984,8,20,20,0,100,0,3,3,0,100,3.7,1290,80,http://content6.flixster.com/movie/25/75/257520_det.jpg
3112,"'night, Mother",1986,0,1,1,0,100,0,0,0,0,0,0,0,0,http://content6.flixster.com/movie/10/89/02/10890284_det.jpg
3113,End of Days,1999,3.7,98,11,87,11,3.3,24,1,23,4,2.8,14087,41,http://content8.flixster.com/movie/10/84/59/10845938_det.jpg
3114,Toy Story,1995,9,73,73,0,100,8.5,17,17,0,100,3.7,102338,81,http://content7.flixster.com/movie/10/93/63/10936393_det.jpg
3115,Flawless,2007,5.7,90,50,40,55,6,17,12,5,70,3.3,5982,56,http://content6.flixster.com/movie/10/87/72/10877212_det.jpg
3116,Miss Julie,1999,5.6,21,8,13,38,5.2,6,1,5,16,3.2,300,57,http://content8.flixster.com/movie/28/02/280226_det.jpg
3117,Ride with the Devil,1999,6.2,64,40,24,62,5.9,18,10,8,55,3.3,1734,62,http://content9.flixster.com/movie/27/19/271907_det.jpg
3118,Tumbleweeds,1999,7,64,54,10,84,7.1,22,19,3,86,3.5,368,66,http://content8.flixster.com/movie/26/53/265306_det.jpg
3119,Reazione a catena,1971,7.5,9,8,1,88,0,0,0,0,0,0,0,0,http://content9.flixster.com/movie/48/61/08/4861087_det.jpg
3120,The Distinguished Gentleman,1992,4,14,2,12,14,0,2,0,2,0,2.8,1961,40,http://content7.flixster.com/movie/27/21/272129_det.jpg
3121,The Hitch-Hiker,1953,7.6,5,5,0,100,0,0,0,0,0,0,0,0,http://content9.flixster.com/movie/21/98/15/2198159_det.jpg
3122,Santa Fe Trail,1940,0,3,3,0,100,0,0,0,0,0,0,0,0,http://content6.flixster.com/movie/10/85/12/10851292_det.jpg
3124,Agnes Browne,1999,5.3,26,10,16,38,5.8,6,2,4,33,3.5,307,70,http://content6.flixster.com/movie/27/63/276300_det.jpg
3125,The End of the Affair,1999,6.6,66,44,22,66,6.5,16,9,7,56,3.6,3227,73,http://content8.flixster.com/movie/10/92/66/10926630_det.jpg
3126,The End of the Affair,1999,6.6,66,44,22,66,6.5,16,9,7,56,3.6,3227,73,http://content8.flixster.com/movie/10/92/66/10926630_det.jpg
3127,Holy Smoke,1999,5.6,73,32,41,43,5.4,22,8,14,36,3,2300,46,http://content7.flixster.com/movie/27/30/273009_det.jpg
3128,A Map of the World,1999,6.4,54,35,19,64,6.6,17,12,5,70,3.2,587,51,http://content8.flixster.com/movie/46/25/30/4625302_det.jpg
3129,Sweet and Lowdown,1999,6.8,59,46,13,77,6.5,16,11,5,68,3.6,3877,76,http://content8.flixster.com/movie/26/07/260798_det.jpg
3130,The Bonfire of the Vanities,1990,3.8,30,7,23,23,0,2,0,2,0,2.6,3216,28,http://content9.flixster.com/movie/27/57/275799_det.jpg
3131,Broadway Damage,1997,3.5,7,2,5,28,0,1,0,1,0,3,241,43,http://content6.flixster.com/movie/30/54/305428_det.jpg
3132,Daddy Long Legs,1955,0,1,1,0,100,0,0,0,0,0,0,0,0,http://content7.flixster.com/movie/32/04/95/3204957_det.jpg
3133,Go West,1940,6.5,9,8,1,88,0,0,0,0,0,0,0,0,http://content6.flixster.com/movie/10/81/62/10816296_det.jpg
3134,La grande illusion,1937,9.2,34,33,1,97,0,4,4,0,100,4.3,2864,93,http://content6.flixster.com/movie/10/91/76/10917672_det.gif
3135,The Great Santini,1979,7.8,17,16,1,94,0,1,1,0,100,3.6,592,74,http://content8.flixster.com/movie/25/79/257906_det.jpg
3136,The James Dean Story,1957,0,1,1,0,100,0,0,0,0,0,0,0,0,http://content9.flixster.com/movie/30/79/307911_det.jpg
3137,The Sea Wolves,1980,\N,\N,\N,\N,\N,\N,\N,\N,\N,\N,\N,\N,\N,\N
3138,Stealing Home,1988,3.4,9,2,7,22,0,1,0,1,0,3.5,936,71,http://content6.flixster.com/movie/25/97/259716_det.jpg
3139,Tarzan the Fearless,1933,0,1,1,0,100,0,0,0,0,0,0,0,0,http://content9.flixster.com/movie/10/93/13/10931347_det.jpg
3140,Three Ages,1923,7.4,7,7,0,100,0,0,0,0,0,0,0,0,http://content8.flixster.com/movie/10/90/66/10906690_det.jpg
3141,The Two Jakes,1990,5.4,16,10,6,62,0,2,2,0,100,2.9,1401,37,http://content7.flixster.com/movie/10/89/74/10897421_det.jpg
3142,U2: Rattle and Hum,1988,5.7,12,8,4,66,0,0,0,0,0,0,0,0,http://content7.flixster.com/movie/10/88/04/10880465_det.jpg
3143,Hell in the Pacific,1968,6.8,10,8,2,80,0,0,0,0,0,0,0,0,http://content7.flixster.com/movie/10/87/88/10878873_det.jpg
3144,The Glass Bottom Boat,1966,5.6,6,3,3,50,0,0,0,0,0,0,0,0,http://content7.flixster.com/movie/10/92/18/10921889_det.jpg
3145,Cradle Will Rock,1999,6.2,66,42,24,63,5.9,14,10,4,71,3.4,1693,65,http://content9.flixster.com/movie/27/32/273223_det.jpg
3146,Deuce Bigalow: Male Gigolo,1999,4,73,17,56,23,3.2,18,1,17,5,2.9,18036,55,http://content6.flixster.com/movie/27/05/270504_det.jpg
3147,The Green Mile,1999,6.8,128,99,29,77,6.2,32,23,9,71,4.1,124792,93,http://content7.flixster.com/movie/26/73/267305_det.jpg